Alabama,Autauga County,0,55395,26943,28452
Alabama,Autauga County,1,3325,1696,1629
Alabama,Autauga County,2,3789,1936,1853
Alabama,Autauga County,3,4231,2105,2126
Alabama,Autauga County,4,3941,2067,1874
Alabama,Autauga County,5,3632,1836,1796
Alabama,Autauga County,6,3376,1677,1699
Alabama,Autauga County,7,3378,1646,1732
Alabama,Autauga County,8,3514,1657,1857
Alabama,Autauga County,9,4115,1993,2122
Alabama,Autauga County,10,3923,1902,2021
Alabama,Autauga County,11,4130,2050,2080
Alabama,Autauga County,12,3524,1649,1875
Alabama,Autauga County,13,2856,1406,1450
Alabama,Autauga County,14,2516,1140,1376
Alabama,Autauga County,15,2048,895,1153
Alabama,Autauga County,16,1483,648,835
Alabama,Autauga County,17,968,410,558
Alabama,Autauga County,18,646,230,416
Alabama,Baldwin County,0,200111,97597,102514
Alabama,Baldwin County,1,11175,5723,5452
Alabama,Baldwin County,2,12478,6351,6127
Alabama,Baldwin County,3,12894,6580,6314
Alabama,Baldwin County,4,12056,6096,5960
Alabama,Baldwin County,5,11174,5737,5437
Alabama,Baldwin County,6,11211,5494,5717
Alabama,Baldwin County,7,11613,5769,5844
Alabama,Baldwin County,8,11705,5721,5984
Alabama,Baldwin County,9,13263,6453,6810
Alabama,Baldwin County,10,13024,6369,6655
Alabama,Baldwin County,11,14604,7027,7577
Alabama,Baldwin County,12,14296,6694,7602
Alabama,Baldwin County,13,13233,6210,7023
Alabama,Baldwin County,14,12647,6025,6622
Alabama,Baldwin County,15,9846,4644,5202
Alabama,Baldwin County,16,6815,3247,3568
Alabama,Baldwin County,17,4243,1974,2269
Alabama,Baldwin County,18,3834,1483,2351
Alabama,Barbour County,0,26887,14354,12533
Alabama,Barbour County,1,1524,764,760
Alabama,Barbour County,2,1683,838,845
Alabama,Barbour County,3,1611,809,802
Alabama,Barbour County,4,1418,754,664
Alabama,Barbour County,5,1854,1087,767
Alabama,Barbour County,6,1947,1203,744
Alabama,Barbour County,7,1903,1193,710
Alabama,Barbour County,8,1581,1011,570
Alabama,Barbour County,9,1790,1042,748
Alabama,Barbour County,10,1774,1042,732
Alabama,Barbour County,11,1945,1006,939
Alabama,Barbour County,12,1720,874,846
Alabama,Barbour County,13,1704,821,883
Alabama,Barbour County,14,1561,715,846
Alabama,Barbour County,15,1089,519,570
Alabama,Barbour County,16,791,343,448
Alabama,Barbour County,17,507,195,312
Alabama,Barbour County,18,485,138,347
Alabama,Bibb County,0,22506,12168,10338
Alabama,Bibb County,1,1203,631,572
Alabama,Bibb County,2,1290,703,587
Alabama,Bibb County,3,1370,749,621
Alabama,Bibb County,4,1321,727,594
Alabama,Bibb County,5,1481,824,657
Alabama,Bibb County,6,1569,951,618
Alabama,Bibb County,7,1623,1033,590
Alabama,Bibb County,8,1531,906,625
Alabama,Bibb County,9,1655,922,733
Alabama,Bibb County,10,1673,912,761
Alabama,Bibb County,11,1667,912,755
Alabama,Bibb County,12,1502,763,739
Alabama,Bibb County,13,1293,667,626
Alabama,Bibb County,14,1157,567,590
Alabama,Bibb County,15,832,394,438
Alabama,Bibb County,16,637,264,373
Alabama,Bibb County,17,385,154,231
Alabama,Bibb County,18,317,89,228
Alabama,Blount County,0,57719,28553,29166
Alabama,Blount County,1,3522,1804,1718
Alabama,Blount County,2,3705,1818,1887
Alabama,Blount County,3,3942,1974,1968
Alabama,Blount County,4,3722,1996,1726
Alabama,Blount County,5,3455,1777,1678
Alabama,Blount County,6,3213,1628,1585
Alabama,Blount County,7,3445,1698,1747
Alabama,Blount County,8,3480,1728,1752
Alabama,Blount County,9,3952,1986,1966
Alabama,Blount County,10,3995,2005,1990
Alabama,Blount County,11,4068,2086,1982
Alabama,Blount County,12,3807,1888,1919
Alabama,Blount County,13,3600,1746,1854
Alabama,Blount County,14,3369,1583,1786
Alabama,Blount County,15,2562,1178,1384
Alabama,Blount County,16,1809,857,952
Alabama,Blount County,17,1157,503,654
Alabama,Blount County,18,916,298,618
Alabama,Bullock County,0,10764,5893,4871
Alabama,Bullock County,1,677,365,312
Alabama,Bullock County,2,699,380,319
Alabama,Bullock County,3,563,287,276
Alabama,Bullock County,4,613,327,286
Alabama,Bullock County,5,751,432,319
Alabama,Bullock County,6,787,475,312
Alabama,Bullock County,7,790,501,289
Alabama,Bullock County,8,676,417,259
Alabama,Bullock County,9,714,428,286
Alabama,Bullock County,10,699,424,275
Alabama,Bullock County,11,756,427,329
Alabama,Bullock County,12,772,403,369
Alabama,Bullock County,13,667,371,296
Alabama,Bullock County,14,536,247,289
Alabama,Bullock County,15,388,168,220
Alabama,Bullock County,16,300,117,183
Alabama,Bullock County,17,197,72,125
Alabama,Bullock County,18,179,52,127
Alabama,Butler County,0,20296,9421,10875
Alabama,Butler County,1,1230,621,609
Alabama,Butler County,2,1357,709,648
Alabama,Butler County,3,1377,739,638
Alabama,Butler County,4,1260,634,626
Alabama,Butler County,5,1197,598,599
Alabama,Butler County,6,1170,506,664
Alabama,Butler County,7,1259,570,689
Alabama,Butler County,8,1204,540,664
Alabama,Butler County,9,1158,536,622
Alabama,Butler County,10,1104,486,618
Alabama,Butler County,11,1418,615,803
Alabama,Butler County,12,1500,736,764
Alabama,Butler County,13,1418,637,781
Alabama,Butler County,14,1134,565,569
Alabama,Butler County,15,803,352,451
Alabama,Butler County,16,673,270,403
Alabama,Butler County,17,493,167,326
Alabama,Butler County,18,541,140,401
Alabama,Calhoun County,0,115916,55880,60036
Alabama,Calhoun County,1,6651,3430,3221
Alabama,Calhoun County,2,7092,3716,3376
Alabama,Calhoun County,3,7332,3765,3567
Alabama,Calhoun County,4,7575,3834,3741
Alabama,Calhoun County,5,8421,4125,4296
Alabama,Calhoun County,6,7801,3808,3993
Alabama,Calhoun County,7,7159,3499,3660
Alabama,Calhoun County,8,6954,3409,3545
Alabama,Calhoun County,9,7061,3448,3613
Alabama,Calhoun County,10,7348,3544,3804
Alabama,Calhoun County,11,8210,3998,4212
Alabama,Calhoun County,12,8355,4001,4354
Alabama,Calhoun County,13,7458,3513,3945
Alabama,Calhoun County,14,6285,2885,3400
Alabama,Calhoun County,15,4551,2088,2463
Alabama,Calhoun County,16,3281,1349,1932
Alabama,Calhoun County,17,2384,892,1492
Alabama,Calhoun County,18,1998,576,1422
Alabama,Chambers County,0,34076,16248,17828
Alabama,Chambers County,1,2016,965,1051
Alabama,Chambers County,2,1956,988,968
Alabama,Chambers County,3,2023,1063,960
Alabama,Chambers County,4,2045,1072,973
Alabama,Chambers County,5,2195,1076,1119
Alabama,Chambers County,6,2009,1001,1008
Alabama,Chambers County,7,1918,915,1003
Alabama,Chambers County,8,1896,907,989
Alabama,Chambers County,9,2140,1040,1100
Alabama,Chambers County,10,2262,1109,1153
Alabama,Chambers County,11,2542,1232,1310
Alabama,Chambers County,12,2509,1176,1333
Alabama,Chambers County,13,2314,1089,1225
Alabama,Chambers County,14,2085,958,1127
Alabama,Chambers County,15,1542,689,853
Alabama,Chambers County,16,1087,498,589
Alabama,Chambers County,17,778,277,501
Alabama,Chambers County,18,759,193,566
Alabama,Cherokee County,0,26037,12959,13078
Alabama,Cherokee County,1,1249,646,603
Alabama,Cherokee County,2,1427,745,682
Alabama,Cherokee County,3,1641,811,830
Alabama,Cherokee County,4,1498,781,717
Alabama,Cherokee County,5,1446,772,674
Alabama,Cherokee County,6,1257,623,634
Alabama,Cherokee County,7,1297,638,659
Alabama,Cherokee County,8,1401,701,700
Alabama,Cherokee County,9,1675,825,850
Alabama,Cherokee County,10,1835,989,846
Alabama,Cherokee County,11,1909,948,961
Alabama,Cherokee County,12,2049,1016,1033
Alabama,Cherokee County,13,1907,951,956
Alabama,Cherokee County,14,1982,973,1009
Alabama,Cherokee County,15,1455,679,776
Alabama,Cherokee County,16,992,483,509
Alabama,Cherokee County,17,571,225,346
Alabama,Cherokee County,18,446,153,293
Alabama,Chilton County,0,43931,21619,22312
Alabama,Chilton County,1,2826,1411,1415
Alabama,Chilton County,2,2999,1520,1479
Alabama,Chilton County,3,3106,1539,1567
Alabama,Chilton County,4,2679,1420,1259
Alabama,Chilton County,5,2769,1396,1373
Alabama,Chilton County,6,2676,1328,1348
Alabama,Chilton County,7,2722,1349,1373
Alabama,Chilton County,8,2879,1407,1472
Alabama,Chilton County,9,2920,1479,1441
Alabama,Chilton County,10,2893,1430,1463
Alabama,Chilton County,11,3069,1562,1507
Alabama,Chilton County,12,3028,1469,1559
Alabama,Chilton County,13,2688,1282,1406
Alabama,Chilton County,14,2290,1104,1186
Alabama,Chilton County,15,1690,793,897
Alabama,Chilton County,16,1186,543,643
Alabama,Chilton County,17,846,346,500
Alabama,Chilton County,18,665,241,424
Alabama,Choctaw County,0,13323,6325,6998
Alabama,Choctaw County,1,657,316,341
Alabama,Choctaw County,2,742,394,348
Alabama,Choctaw County,3,810,433,377
Alabama,Choctaw County,4,813,383,430
Alabama,Choctaw County,5,779,394,385
Alabama,Choctaw County,6,632,314,318
Alabama,Choctaw County,7,716,327,389
Alabama,Choctaw County,8,727,349,378
Alabama,Choctaw County,9,779,362,417
Alabama,Choctaw County,10,892,428,464
Alabama,Choctaw County,11,1038,486,552
Alabama,Choctaw County,12,1017,489,528
Alabama,Choctaw County,13,954,442,512
Alabama,Choctaw County,14,886,389,497
Alabama,Choctaw County,15,723,357,366
Alabama,Choctaw County,16,499,233,266
Alabama,Choctaw County,17,345,117,228
Alabama,Choctaw County,18,314,112,202
Alabama,Clarke County,0,24945,11765,13180
Alabama,Clarke County,1,1387,706,681
Alabama,Clarke County,2,1447,753,694
Alabama,Clarke County,3,1686,815,871
Alabama,Clarke County,4,1731,819,912
Alabama,Clarke County,5,1648,824,824
Alabama,Clarke County,6,1226,590,636
Alabama,Clarke County,7,1405,638,767
Alabama,Clarke County,8,1441,665,776
Alabama,Clarke County,9,1573,729,844
Alabama,Clarke County,10,1662,784,878
Alabama,Clarke County,11,1873,898,975
Alabama,Clarke County,12,1847,863,984
Alabama,Clarke County,13,1534,736,798
Alabama,Clarke County,14,1412,661,751
Alabama,Clarke County,15,1115,510,605
Alabama,Clarke County,16,865,390,475
Alabama,Clarke County,17,578,216,362
Alabama,Clarke County,18,515,168,347
Alabama,Clay County,0,13552,6693,6859
Alabama,Clay County,1,721,397,324
Alabama,Clay County,2,778,410,368
Alabama,Clay County,3,831,442,389
Alabama,Clay County,4,885,473,412
Alabama,Clay County,5,757,383,374
Alabama,Clay County,6,708,320,388
Alabama,Clay County,7,741,361,380
Alabama,Clay County,8,742,365,377
Alabama,Clay County,9,887,446,441
Alabama,Clay County,10,939,470,469
Alabama,Clay County,11,1053,529,524
Alabama,Clay County,12,977,477,500
Alabama,Clay County,13,902,443,459
Alabama,Clay County,14,794,373,421
Alabama,Clay County,15,679,316,363
Alabama,Clay County,16,513,229,284
Alabama,Clay County,17,354,146,208
Alabama,Clay County,18,291,113,178
Alabama,Cleburne County,0,15080,7482,7598
Alabama,Cleburne County,1,858,438,420
Alabama,Cleburne County,2,1000,498,502
Alabama,Cleburne County,3,1039,565,474
Alabama,Cleburne County,4,904,458,446
Alabama,Cleburne County,5,881,438,443
Alabama,Cleburne County,6,833,415,418
Alabama,Cleburne County,7,841,424,417
Alabama,Cleburne County,8,871,437,434
Alabama,Cleburne County,9,1032,526,506
Alabama,Cleburne County,10,1006,513,493
Alabama,Cleburne County,11,1083,536,547
Alabama,Cleburne County,12,956,462,494
Alabama,Cleburne County,13,1003,521,482
Alabama,Cleburne County,14,926,446,480
Alabama,Cleburne County,15,735,356,379
Alabama,Cleburne County,16,494,220,274
Alabama,Cleburne County,17,351,141,210
Alabama,Cleburne County,18,267,88,179
Alabama,Coffee County,0,50909,25180,25729
Alabama,Coffee County,1,3098,1605,1493
Alabama,Coffee County,2,3301,1700,1601
Alabama,Coffee County,3,3444,1788,1656
Alabama,Coffee County,4,3302,1699,1603
Alabama,Coffee County,5,3106,1582,1524
Alabama,Coffee County,6,3263,1688,1575
Alabama,Coffee County,7,3295,1710,1585
Alabama,Coffee County,8,3213,1610,1603
Alabama,Coffee County,9,3488,1759,1729
Alabama,Coffee County,10,3483,1700,1783
Alabama,Coffee County,11,3467,1772,1695
Alabama,Coffee County,12,3347,1587,1760
Alabama,Coffee County,13,2984,1424,1560
Alabama,Coffee County,14,2779,1365,1414
Alabama,Coffee County,15,1922,855,1067
Alabama,Coffee County,16,1546,652,894
Alabama,Coffee County,17,1008,417,591
Alabama,Coffee County,18,863,267,596
Alabama,Colbert County,0,54543,26290,28253
Alabama,Colbert County,1,3091,1577,1514
Alabama,Colbert County,2,3269,1681,1588
Alabama,Colbert County,3,3324,1678,1646
Alabama,Colbert County,4,3350,1741,1609
Alabama,Colbert County,5,3276,1614,1662
Alabama,Colbert County,6,3240,1574,1666
Alabama,Colbert County,7,3129,1517,1612
Alabama,Colbert County,8,3149,1535,1614
Alabama,Colbert County,9,3420,1669,1751
Alabama,Colbert County,10,3564,1738,1826
Alabama,Colbert County,11,3981,1904,2077
Alabama,Colbert County,12,4075,1967,2108
Alabama,Colbert County,13,3576,1721,1855
Alabama,Colbert County,14,3193,1501,1692
Alabama,Colbert County,15,2554,1117,1437
Alabama,Colbert County,16,1834,777,1057
Alabama,Colbert County,17,1306,540,766
Alabama,Colbert County,18,1212,439,773
Alabama,Conecuh County,0,12670,6098,6572
Alabama,Conecuh County,1,700,324,376
Alabama,Conecuh County,2,734,374,360
Alabama,Conecuh County,3,805,410,395
Alabama,Conecuh County,4,766,393,373
Alabama,Conecuh County,5,793,414,379
Alabama,Conecuh County,6,621,318,303
Alabama,Conecuh County,7,636,310,326
Alabama,Conecuh County,8,667,293,374
Alabama,Conecuh County,9,728,335,393
Alabama,Conecuh County,10,788,384,404
Alabama,Conecuh County,11,952,448,504
Alabama,Conecuh County,12,1011,512,499
Alabama,Conecuh County,13,882,412,470
Alabama,Conecuh County,14,879,418,461
Alabama,Conecuh County,15,638,296,342
Alabama,Conecuh County,16,478,220,258
Alabama,Conecuh County,17,283,119,164
Alabama,Conecuh County,18,309,118,191
Alabama,Coosa County,0,10886,5492,5394
Alabama,Coosa County,1,519,262,257
Alabama,Coosa County,2,522,253,269
Alabama,Coosa County,3,558,283,275
Alabama,Coosa County,4,616,317,299
Alabama,Coosa County,5,611,334,277
Alabama,Coosa County,6,557,303,254
Alabama,Coosa County,7,545,289,256
Alabama,Coosa County,8,577,308,269
Alabama,Coosa County,9,758,370,388
Alabama,Coosa County,10,827,431,396
Alabama,Coosa County,11,891,460,431
Alabama,Coosa County,12,1015,541,474
Alabama,Coosa County,13,873,435,438
Alabama,Coosa County,14,723,340,383
Alabama,Coosa County,15,506,250,256
Alabama,Coosa County,16,368,154,214
Alabama,Coosa County,17,224,83,141
Alabama,Coosa County,18,196,79,117
Alabama,Covington County,0,37914,18361,19553
Alabama,Covington County,1,2221,1149,1072
Alabama,Covington County,2,2321,1189,1132
Alabama,Covington County,3,2376,1233,1143
Alabama,Covington County,4,2221,1145,1076
Alabama,Covington County,5,2225,1148,1077
Alabama,Covington County,6,2115,1029,1086
Alabama,Covington County,7,2155,1035,1120
Alabama,Covington County,8,2039,981,1058
Alabama,Covington County,9,2298,1148,1150
Alabama,Covington County,10,2334,1135,1199
Alabama,Covington County,11,2762,1353,1409
Alabama,Covington County,12,2883,1423,1460
Alabama,Covington County,13,2466,1188,1278
Alabama,Covington County,14,2342,1124,1218
Alabama,Covington County,15,1823,829,994
Alabama,Covington County,16,1394,582,812
Alabama,Covington County,17,974,380,594
Alabama,Covington County,18,965,290,675
Alabama,Crenshaw County,0,13977,6837,7140
Alabama,Crenshaw County,1,857,440,417
Alabama,Crenshaw County,2,860,432,428
Alabama,Crenshaw County,3,911,479,432
Alabama,Crenshaw County,4,845,450,395
Alabama,Crenshaw County,5,900,460,440
Alabama,Crenshaw County,6,734,377,357
Alabama,Crenshaw County,7,780,375,405
Alabama,Crenshaw County,8,808,403,405
Alabama,Crenshaw County,9,900,435,465
Alabama,Crenshaw County,10,871,394,477
Alabama,Crenshaw County,11,1061,561,500
Alabama,Crenshaw County,12,1041,518,523
Alabama,Crenshaw County,13,900,435,465
Alabama,Crenshaw County,14,896,418,478
Alabama,Crenshaw County,15,579,285,294
Alabama,Crenshaw County,16,430,181,249
Alabama,Crenshaw County,17,291,114,177
Alabama,Crenshaw County,18,313,80,233
Alabama,Cullman County,0,81289,40244,41045
Alabama,Cullman County,1,4817,2385,2432
Alabama,Cullman County,2,4995,2599,2396
Alabama,Cullman County,3,5301,2734,2567
Alabama,Cullman County,4,4954,2563,2391
Alabama,Cullman County,5,5043,2547,2496
Alabama,Cullman County,6,4955,2569,2386
Alabama,Cullman County,7,4857,2473,2384
Alabama,Cullman County,8,5003,2572,2431
Alabama,Cullman County,9,5223,2585,2638
Alabama,Cullman County,10,5219,2671,2548
Alabama,Cullman County,11,5863,2977,2886
Alabama,Cullman County,12,5714,2828,2886
Alabama,Cullman County,13,5021,2421,2600
Alabama,Cullman County,14,4811,2273,2538
Alabama,Cullman County,15,3703,1702,2001
Alabama,Cullman County,16,2724,1164,1560
Alabama,Cullman County,17,1774,744,1030
Alabama,Cullman County,18,1312,437,875
Alabama,Dale County,0,49484,24472,25012
Alabama,Dale County,1,3139,1648,1491
Alabama,Dale County,2,3349,1706,1643
Alabama,Dale County,3,3254,1626,1628
Alabama,Dale County,4,3044,1559,1485
Alabama,Dale County,5,3365,1848,1517
Alabama,Dale County,6,3652,1926,1726
Alabama,Dale County,7,3601,1879,1722
Alabama,Dale County,8,2927,1369,1558
Alabama,Dale County,9,3075,1528,1547
Alabama,Dale County,10,2920,1415,1505
Alabama,Dale County,11,3358,1640,1718
Alabama,Dale County,12,3334,1627,1707
Alabama,Dale County,13,2855,1392,1463
Alabama,Dale County,14,2528,1183,1345
Alabama,Dale County,15,1948,881,1067
Alabama,Dale County,16,1392,578,814
Alabama,Dale County,17,981,415,566
Alabama,Dale County,18,762,252,510
Alabama,Dallas County,0,41711,19314,22397
Alabama,Dallas County,1,2795,1402,1393
Alabama,Dallas County,2,2933,1477,1456
Alabama,Dallas County,3,2935,1524,1411
Alabama,Dallas County,4,2912,1459,1453
Alabama,Dallas County,5,2927,1336,1591
Alabama,Dallas County,6,2445,1127,1318
Alabama,Dallas County,7,2373,1059,1314
Alabama,Dallas County,8,2284,1002,1282
Alabama,Dallas County,9,2324,1021,1303
Alabama,Dallas County,10,2434,1103,1331
Alabama,Dallas County,11,3052,1383,1669
Alabama,Dallas County,12,3146,1453,1693
Alabama,Dallas County,13,2636,1233,1403
Alabama,Dallas County,14,2244,1038,1206
Alabama,Dallas County,15,1594,742,852
Alabama,Dallas County,16,1189,495,694
Alabama,Dallas County,17,766,268,498
Alabama,Dallas County,18,722,192,530
Alabama,DeKalb County,0,71065,35024,36041
Alabama,DeKalb County,1,4401,2235,2166
Alabama,DeKalb County,2,5050,2532,2518
Alabama,DeKalb County,3,5157,2629,2528
Alabama,DeKalb County,4,4559,2368,2191
Alabama,DeKalb County,5,4512,2267,2245
Alabama,DeKalb County,6,4049,2041,2008
Alabama,DeKalb County,7,4267,2120,2147
Alabama,DeKalb County,8,4513,2258,2255
Alabama,DeKalb County,9,4874,2453,2421
Alabama,DeKalb County,10,4727,2364,2363
Alabama,DeKalb County,11,4855,2396,2459
Alabama,DeKalb County,12,4718,2355,2363
Alabama,DeKalb County,13,4224,2041,2183
Alabama,DeKalb County,14,3883,1842,2041
Alabama,DeKalb County,15,2823,1368,1455
Alabama,DeKalb County,16,2040,889,1151
Alabama,DeKalb County,17,1350,540,810
Alabama,DeKalb County,18,1063,326,737
Alabama,Elmore County,0,80977,39295,41682
Alabama,Elmore County,1,4799,2579,2220
Alabama,Elmore County,2,5170,2614,2556
Alabama,Elmore County,3,5422,2710,2712
Alabama,Elmore County,4,5056,2577,2479
Alabama,Elmore County,5,5860,3054,2806
Alabama,Elmore County,6,5354,2599,2755
Alabama,Elmore County,7,5357,2566,2791
Alabama,Elmore County,8,5415,2579,2836
Alabama,Elmore County,9,5744,2668,3076
Alabama,Elmore County,10,5527,2591,2936
Alabama,Elmore County,11,5958,2849,3109
Alabama,Elmore County,12,5392,2574,2818
Alabama,Elmore County,13,4565,2143,2422
Alabama,Elmore County,14,4068,1978,2090
Alabama,Elmore County,15,2956,1423,1533
Alabama,Elmore County,16,2014,922,1092
Alabama,Elmore County,17,1227,545,682
Alabama,Elmore County,18,1093,324,769
Alabama,Escambia County,0,37733,19319,18414
Alabama,Escambia County,1,2294,1187,1107
Alabama,Escambia County,2,2333,1165,1168
Alabama,Escambia County,3,2342,1134,1208
Alabama,Escambia County,4,2104,1043,1061
Alabama,Escambia County,5,2476,1296,1180
Alabama,Escambia County,6,2381,1380,1001
Alabama,Escambia County,7,2562,1485,1077
Alabama,Escambia County,8,2399,1350,1049
Alabama,Escambia County,9,2598,1453,1145
Alabama,Escambia County,10,2390,1312,1078
Alabama,Escambia County,11,2717,1419,1298
Alabama,Escambia County,12,2589,1313,1276
Alabama,Escambia County,13,2261,1084,1177
Alabama,Escambia County,14,2035,955,1080
Alabama,Escambia County,15,1609,704,905
Alabama,Escambia County,16,1213,533,680
Alabama,Escambia County,17,800,310,490
Alabama,Escambia County,18,630,196,434
Alabama,Etowah County,0,103531,50100,53431
Alabama,Etowah County,1,5953,3076,2877
Alabama,Etowah County,2,6109,3098,3011
Alabama,Etowah County,3,6577,3352,3225
Alabama,Etowah County,4,6568,3412,3156
Alabama,Etowah County,5,6637,3401,3236
Alabama,Etowah County,6,6045,2974,3071
Alabama,Etowah County,7,6086,2904,3182
Alabama,Etowah County,8,6118,2978,3140
Alabama,Etowah County,9,7068,3446,3622
Alabama,Etowah County,10,6950,3434,3516
Alabama,Etowah County,11,7185,3502,3683
Alabama,Etowah County,12,7366,3576,3790
Alabama,Etowah County,13,6950,3264,3686
Alabama,Etowah County,14,6190,2922,3268
Alabama,Etowah County,15,4374,1960,2414
Alabama,Etowah County,16,3223,1330,1893
Alabama,Etowah County,17,2189,849,1340
Alabama,Etowah County,18,1943,622,1321
Alabama,Fayette County,0,16874,8359,8515
Alabama,Fayette County,1,903,472,431
Alabama,Fayette County,2,1032,551,481
Alabama,Fayette County,3,1046,546,500
Alabama,Fayette County,4,1063,581,482
Alabama,Fayette County,5,1082,582,500
Alabama,Fayette County,6,849,415,434
Alabama,Fayette County,7,842,429,413
Alabama,Fayette County,8,955,454,501
Alabama,Fayette County,9,1061,520,541
Alabama,Fayette County,10,1074,520,554
Alabama,Fayette County,11,1254,645,609
Alabama,Fayette County,12,1225,594,631
Alabama,Fayette County,13,1188,579,609
Alabama,Fayette County,14,1040,494,546
Alabama,Fayette County,15,871,395,476
Alabama,Fayette County,16,659,295,364
Alabama,Fayette County,17,398,164,234
Alabama,Fayette County,18,332,123,209
Alabama,Franklin County,0,31601,15708,15893
Alabama,Franklin County,1,2092,1073,1019
Alabama,Franklin County,2,2188,1115,1073
Alabama,Franklin County,3,2149,1083,1066
Alabama,Franklin County,4,1989,1045,944
Alabama,Franklin County,5,2099,1051,1048
Alabama,Franklin County,6,1977,1066,911
Alabama,Franklin County,7,1962,988,974
Alabama,Franklin County,8,1969,1007,962
Alabama,Franklin County,9,2171,1095,1076
Alabama,Franklin County,10,2019,1037,982
Alabama,Franklin County,11,2073,1039,1034
Alabama,Franklin County,12,2030,1020,1010
Alabama,Franklin County,13,1843,851,992
Alabama,Franklin County,14,1600,781,819
Alabama,Franklin County,15,1321,597,724
Alabama,Franklin County,16,953,415,538
Alabama,Franklin County,17,659,264,395
Alabama,Franklin County,18,507,181,326
Alabama,Geneva County,0,26712,13135,13577
Alabama,Geneva County,1,1551,833,718
Alabama,Geneva County,2,1655,845,810
Alabama,Geneva County,3,1747,903,844
Alabama,Geneva County,4,1506,772,734
Alabama,Geneva County,5,1520,794,726
Alabama,Geneva County,6,1509,742,767
Alabama,Geneva County,7,1441,706,735
Alabama,Geneva County,8,1523,736,787
Alabama,Geneva County,9,1655,800,855
Alabama,Geneva County,10,1827,930,897
Alabama,Geneva County,11,1912,957,955
Alabama,Geneva County,12,1969,960,1009
Alabama,Geneva County,13,1768,870,898
Alabama,Geneva County,14,1719,850,869
Alabama,Geneva County,15,1270,576,694
Alabama,Geneva County,16,961,421,540
Alabama,Geneva County,17,623,259,364
Alabama,Geneva County,18,556,181,375
Alabama,Greene County,0,8553,4059,4494
Alabama,Greene County,1,504,264,240
Alabama,Greene County,2,566,283,283
Alabama,Greene County,3,574,290,284
Alabama,Greene County,4,532,279,253
Alabama,Greene County,5,570,312,258
Alabama,Greene County,6,470,235,235
Alabama,Greene County,7,468,209,259
Alabama,Greene County,8,412,190,222
Alabama,Greene County,9,416,205,211
Alabama,Greene County,10,471,191,280
Alabama,Greene County,11,611,283,328
Alabama,Greene County,12,729,335,394
Alabama,Greene County,13,697,328,369
Alabama,Greene County,14,469,213,256
Alabama,Greene County,15,363,175,188
Alabama,Greene County,16,264,118,146
Alabama,Greene County,17,184,72,112
Alabama,Greene County,18,253,77,176
Alabama,Hale County,0,15184,7166,8018
Alabama,Hale County,1,939,487,452
Alabama,Hale County,2,927,463,464
Alabama,Hale County,3,981,494,487
Alabama,Hale County,4,1075,530,545
Alabama,Hale County,5,998,500,498
Alabama,Hale County,6,838,405,433
Alabama,Hale County,7,854,392,462
Alabama,Hale County,8,814,362,452
Alabama,Hale County,9,821,385,436
Alabama,Hale County,10,965,438,527
Alabama,Hale County,11,1169,538,631
Alabama,Hale County,12,1127,537,590
Alabama,Hale County,13,1049,512,537
Alabama,Hale County,14,854,418,436
Alabama,Hale County,15,629,296,333
Alabama,Hale County,16,449,182,267
Alabama,Hale County,17,348,136,212
Alabama,Hale County,18,347,91,256
Alabama,Henry County,0,17190,8277,8913
Alabama,Henry County,1,943,496,447
Alabama,Henry County,2,929,481,448
Alabama,Henry County,3,1081,568,513
Alabama,Henry County,4,1026,537,489
Alabama,Henry County,5,908,458,450
Alabama,Henry County,6,864,411,453
Alabama,Henry County,7,932,446,486
Alabama,Henry County,8,992,482,510
Alabama,Henry County,9,1119,548,571
Alabama,Henry County,10,1118,541,577
Alabama,Henry County,11,1173,549,624
Alabama,Henry County,12,1253,620,633
Alabama,Henry County,13,1283,564,719
Alabama,Henry County,14,1284,604,680
Alabama,Henry County,15,873,421,452
Alabama,Henry County,16,624,275,349
Alabama,Henry County,17,383,163,220
Alabama,Henry County,18,405,113,292
Alabama,Houston County,0,104193,49889,54304
Alabama,Houston County,1,6496,3313,3183
Alabama,Houston County,2,6776,3536,3240
Alabama,Houston County,3,7245,3761,3484
Alabama,Houston County,4,6389,3269,3120
Alabama,Houston County,5,6442,3081,3361
Alabama,Houston County,6,6689,3228,3461
Alabama,Houston County,7,6757,3243,3514
Alabama,Houston County,8,6439,2990,3449
Alabama,Houston County,9,6859,3268,3591
Alabama,Houston County,10,6544,3153,3391
Alabama,Houston County,11,7376,3540,3836
Alabama,Houston County,12,7051,3364,3687
Alabama,Houston County,13,6340,2921,3419
Alabama,Houston County,14,5675,2661,3014
Alabama,Houston County,15,4041,1819,2222
Alabama,Houston County,16,3067,1294,1773
Alabama,Houston County,17,2152,866,1286
Alabama,Houston County,18,1855,582,1273
Alabama,Jackson County,0,52665,25974,26691
Alabama,Jackson County,1,2858,1499,1359
Alabama,Jackson County,2,3068,1630,1438
Alabama,Jackson County,3,3415,1749,1666
Alabama,Jackson County,4,3180,1688,1492
Alabama,Jackson County,5,3148,1604,1544
Alabama,Jackson County,6,2776,1433,1343
Alabama,Jackson County,7,2901,1365,1536
Alabama,Jackson County,8,3118,1551,1567
Alabama,Jackson County,9,3526,1767,1759
Alabama,Jackson County,10,3425,1717,1708
Alabama,Jackson County,11,3889,1929,1960
Alabama,Jackson County,12,3978,1967,2011
Alabama,Jackson County,13,3607,1735,1872
Alabama,Jackson County,14,3335,1545,1790
Alabama,Jackson County,15,2583,1223,1360
Alabama,Jackson County,16,1874,839,1035
Alabama,Jackson County,17,1050,427,623
Alabama,Jackson County,18,934,306,628
Alabama,Jefferson County,0,660793,312043,348750
Alabama,Jefferson County,1,43498,22132,21366
Alabama,Jefferson County,2,42913,21789,21124
Alabama,Jefferson County,3,41632,20959,20673
Alabama,Jefferson County,4,41026,20605,20421
Alabama,Jefferson County,5,44506,21793,22713
Alabama,Jefferson County,6,48472,22887,25585
Alabama,Jefferson County,7,46597,22177,24420
Alabama,Jefferson County,8,42097,19961,22136
Alabama,Jefferson County,9,41809,20110,21699
Alabama,Jefferson County,10,40682,19277,21405
Alabama,Jefferson County,11,45859,21638,24221
Alabama,Jefferson County,12,46521,21492,25029
Alabama,Jefferson County,13,40806,18725,22081
Alabama,Jefferson County,14,30989,14144,16845
Alabama,Jefferson County,15,21593,9350,12243
Alabama,Jefferson County,16,15868,6288,9580
Alabama,Jefferson County,17,12244,4469,7775
Alabama,Jefferson County,18,13681,4247,9434
Alabama,Lamar County,0,14086,6868,7218
Alabama,Lamar County,1,709,365,344
Alabama,Lamar County,2,880,464,416
Alabama,Lamar County,3,912,462,450
Alabama,Lamar County,4,818,416,402
Alabama,Lamar County,5,697,345,352
Alabama,Lamar County,6,755,385,370
Alabama,Lamar County,7,704,334,370
Alabama,Lamar County,8,802,393,409
Alabama,Lamar County,9,903,432,471
Alabama,Lamar County,10,908,450,458
Alabama,Lamar County,11,1048,536,512
Alabama,Lamar County,12,1096,529,567
Alabama,Lamar County,13,969,491,478
Alabama,Lamar County,14,877,431,446
Alabama,Lamar County,15,708,336,372
Alabama,Lamar County,16,611,263,348
Alabama,Lamar County,17,379,140,239
Alabama,Lamar County,18,310,96,214
Alabama,Lauderdale County,0,93096,44627,48469
Alabama,Lauderdale County,1,4838,2534,2304
Alabama,Lauderdale County,2,5230,2632,2598
Alabama,Lauderdale County,3,5529,2798,2731
Alabama,Lauderdale County,4,6351,3122,3229
Alabama,Lauderdale County,5,8238,3997,4241
Alabama,Lauderdale County,6,5287,2665,2622
Alabama,Lauderdale County,7,5211,2558,2653
Alabama,Lauderdale County,8,4872,2387,2485
Alabama,Lauderdale County,9,5677,2780,2897
Alabama,Lauderdale County,10,5805,2798,3007
Alabama,Lauderdale County,11,6422,3081,3341
Alabama,Lauderdale County,12,6598,3101,3497
Alabama,Lauderdale County,13,6060,2895,3165
Alabama,Lauderdale County,14,5420,2519,2901
Alabama,Lauderdale County,15,4230,1929,2301
Alabama,Lauderdale County,16,3099,1314,1785
Alabama,Lauderdale County,17,2233,900,1333
Alabama,Lauderdale County,18,1996,617,1379
Alabama,Lawrence County,0,33477,16305,17172
Alabama,Lawrence County,1,1791,888,903
Alabama,Lawrence County,2,2115,1065,1050
Alabama,Lawrence County,3,2124,1073,1051
Alabama,Lawrence County,4,1983,1027,956
Alabama,Lawrence County,5,2054,1051,1003
Alabama,Lawrence County,6,1908,936,972
Alabama,Lawrence County,7,1920,958,962
Alabama,Lawrence County,8,1843,922,921
Alabama,Lawrence County,9,2254,1085,1169
Alabama,Lawrence County,10,2508,1252,1256
Alabama,Lawrence County,11,2718,1297,1421
Alabama,Lawrence County,12,2469,1196,1273
Alabama,Lawrence County,13,2164,1028,1136
Alabama,Lawrence County,14,1991,909,1082
Alabama,Lawrence County,15,1522,728,794
Alabama,Lawrence County,16,1015,472,543
Alabama,Lawrence County,17,638,268,370
Alabama,Lawrence County,18,460,150,310
Alabama,Lee County,0,154255,76025,78230
Alabama,Lee County,1,8952,4466,4486
Alabama,Lee County,2,9368,4823,4545
Alabama,Lee County,3,9330,4849,4481
Alabama,Lee County,4,12915,6376,6539
Alabama,Lee County,5,22670,11781,10889
Alabama,Lee County,6,12040,6128,5912
Alabama,Lee County,7,10541,5203,5338
Alabama,Lee County,8,9429,4505,4924
Alabama,Lee County,9,9490,4501,4989
Alabama,Lee County,10,9001,4441,4560
Alabama,Lee County,11,9219,4496,4723
Alabama,Lee County,12,8404,4041,4363
Alabama,Lee County,13,7068,3299,3769
Alabama,Lee County,14,5853,2804,3049
Alabama,Lee County,15,3954,1874,2080
Alabama,Lee County,16,2682,1189,1493
Alabama,Lee County,17,1809,780,1029
Alabama,Lee County,18,1530,469,1061
Alabama,Limestone County,0,90787,45674,45113
Alabama,Limestone County,1,5338,2646,2692
Alabama,Limestone County,2,5946,3063,2883
Alabama,Limestone County,3,6192,3143,3049
Alabama,Limestone County,4,5622,2940,2682
Alabama,Limestone County,5,5267,2713,2554
Alabama,Limestone County,6,5797,2993,2804
Alabama,Limestone County,7,6275,3255,3020
Alabama,Limestone County,8,6076,3203,2873
Alabama,Limestone County,9,6593,3418,3175
Alabama,Limestone County,10,6793,3444,3349
Alabama,Limestone County,11,7103,3698,3405
Alabama,Limestone County,12,6194,3138,3056
Alabama,Limestone County,13,5060,2459,2601
Alabama,Limestone County,14,4458,2114,2344
Alabama,Limestone County,15,3190,1496,1694
Alabama,Limestone County,16,2281,1021,1260
Alabama,Limestone County,17,1420,564,856
Alabama,Limestone County,18,1182,366,816
Alabama,Lowndes County,0,10580,5044,5536
Alabama,Lowndes County,1,710,370,340
Alabama,Lowndes County,2,667,326,341
Alabama,Lowndes County,3,687,364,323
Alabama,Lowndes County,4,620,306,314
Alabama,Lowndes County,5,757,388,369
Alabama,Lowndes County,6,665,328,337
Alabama,Lowndes County,7,574,275,299
Alabama,Lowndes County,8,513,244,269
Alabama,Lowndes County,9,595,279,316
Alabama,Lowndes County,10,683,300,383
Alabama,Lowndes County,11,818,374,444
Alabama,Lowndes County,12,804,386,418
Alabama,Lowndes County,13,644,327,317
Alabama,Lowndes County,14,611,267,344
Alabama,Lowndes County,15,505,232,273
Alabama,Lowndes County,16,340,158,182
Alabama,Lowndes County,17,205,68,137
Alabama,Lowndes County,18,182,52,130
Alabama,Macon County,0,19425,8890,10535
Alabama,Macon County,1,922,472,450
Alabama,Macon County,2,969,482,487
Alabama,Macon County,3,954,475,479
Alabama,Macon County,4,1889,856,1033
Alabama,Macon County,5,2579,1168,1411
Alabama,Macon County,6,1126,521,605
Alabama,Macon County,7,873,398,475
Alabama,Macon County,8,824,405,419
Alabama,Macon County,9,996,452,544
Alabama,Macon County,10,1045,488,557
Alabama,Macon County,11,1266,566,700
Alabama,Macon County,12,1342,642,700
Alabama,Macon County,13,1367,597,770
Alabama,Macon County,14,1084,499,585
Alabama,Macon County,15,814,367,447
Alabama,Macon County,16,540,210,330
Alabama,Macon County,17,405,163,242
Alabama,Macon County,18,430,129,301
Alabama,Madison County,0,350299,171026,179273
Alabama,Madison County,1,20404,10369,10035
Alabama,Madison County,2,21707,11002,10705
Alabama,Madison County,3,22318,11363,10955
Alabama,Madison County,4,23697,12075,11622
Alabama,Madison County,5,24812,12508,12304
Alabama,Madison County,6,24715,12417,12298
Alabama,Madison County,7,23416,11677,11739
Alabama,Madison County,8,20997,10125,10872
Alabama,Madison County,9,22293,10714,11579
Alabama,Madison County,10,24713,12007,12706
Alabama,Madison County,11,28838,14136,14702
Alabama,Madison County,12,24998,12421,12577
Alabama,Madison County,13,19379,9307,10072
Alabama,Madison County,14,15723,7341,8382
Alabama,Madison County,15,11574,5135,6439
Alabama,Madison County,16,9074,3921,5153
Alabama,Madison County,17,6278,2666,3612
Alabama,Madison County,18,5363,1842,3521
Alabama,Marengo County,0,20110,9407,10703
Alabama,Marengo County,1,1209,571,638
Alabama,Marengo County,2,1273,632,641
Alabama,Marengo County,3,1325,663,662
Alabama,Marengo County,4,1299,657,642
Alabama,Marengo County,5,1328,657,671
Alabama,Marengo County,6,1146,542,604
Alabama,Marengo County,7,1013,466,547
Alabama,Marengo County,8,1134,547,587
Alabama,Marengo County,9,1252,542,710
Alabama,Marengo County,10,1247,582,665
Alabama,Marengo County,11,1365,617,748
Alabama,Marengo County,12,1503,709,794
Alabama,Marengo County,13,1276,617,659
Alabama,Marengo County,14,1169,539,630
Alabama,Marengo County,15,917,438,479
Alabama,Marengo County,16,657,288,369
Alabama,Marengo County,17,484,182,302
Alabama,Marengo County,18,513,158,355
Alabama,Marion County,0,30271,15014,15257
Alabama,Marion County,1,1622,850,772
Alabama,Marion County,2,1679,872,807
Alabama,Marion County,3,1920,1007,913
Alabama,Marion County,4,1786,958,828
Alabama,Marion County,5,1702,857,845
Alabama,Marion County,6,1617,806,811
Alabama,Marion County,7,1694,836,858
Alabama,Marion County,8,1660,838,822
Alabama,Marion County,9,2025,1037,988
Alabama,Marion County,10,2112,1072,1040
Alabama,Marion County,11,2249,1144,1105
Alabama,Marion County,12,2108,1057,1051
Alabama,Marion County,13,2002,973,1029
Alabama,Marion County,14,1946,943,1003
Alabama,Marion County,15,1554,723,831
Alabama,Marion County,16,1232,546,686
Alabama,Marion County,17,687,269,418
Alabama,Marion County,18,676,226,450
Alabama,Marshall County,0,94636,46497,48139
Alabama,Marshall County,1,6222,3162,3060
Alabama,Marshall County,2,6638,3413,3225
Alabama,Marshall County,3,6448,3268,3180
Alabama,Marshall County,4,6027,3175,2852
Alabama,Marshall County,5,6021,3123,2898
Alabama,Marshall County,6,5900,2962,2938
Alabama,Marshall County,7,5698,2875,2823
Alabama,Marshall County,8,5561,2785,2776
Alabama,Marshall County,9,6209,3072,3137
Alabama,Marshall County,10,6027,3073,2954
Alabama,Marshall County,11,6639,3260,3379
Alabama,Marshall County,12,6219,3052,3167
Alabama,Marshall County,13,5618,2637,2981
Alabama,Marshall County,14,5114,2351,2763
Alabama,Marshall County,15,3983,1839,2144
Alabama,Marshall County,16,2866,1232,1634
Alabama,Marshall County,17,1956,759,1197
Alabama,Marshall County,18,1490,459,1031
Alabama,Mobile County,0,415123,198569,216554
Alabama,Mobile County,1,27610,13931,13679
Alabama,Mobile County,2,27468,13997,13471
Alabama,Mobile County,3,27739,14080,13659
Alabama,Mobile County,4,27418,13866,13552
Alabama,Mobile County,5,29903,14590,15313
Alabama,Mobile County,6,29154,13903,15251
Alabama,Mobile County,7,26907,12877,14030
Alabama,Mobile County,8,24907,11967,12940
Alabama,Mobile County,9,25281,12124,13157
Alabama,Mobile County,10,25394,12091,13303
Alabama,Mobile County,11,29285,13881,15404
Alabama,Mobile County,12,28927,13823,15104
Alabama,Mobile County,13,24804,11825,12979
Alabama,Mobile County,14,20749,9563,11186
Alabama,Mobile County,15,14832,6580,8252
Alabama,Mobile County,16,10724,4529,6195
Alabama,Mobile County,17,7116,2805,4311
Alabama,Mobile County,18,6905,2137,4768
Alabama,Monroe County,0,21947,10412,11535
Alabama,Monroe County,1,1204,585,619
Alabama,Monroe County,2,1368,709,659
Alabama,Monroe County,3,1530,775,755
Alabama,Monroe County,4,1570,815,755
Alabama,Monroe County,5,1406,707,699
Alabama,Monroe County,6,1050,486,564
Alabama,Monroe County,7,1152,524,628
Alabama,Monroe County,8,1180,541,639
Alabama,Monroe County,9,1405,662,743
Alabama,Monroe County,10,1420,645,775
Alabama,Monroe County,11,1587,780,807
Alabama,Monroe County,12,1649,808,841
Alabama,Monroe County,13,1508,688,820
Alabama,Monroe County,14,1236,601,635
Alabama,Monroe County,15,1001,436,565
Alabama,Monroe County,16,663,293,370
Alabama,Monroe County,17,518,205,313
Alabama,Monroe County,18,500,152,348
Alabama,Montgomery County,0,226189,107182,119007
Alabama,Montgomery County,1,15358,7871,7487
Alabama,Montgomery County,2,15235,7771,7464
Alabama,Montgomery County,3,14967,7621,7346
Alabama,Montgomery County,4,15000,7592,7408
Alabama,Montgomery County,5,17788,8842,8946
Alabama,Montgomery County,6,17011,8214,8797
Alabama,Montgomery County,7,16038,7647,8391
Alabama,Montgomery County,8,14051,6653,7398
Alabama,Montgomery County,9,14343,6782,7561
Alabama,Montgomery County,10,13509,6395,7114
Alabama,Montgomery County,11,15069,6920,8149
Alabama,Montgomery County,12,14692,6672,8020
Alabama,Montgomery County,13,12936,5730,7206
Alabama,Montgomery County,14,9988,4575,5413
Alabama,Montgomery County,15,7126,3101,4025
Alabama,Montgomery County,16,5305,2129,3176
Alabama,Montgomery County,17,3913,1526,2387
Alabama,Montgomery County,18,3860,1141,2719
Alabama,Morgan County,0,119607,58883,60724
Alabama,Morgan County,1,7231,3779,3452
Alabama,Morgan County,2,7615,3898,3717
Alabama,Morgan County,3,7968,4084,3884
Alabama,Morgan County,4,7326,3791,3535
Alabama,Morgan County,5,7464,3805,3659
Alabama,Morgan County,6,7214,3700,3514
Alabama,Morgan County,7,7482,3743,3739
Alabama,Morgan County,8,7342,3702,3640
Alabama,Morgan County,9,7785,3906,3879
Alabama,Morgan County,10,8405,4099,4306
Alabama,Morgan County,11,8963,4487,4476
Alabama,Morgan County,12,8370,4070,4300
Alabama,Morgan County,13,7380,3477,3903
Alabama,Morgan County,14,6355,2902,3453
Alabama,Morgan County,15,4875,2240,2635
Alabama,Morgan County,16,3480,1558,1922
Alabama,Morgan County,17,2371,976,1395
Alabama,Morgan County,18,1981,666,1315
Alabama,Perry County,0,9826,4579,5247
Alabama,Perry County,1,543,249,294
Alabama,Perry County,2,597,312,285
Alabama,Perry County,3,671,319,352
Alabama,Perry County,4,979,546,433
Alabama,Perry County,5,846,390,456
Alabama,Perry County,6,512,246,266
Alabama,Perry County,7,498,224,274
Alabama,Perry County,8,487,227,260
Alabama,Perry County,9,521,236,285
Alabama,Perry County,10,516,235,281
Alabama,Perry County,11,604,278,326
Alabama,Perry County,12,706,323,383
Alabama,Perry County,13,583,256,327
Alabama,Perry County,14,529,243,286
Alabama,Perry County,15,445,196,249
Alabama,Perry County,16,328,154,174
Alabama,Perry County,17,232,82,150
Alabama,Perry County,18,229,63,166
Alabama,Pickens County,0,20365,10051,10314
Alabama,Pickens County,1,1052,496,556
Alabama,Pickens County,2,1108,571,537
Alabama,Pickens County,3,1225,640,585
Alabama,Pickens County,4,1238,679,559
Alabama,Pickens County,5,1387,762,625
Alabama,Pickens County,6,1244,628,616
Alabama,Pickens County,7,1310,688,622
Alabama,Pickens County,8,1130,571,559
Alabama,Pickens County,9,1208,581,627
Alabama,Pickens County,10,1485,733,752
Alabama,Pickens County,11,1567,753,814
Alabama,Pickens County,12,1478,754,724
Alabama,Pickens County,13,1306,627,679
Alabama,Pickens County,14,1147,551,596
Alabama,Pickens County,15,910,396,514
Alabama,Pickens County,16,725,306,419
Alabama,Pickens County,17,431,167,264
Alabama,Pickens County,18,414,148,266
Alabama,Pike County,0,33389,16051,17338
Alabama,Pike County,1,1888,982,906
Alabama,Pike County,2,1708,848,860
Alabama,Pike County,3,1754,902,852
Alabama,Pike County,4,3010,1327,1683
Alabama,Pike County,5,5823,2946,2877
Alabama,Pike County,6,2063,1113,950
Alabama,Pike County,7,1842,924,918
Alabama,Pike County,8,1645,736,909
Alabama,Pike County,9,1708,822,886
Alabama,Pike County,10,1664,757,907
Alabama,Pike County,11,1896,888,1008
Alabama,Pike County,12,1974,926,1048
Alabama,Pike County,13,1720,829,891
Alabama,Pike County,14,1589,753,836
Alabama,Pike County,15,1159,548,611
Alabama,Pike County,16,866,386,480
Alabama,Pike County,17,569,215,354
Alabama,Pike County,18,511,149,362
Alabama,Randolph County,0,22539,10946,11593
Alabama,Randolph County,1,1276,673,603
Alabama,Randolph County,2,1332,660,672
Alabama,Randolph County,3,1423,757,666
Alabama,Randolph County,4,1549,778,771
Alabama,Randolph County,5,1291,643,648
Alabama,Randolph County,6,1147,561,586
Alabama,Randolph County,7,1187,555,632
Alabama,Randolph County,8,1213,598,615
Alabama,Randolph County,9,1360,660,700
Alabama,Randolph County,10,1475,711,764
Alabama,Randolph County,11,1657,823,834
Alabama,Randolph County,12,1681,841,840
Alabama,Randolph County,13,1532,757,775
Alabama,Randolph County,14,1406,684,722
Alabama,Randolph County,15,1167,546,621
Alabama,Randolph County,16,852,365,487
Alabama,Randolph County,17,554,208,346
Alabama,Randolph County,18,437,126,311
Alabama,Russell County,0,59608,29035,30573
Alabama,Russell County,1,4529,2311,2218
Alabama,Russell County,2,4157,2110,2047
Alabama,Russell County,3,3992,2058,1934
Alabama,Russell County,4,3934,2030,1904
Alabama,Russell County,5,4175,2106,2069
Alabama,Russell County,6,4897,2353,2544
Alabama,Russell County,7,4425,2233,2192
Alabama,Russell County,8,3839,1918,1921
Alabama,Russell County,9,3631,1801,1830
Alabama,Russell County,10,3708,1861,1847
Alabama,Russell County,11,3980,1921,2059
Alabama,Russell County,12,3733,1789,1944
Alabama,Russell County,13,3139,1447,1692
Alabama,Russell County,14,2526,1150,1376
Alabama,Russell County,15,1827,796,1031
Alabama,Russell County,16,1339,578,761
Alabama,Russell County,17,899,329,570
Alabama,Russell County,18,878,244,634
Alabama,Shelby County,0,206655,100752,105903
Alabama,Shelby County,1,12383,6299,6084
Alabama,Shelby County,2,14116,7233,6883
Alabama,Shelby County,3,14995,7674,7321
Alabama,Shelby County,4,13852,7019,6833
Alabama,Shelby County,5,11903,5988,5915
Alabama,Shelby County,6,12348,5921,6427
Alabama,Shelby County,7,14295,7011,7284
Alabama,Shelby County,8,14512,7081,7431
Alabama,Shelby County,9,15620,7685,7935
Alabama,Shelby County,10,14614,7132,7482
Alabama,Shelby County,11,15154,7298,7856
Alabama,Shelby County,12,13883,6720,7163
Alabama,Shelby County,13,12132,5671,6461
Alabama,Shelby County,14,9878,4652,5226
Alabama,Shelby County,15,6828,3137,3691
Alabama,Shelby County,16,4415,2018,2397
Alabama,Shelby County,17,2950,1213,1737
Alabama,Shelby County,18,2777,1000,1777
Alabama,Sumter County,0,13166,5929,7237
Alabama,Sumter County,1,626,307,319
Alabama,Sumter County,2,723,351,372
Alabama,Sumter County,3,771,377,394
Alabama,Sumter County,4,1115,544,571
Alabama,Sumter County,5,1758,760,998
Alabama,Sumter County,6,664,349,315
Alabama,Sumter County,7,591,275,316
Alabama,Sumter County,8,559,231,328
Alabama,Sumter County,9,709,319,390
Alabama,Sumter County,10,698,306,392
Alabama,Sumter County,11,932,408,524
Alabama,Sumter County,12,991,449,542
Alabama,Sumter County,13,882,426,456
Alabama,Sumter County,14,650,298,352
Alabama,Sumter County,15,489,208,281
Alabama,Sumter County,16,392,167,225
Alabama,Sumter County,17,261,68,193
Alabama,Sumter County,18,355,86,269
Alabama,Talladega County,0,81322,39535,41787
Alabama,Talladega County,1,4470,2274,2196
Alabama,Talladega County,2,5026,2427,2599
Alabama,Talladega County,3,5365,2677,2688
Alabama,Talladega County,4,5126,2584,2542
Alabama,Talladega County,5,5324,2630,2694
Alabama,Talladega County,6,4853,2393,2460
Alabama,Talladega County,7,5012,2533,2479
Alabama,Talladega County,8,4901,2460,2441
Alabama,Talladega County,9,5558,2775,2783
Alabama,Talladega County,10,5452,2748,2704
Alabama,Talladega County,11,5833,2856,2977
Alabama,Talladega County,12,6052,2866,3186
Alabama,Talladega County,13,5292,2561,2731
Alabama,Talladega County,14,4596,2180,2416
Alabama,Talladega County,15,3351,1568,1783
Alabama,Talladega County,16,2272,998,1274
Alabama,Talladega County,17,1514,568,946
Alabama,Talladega County,18,1325,437,888
Alabama,Tallapoosa County,0,41165,20011,21154
Alabama,Tallapoosa County,1,2372,1272,1100
Alabama,Tallapoosa County,2,2322,1185,1137
Alabama,Tallapoosa County,3,2444,1238,1206
Alabama,Tallapoosa County,4,2442,1279,1163
Alabama,Tallapoosa County,5,2631,1348,1283
Alabama,Tallapoosa County,6,2188,1047,1141
Alabama,Tallapoosa County,7,2183,1019,1164
Alabama,Tallapoosa County,8,2095,1003,1092
Alabama,Tallapoosa County,9,2562,1196,1366
Alabama,Tallapoosa County,10,2709,1305,1404
Alabama,Tallapoosa County,11,2958,1468,1490
Alabama,Tallapoosa County,12,3191,1553,1638
Alabama,Tallapoosa County,13,3016,1452,1564
Alabama,Tallapoosa County,14,2710,1285,1425
Alabama,Tallapoosa County,15,2088,991,1097
Alabama,Tallapoosa County,16,1474,649,825
Alabama,Tallapoosa County,17,977,405,572
Alabama,Tallapoosa County,18,803,316,487
Alabama,Tuscaloosa County,0,202212,97626,104586
Alabama,Tuscaloosa County,1,12127,6022,6105
Alabama,Tuscaloosa County,2,11632,5926,5706
Alabama,Tuscaloosa County,3,11881,6113,5768
Alabama,Tuscaloosa County,4,17225,8359,8866
Alabama,Tuscaloosa County,5,27981,13847,14134
Alabama,Tuscaloosa County,6,15085,7603,7482
Alabama,Tuscaloosa County,7,13353,6536,6817
Alabama,Tuscaloosa County,8,11788,5702,6086
Alabama,Tuscaloosa County,9,11766,5596,6170
Alabama,Tuscaloosa County,10,10968,5248,5720
Alabama,Tuscaloosa County,11,11743,5697,6046
Alabama,Tuscaloosa County,12,12106,5692,6414
Alabama,Tuscaloosa County,13,10835,5188,5647
Alabama,Tuscaloosa County,14,8225,3896,4329
Alabama,Tuscaloosa County,15,5650,2538,3112
Alabama,Tuscaloosa County,16,3954,1624,2330
Alabama,Tuscaloosa County,17,3058,1131,1927
Alabama,Tuscaloosa County,18,2835,908,1927
Alabama,Walker County,0,65471,31822,33649
Alabama,Walker County,1,3829,1902,1927
Alabama,Walker County,2,3866,1964,1902
Alabama,Walker County,3,4151,2185,1966
Alabama,Walker County,4,4031,2035,1996
Alabama,Walker County,5,4029,2057,1972
Alabama,Walker County,6,3713,1823,1890
Alabama,Walker County,7,3646,1817,1829
Alabama,Walker County,8,3796,1787,2009
Alabama,Walker County,9,4202,2151,2051
Alabama,Walker County,10,4298,2199,2099
Alabama,Walker County,11,4751,2310,2441
Alabama,Walker County,12,4827,2313,2514
Alabama,Walker County,13,4419,2154,2265
Alabama,Walker County,14,4052,1839,2213
Alabama,Walker County,15,3035,1370,1665
Alabama,Walker County,16,2322,993,1329
Alabama,Walker County,17,1414,604,810
Alabama,Walker County,18,1090,319,771
Alabama,Washington County,0,16834,8220,8614
Alabama,Washington County,1,821,418,403
Alabama,Washington County,2,1028,490,538
Alabama,Washington County,3,1196,625,571
Alabama,Washington County,4,1147,610,537
Alabama,Washington County,5,1114,596,518
Alabama,Washington County,6,891,458,433
Alabama,Washington County,7,966,443,523
Alabama,Washington County,8,883,421,462
Alabama,Washington County,9,1059,501,558
Alabama,Washington County,10,1151,553,598
Alabama,Washington County,11,1308,649,659
Alabama,Washington County,12,1271,612,659
Alabama,Washington County,13,1131,533,598
Alabama,Washington County,14,977,472,505
Alabama,Washington County,15,749,340,409
Alabama,Washington County,16,501,240,261
Alabama,Washington County,17,380,171,209
Alabama,Washington County,18,261,88,173
Alabama,Wilcox County,0,11098,5281,5817
Alabama,Wilcox County,1,633,330,303
Alabama,Wilcox County,2,684,338,346
Alabama,Wilcox County,3,895,459,436
Alabama,Wilcox County,4,846,453,393
Alabama,Wilcox County,5,706,369,337
Alabama,Wilcox County,6,540,254,286
Alabama,Wilcox County,7,600,287,313
Alabama,Wilcox County,8,594,246,348
Alabama,Wilcox County,9,650,302,348
Alabama,Wilcox County,10,647,299,348
Alabama,Wilcox County,11,750,344,406
Alabama,Wilcox County,12,816,397,419
Alabama,Wilcox County,13,769,371,398
Alabama,Wilcox County,14,661,315,346
Alabama,Wilcox County,15,461,226,235
Alabama,Wilcox County,16,367,159,208
Alabama,Wilcox County,17,252,71,181
Alabama,Wilcox County,18,227,61,166
Alabama,Winston County,0,24150,11865,12285
Alabama,Winston County,1,1219,623,596
Alabama,Winston County,2,1392,692,700
Alabama,Winston County,3,1499,748,751
Alabama,Winston County,4,1438,723,715
Alabama,Winston County,5,1310,672,638
Alabama,Winston County,6,1285,653,632
Alabama,Winston County,7,1238,599,639
Alabama,Winston County,8,1358,685,673
Alabama,Winston County,9,1569,806,763
Alabama,Winston County,10,1691,846,845
Alabama,Winston County,11,1872,929,943
Alabama,Winston County,12,1780,903,877
Alabama,Winston County,13,1659,832,827
Alabama,Winston County,14,1621,788,833
Alabama,Winston County,15,1267,557,710
Alabama,Winston County,16,907,434,473
Alabama,Winston County,17,572,244,328
Alabama,Winston County,18,473,131,342
Alaska,Aleutians East Borough,0,3360,2323,1037
Alaska,Aleutians East Borough,1,94,55,39
Alaska,Aleutians East Borough,2,90,52,38
Alaska,Aleutians East Borough,3,96,48,48
Alaska,Aleutians East Borough,4,150,97,53
Alaska,Aleutians East Borough,5,330,264,66
Alaska,Aleutians East Borough,6,304,229,75
Alaska,Aleutians East Borough,7,245,178,67
Alaska,Aleutians East Borough,8,279,216,63
Alaska,Aleutians East Borough,9,331,237,94
Alaska,Aleutians East Borough,10,380,282,98
Alaska,Aleutians East Borough,11,381,252,129
Alaska,Aleutians East Borough,12,271,179,92
Alaska,Aleutians East Borough,13,186,106,80
Alaska,Aleutians East Borough,14,95,55,40
Alaska,Aleutians East Borough,15,51,31,20
Alaska,Aleutians East Borough,16,34,21,13
Alaska,Aleutians East Borough,17,20,11,9
Alaska,Aleutians East Borough,18,23,10,13
Alaska,Aleutians West Census Area,0,5750,3887,1863
Alaska,Aleutians West Census Area,1,207,111,96
Alaska,Aleutians West Census Area,2,199,96,103
Alaska,Aleutians West Census Area,3,188,94,94
Alaska,Aleutians West Census Area,4,226,135,91
Alaska,Aleutians West Census Area,5,426,287,139
Alaska,Aleutians West Census Area,6,502,377,125
Alaska,Aleutians West Census Area,7,483,352,131
Alaska,Aleutians West Census Area,8,496,344,152
Alaska,Aleutians West Census Area,9,591,425,166
Alaska,Aleutians West Census Area,10,625,438,187
Alaska,Aleutians West Census Area,11,614,432,182
Alaska,Aleutians West Census Area,12,514,354,160
Alaska,Aleutians West Census Area,13,368,247,121
Alaska,Aleutians West Census Area,14,184,123,61
Alaska,Aleutians West Census Area,15,70,46,24
Alaska,Aleutians West Census Area,16,25,16,9
Alaska,Aleutians West Census Area,17,15,6,9
Alaska,Aleutians West Census Area,18,17,4,13
Alaska,Anchorage Municipality,0,301010,154711,146299
Alaska,Anchorage Municipality,1,22163,11488,10675
Alaska,Anchorage Municipality,2,20856,10764,10092
Alaska,Anchorage Municipality,3,19870,10274,9596
Alaska,Anchorage Municipality,4,19838,10418,9420
Alaska,Anchorage Municipality,5,27503,15698,11805
Alaska,Anchorage Municipality,6,28121,14973,13148
Alaska,Anchorage Municipality,7,24367,12639,11728
Alaska,Anchorage Municipality,8,19060,9641,9419
Alaska,Anchorage Municipality,9,18511,9292,9219
Alaska,Anchorage Municipality,10,18237,9130,9107
Alaska,Anchorage Municipality,11,20643,10297,10346
Alaska,Anchorage Municipality,12,19624,9708,9916
Alaska,Anchorage Municipality,13,15498,7859,7639
Alaska,Anchorage Municipality,14,11093,5521,5572
Alaska,Anchorage Municipality,15,6554,3200,3354
Alaska,Anchorage Municipality,16,3936,1823,2113
Alaska,Anchorage Municipality,17,2597,1084,1513
Alaska,Anchorage Municipality,18,2539,902,1637
Alaska,Bethel Census Area,0,17868,9231,8637
Alaska,Bethel Census Area,1,1988,998,990
Alaska,Bethel Census Area,2,1773,878,895
Alaska,Bethel Census Area,3,1677,884,793
Alaska,Bethel Census Area,4,1530,789,741
Alaska,Bethel Census Area,5,1440,722,718
Alaska,Bethel Census Area,6,1450,757,693
Alaska,Bethel Census Area,7,1217,619,598
Alaska,Bethel Census Area,8,954,497,457
Alaska,Bethel Census Area,9,860,424,436
Alaska,Bethel Census Area,10,986,564,422
Alaska,Bethel Census Area,11,1108,608,500
Alaska,Bethel Census Area,12,968,510,458
Alaska,Bethel Census Area,13,734,393,341
Alaska,Bethel Census Area,14,457,243,214
Alaska,Bethel Census Area,15,340,167,173
Alaska,Bethel Census Area,16,169,86,83
Alaska,Bethel Census Area,17,130,48,82
Alaska,Bethel Census Area,18,87,44,43
Alaska,Bristol Bay Borough,0,957,533,424
Alaska,Bristol Bay Borough,1,50,33,17
Alaska,Bristol Bay Borough,2,49,26,23
Alaska,Bristol Bay Borough,3,58,27,31
Alaska,Bristol Bay Borough,4,63,33,30
Alaska,Bristol Bay Borough,5,63,37,26
Alaska,Bristol Bay Borough,6,65,39,26
Alaska,Bristol Bay Borough,7,60,31,29
Alaska,Bristol Bay Borough,8,60,33,27
Alaska,Bristol Bay Borough,9,54,28,26
Alaska,Bristol Bay Borough,10,73,45,28
Alaska,Bristol Bay Borough,11,107,58,49
Alaska,Bristol Bay Borough,12,92,49,43
Alaska,Bristol Bay Borough,13,70,38,32
Alaska,Bristol Bay Borough,14,36,24,12
Alaska,Bristol Bay Borough,15,24,16,8
Alaska,Bristol Bay Borough,16,20,10,10
Alaska,Bristol Bay Borough,17,12,6,6
Alaska,Bristol Bay Borough,18,1,0,1
Alaska,Denali Borough,0,1921,1045,876
Alaska,Denali Borough,1,90,45,45
Alaska,Denali Borough,2,91,46,45
Alaska,Denali Borough,3,111,56,55
Alaska,Denali Borough,4,97,49,48
Alaska,Denali Borough,5,106,62,44
Alaska,Denali Borough,6,135,74,61
Alaska,Denali Borough,7,148,82,66
Alaska,Denali Borough,8,142,70,72
Alaska,Denali Borough,9,136,74,62
Alaska,Denali Borough,10,167,98,69
Alaska,Denali Borough,11,222,104,118
Alaska,Denali Borough,12,147,84,63
Alaska,Denali Borough,13,165,98,67
Alaska,Denali Borough,14,77,51,26
Alaska,Denali Borough,15,46,28,18
Alaska,Denali Borough,16,26,16,10
Alaska,Denali Borough,17,7,4,3
Alaska,Denali Borough,18,8,4,4
Alaska,Dillingham Census Area,0,4988,2562,2426
Alaska,Dillingham Census Area,1,549,267,282
Alaska,Dillingham Census Area,2,407,205,202
Alaska,Dillingham Census Area,3,384,205,179
Alaska,Dillingham Census Area,4,404,208,196
Alaska,Dillingham Census Area,5,422,225,197
Alaska,Dillingham Census Area,6,367,183,184
Alaska,Dillingham Census Area,7,310,162,148
Alaska,Dillingham Census Area,8,246,129,117
Alaska,Dillingham Census Area,9,232,115,117
Alaska,Dillingham Census Area,10,298,148,150
Alaska,Dillingham Census Area,11,333,175,158
Alaska,Dillingham Census Area,12,356,191,165
Alaska,Dillingham Census Area,13,284,146,138
Alaska,Dillingham Census Area,14,145,75,70
Alaska,Dillingham Census Area,15,108,50,58
Alaska,Dillingham Census Area,16,68,37,31
Alaska,Dillingham Census Area,17,38,24,14
Alaska,Dillingham Census Area,18,37,17,20
Alaska,Fairbanks North Star Borough,0,99357,53759,45598
Alaska,Fairbanks North Star Borough,1,7610,3918,3692
Alaska,Fairbanks North Star Borough,2,6763,3443,3320
Alaska,Fairbanks North Star Borough,3,6118,3185,2933
Alaska,Fairbanks North Star Borough,4,6282,3371,2911
Alaska,Fairbanks North Star Borough,5,11868,7667,4201
Alaska,Fairbanks North Star Borough,6,10289,5928,4361
Alaska,Fairbanks North Star Borough,7,8287,4504,3783
Alaska,Fairbanks North Star Borough,8,6218,3276,2942
Alaska,Fairbanks North Star Borough,9,5551,2903,2648
Alaska,Fairbanks North Star Borough,10,5290,2693,2597
Alaska,Fairbanks North Star Borough,11,6035,3035,3000
Alaska,Fairbanks North Star Borough,12,6014,3071,2943
Alaska,Fairbanks North Star Borough,13,5119,2744,2375
Alaska,Fairbanks North Star Borough,14,3440,1901,1539
Alaska,Fairbanks North Star Borough,15,1970,1019,951
Alaska,Fairbanks North Star Borough,16,1144,551,593
Alaska,Fairbanks North Star Borough,17,700,317,383
Alaska,Fairbanks North Star Borough,18,659,233,426
Alaska,Haines Borough,0,2566,1257,1309
Alaska,Haines Borough,1,96,52,44
Alaska,Haines Borough,2,138,54,84
Alaska,Haines Borough,3,167,73,94
Alaska,Haines Borough,4,145,79,66
Alaska,Haines Borough,5,100,45,55
Alaska,Haines Borough,6,119,56,63
Alaska,Haines Borough,7,138,70,68
Alaska,Haines Borough,8,142,76,66
Alaska,Haines Borough,9,156,76,80
Alaska,Haines Borough,10,188,83,105
Alaska,Haines Borough,11,237,123,114
Alaska,Haines Borough,12,257,128,129
Alaska,Haines Borough,13,253,130,123
Alaska,Haines Borough,14,197,105,92
Alaska,Haines Borough,15,97,52,45
Alaska,Haines Borough,16,52,22,30
Alaska,Haines Borough,17,49,19,30
Alaska,Haines Borough,18,35,14,21
Alaska,Juneau City and Borough,0,32406,16580,15826
Alaska,Juneau City and Borough,1,1920,1019,901
Alaska,Juneau City and Borough,2,1973,1010,963
Alaska,Juneau City and Borough,3,1979,1024,955
Alaska,Juneau City and Borough,4,2129,1103,1026
Alaska,Juneau City and Borough,5,2212,1139,1073
Alaska,Juneau City and Borough,6,2488,1307,1181
Alaska,Juneau City and Borough,7,2515,1277,1238
Alaska,Juneau City and Borough,8,2063,1087,976
Alaska,Juneau City and Borough,9,2129,1085,1044
Alaska,Juneau City and Borough,10,2253,1153,1100
Alaska,Juneau City and Borough,11,2614,1369,1245
Alaska,Juneau City and Borough,12,2550,1317,1233
Alaska,Juneau City and Borough,13,2145,1091,1054
Alaska,Juneau City and Borough,14,1484,766,718
Alaska,Juneau City and Borough,15,836,389,447
Alaska,Juneau City and Borough,16,496,242,254
Alaska,Juneau City and Borough,17,274,96,178
Alaska,Juneau City and Borough,18,346,106,240
Alaska,Kenai Peninsula Borough,0,57477,30128,27349
Alaska,Kenai Peninsula Borough,1,3707,1925,1782
Alaska,Kenai Peninsula Borough,2,3636,1869,1767
Alaska,Kenai Peninsula Borough,3,3600,1831,1769
Alaska,Kenai Peninsula Borough,4,3663,1919,1744
Alaska,Kenai Peninsula Borough,5,3757,2148,1609
Alaska,Kenai Peninsula Borough,6,3509,1911,1598
Alaska,Kenai Peninsula Borough,7,3581,1894,1687
Alaska,Kenai Peninsula Borough,8,3194,1671,1523
Alaska,Kenai Peninsula Borough,9,3340,1770,1570
Alaska,Kenai Peninsula Borough,10,3448,1749,1699
Alaska,Kenai Peninsula Borough,11,4453,2325,2128
Alaska,Kenai Peninsula Borough,12,4853,2489,2364
Alaska,Kenai Peninsula Borough,13,4573,2361,2212
Alaska,Kenai Peninsula Borough,14,3337,1801,1536
Alaska,Kenai Peninsula Borough,15,2192,1195,997
Alaska,Kenai Peninsula Borough,16,1198,625,573
Alaska,Kenai Peninsula Borough,17,795,390,405
Alaska,Kenai Peninsula Borough,18,641,255,386
Alaska,Ketchikan Gateway Borough,0,13787,7178,6609
Alaska,Ketchikan Gateway Borough,1,890,439,451
Alaska,Ketchikan Gateway Borough,2,807,399,408
Alaska,Ketchikan Gateway Borough,3,880,475,405
Alaska,Ketchikan Gateway Borough,4,856,455,401
Alaska,Ketchikan Gateway Borough,5,944,548,396
Alaska,Ketchikan Gateway Borough,6,948,502,446
Alaska,Ketchikan Gateway Borough,7,934,504,430
Alaska,Ketchikan Gateway Borough,8,792,409,383
Alaska,Ketchikan Gateway Borough,9,844,436,408
Alaska,Ketchikan Gateway Borough,10,902,428,474
Alaska,Ketchikan Gateway Borough,11,1148,624,524
Alaska,Ketchikan Gateway Borough,12,1139,570,569
Alaska,Ketchikan Gateway Borough,13,983,518,465
Alaska,Ketchikan Gateway Borough,14,696,356,340
Alaska,Ketchikan Gateway Borough,15,442,236,206
Alaska,Ketchikan Gateway Borough,16,256,142,114
Alaska,Ketchikan Gateway Borough,17,159,69,90
Alaska,Ketchikan Gateway Borough,18,167,68,99
Alaska,Kodiak Island Borough,0,13986,7529,6457
Alaska,Kodiak Island Borough,1,1122,614,508
Alaska,Kodiak Island Borough,2,1011,531,480
Alaska,Kodiak Island Borough,3,929,512,417
Alaska,Kodiak Island Borough,4,938,503,435
Alaska,Kodiak Island Borough,5,1096,639,457
Alaska,Kodiak Island Borough,6,1185,685,500
Alaska,Kodiak Island Borough,7,1078,563,515
Alaska,Kodiak Island Borough,8,947,498,449
Alaska,Kodiak Island Borough,9,816,424,392
Alaska,Kodiak Island Borough,10,915,478,437
Alaska,Kodiak Island Borough,11,1027,554,473
Alaska,Kodiak Island Borough,12,987,541,446
Alaska,Kodiak Island Borough,13,727,394,333
Alaska,Kodiak Island Borough,14,524,271,253
Alaska,Kodiak Island Borough,15,322,153,169
Alaska,Kodiak Island Borough,16,189,98,91
Alaska,Kodiak Island Borough,17,97,46,51
Alaska,Kodiak Island Borough,18,76,25,51
Alaska,Lake and Peninsula Borough,0,1631,863,768
Alaska,Lake and Peninsula Borough,1,151,85,66
Alaska,Lake and Peninsula Borough,2,123,67,56
Alaska,Lake and Peninsula Borough,3,120,58,62
Alaska,Lake and Peninsula Borough,4,117,66,51
Alaska,Lake and Peninsula Borough,5,126,50,76
Alaska,Lake and Peninsula Borough,6,132,74,58
Alaska,Lake and Peninsula Borough,7,120,60,60
Alaska,Lake and Peninsula Borough,8,110,69,41
Alaska,Lake and Peninsula Borough,9,72,39,33
Alaska,Lake and Peninsula Borough,10,85,50,35
Alaska,Lake and Peninsula Borough,11,135,77,58
Alaska,Lake and Peninsula Borough,12,116,59,57
Alaska,Lake and Peninsula Borough,13,78,31,47
Alaska,Lake and Peninsula Borough,14,62,38,24
Alaska,Lake and Peninsula Borough,15,37,19,18
Alaska,Lake and Peninsula Borough,16,20,10,10
Alaska,Lake and Peninsula Borough,17,13,5,8
Alaska,Lake and Peninsula Borough,18,14,6,8
Alaska,Nome Census Area,0,9817,5147,4670
Alaska,Nome Census Area,1,1090,561,529
Alaska,Nome Census Area,2,967,512,455
Alaska,Nome Census Area,3,863,433,430
Alaska,Nome Census Area,4,777,410,367
Alaska,Nome Census Area,5,772,398,374
Alaska,Nome Census Area,6,794,409,385
Alaska,Nome Census Area,7,641,343,298
Alaska,Nome Census Area,8,558,274,284
Alaska,Nome Census Area,9,519,264,255
Alaska,Nome Census Area,10,517,291,226
Alaska,Nome Census Area,11,590,311,279
Alaska,Nome Census Area,12,554,317,237
Alaska,Nome Census Area,13,454,245,209
Alaska,Nome Census Area,14,310,186,124
Alaska,Nome Census Area,15,177,94,83
Alaska,Nome Census Area,16,100,42,58
Alaska,Nome Census Area,17,71,27,44
Alaska,Nome Census Area,18,63,30,33
Alaska,North Slope Borough,0,9703,6064,3639
Alaska,North Slope Borough,1,833,427,406
Alaska,North Slope Borough,2,708,362,346
Alaska,North Slope Borough,3,631,322,309
Alaska,North Slope Borough,4,523,275,248
Alaska,North Slope Borough,5,690,393,297
Alaska,North Slope Borough,6,833,510,323
Alaska,North Slope Borough,7,739,486,253
Alaska,North Slope Borough,8,635,425,210
Alaska,North Slope Borough,9,591,409,182
Alaska,North Slope Borough,10,756,547,209
Alaska,North Slope Borough,11,926,655,271
Alaska,North Slope Borough,12,852,626,226
Alaska,North Slope Borough,13,520,368,152
Alaska,North Slope Borough,14,218,136,82
Alaska,North Slope Borough,15,109,70,39
Alaska,North Slope Borough,16,70,27,43
Alaska,North Slope Borough,17,37,14,23
Alaska,North Slope Borough,18,32,12,20
Alaska,Northwest Arctic Borough,0,7717,4184,3533
Alaska,Northwest Arctic Borough,1,884,487,397
Alaska,Northwest Arctic Borough,2,807,436,371
Alaska,Northwest Arctic Borough,3,664,330,334
Alaska,Northwest Arctic Borough,4,650,320,330
Alaska,Northwest Arctic Borough,5,653,374,279
Alaska,Northwest Arctic Borough,6,688,374,314
Alaska,Northwest Arctic Borough,7,504,263,241
Alaska,Northwest Arctic Borough,8,389,226,163
Alaska,Northwest Arctic Borough,9,368,198,170
Alaska,Northwest Arctic Borough,10,438,261,177
Alaska,Northwest Arctic Borough,11,474,272,202
Alaska,Northwest Arctic Borough,12,409,239,170
Alaska,Northwest Arctic Borough,13,260,155,105
Alaska,Northwest Arctic Borough,14,208,106,102
Alaska,Northwest Arctic Borough,15,113,63,50
Alaska,Northwest Arctic Borough,16,102,57,45
Alaska,Northwest Arctic Borough,17,51,11,40
Alaska,Northwest Arctic Borough,18,55,12,43
Alaska,Petersburg Borough,0,3160,1637,1523
Alaska,Petersburg Borough,1,211,92,119
Alaska,Petersburg Borough,2,185,99,86
Alaska,Petersburg Borough,3,190,91,99
Alaska,Petersburg Borough,4,181,104,77
Alaska,Petersburg Borough,5,198,107,91
Alaska,Petersburg Borough,6,191,93,98
Alaska,Petersburg Borough,7,211,101,110
Alaska,Petersburg Borough,8,203,118,85
Alaska,Petersburg Borough,9,183,96,87
Alaska,Petersburg Borough,10,199,110,89
Alaska,Petersburg Borough,11,264,138,126
Alaska,Petersburg Borough,12,270,128,142
Alaska,Petersburg Borough,13,255,133,122
Alaska,Petersburg Borough,14,180,102,78
Alaska,Petersburg Borough,15,115,71,44
Alaska,Petersburg Borough,16,46,21,25
Alaska,Petersburg Borough,17,39,16,23
Alaska,Petersburg Borough,18,39,17,22
Alaska,Sitka City and Borough,0,8900,4565,4335
Alaska,Sitka City and Borough,1,547,283,264
Alaska,Sitka City and Borough,2,580,319,261
Alaska,Sitka City and Borough,3,538,269,269
Alaska,Sitka City and Borough,4,511,292,219
Alaska,Sitka City and Borough,5,552,291,261
Alaska,Sitka City and Borough,6,610,300,310
Alaska,Sitka City and Borough,7,650,345,305
Alaska,Sitka City and Borough,8,611,327,284
Alaska,Sitka City and Borough,9,573,300,273
Alaska,Sitka City and Borough,10,555,283,272
Alaska,Sitka City and Borough,11,656,327,329
Alaska,Sitka City and Borough,12,734,362,372
Alaska,Sitka City and Borough,13,610,316,294
Alaska,Sitka City and Borough,14,408,206,202
Alaska,Sitka City and Borough,15,269,146,123
Alaska,Sitka City and Borough,16,215,98,117
Alaska,Sitka City and Borough,17,128,57,71
Alaska,Sitka City and Borough,18,153,44,109
Alaska,Skagway Municipality,0,1036,543,493
Alaska,Skagway Municipality,1,54,31,23
Alaska,Skagway Municipality,2,39,18,21
Alaska,Skagway Municipality,3,25,16,9
Alaska,Skagway Municipality,4,32,19,13
Alaska,Skagway Municipality,5,62,25,37
Alaska,Skagway Municipality,6,79,41,38
Alaska,Skagway Municipality,7,122,64,58
Alaska,Skagway Municipality,8,102,44,58
Alaska,Skagway Municipality,9,74,41,33
Alaska,Skagway Municipality,10,81,41,40
Alaska,Skagway Municipality,11,74,44,30
Alaska,Skagway Municipality,12,87,46,41
Alaska,Skagway Municipality,13,95,57,38
Alaska,Skagway Municipality,14,50,30,20
Alaska,Skagway Municipality,15,26,10,16
Alaska,Skagway Municipality,16,15,9,6
Alaska,Skagway Municipality,17,9,2,7
Alaska,Skagway Municipality,18,10,5,5
Alaska,Southeast Fairbanks Census Area,0,6931,3851,3080
Alaska,Southeast Fairbanks Census Area,1,534,282,252
Alaska,Southeast Fairbanks Census Area,2,461,214,247
Alaska,Southeast Fairbanks Census Area,3,503,284,219
Alaska,Southeast Fairbanks Census Area,4,422,225,197
Alaska,Southeast Fairbanks Census Area,5,472,268,204
Alaska,Southeast Fairbanks Census Area,6,460,258,202
Alaska,Southeast Fairbanks Census Area,7,458,265,193
Alaska,Southeast Fairbanks Census Area,8,404,225,179
Alaska,Southeast Fairbanks Census Area,9,423,240,183
Alaska,Southeast Fairbanks Census Area,10,449,249,200
Alaska,Southeast Fairbanks Census Area,11,513,315,198
Alaska,Southeast Fairbanks Census Area,12,523,285,238
Alaska,Southeast Fairbanks Census Area,13,480,279,201
Alaska,Southeast Fairbanks Census Area,14,329,190,139
Alaska,Southeast Fairbanks Census Area,15,244,149,95
Alaska,Southeast Fairbanks Census Area,16,139,70,69
Alaska,Southeast Fairbanks Census Area,17,63,33,30
Alaska,Southeast Fairbanks Census Area,18,54,20,34
Alaska,Wade Hampton Census Area,0,8010,4206,3804
Alaska,Wade Hampton Census Area,1,1095,579,516
Alaska,Wade Hampton Census Area,2,910,505,405
Alaska,Wade Hampton Census Area,3,840,429,411
Alaska,Wade Hampton Census Area,4,789,404,385
Alaska,Wade Hampton Census Area,5,702,347,355
Alaska,Wade Hampton Census Area,6,692,384,308
Alaska,Wade Hampton Census Area,7,469,250,219
Alaska,Wade Hampton Census Area,8,358,190,168
Alaska,Wade Hampton Census Area,9,314,161,153
Alaska,Wade Hampton Census Area,10,391,208,183
Alaska,Wade Hampton Census Area,11,430,230,200
Alaska,Wade Hampton Census Area,12,348,202,146
Alaska,Wade Hampton Census Area,13,254,136,118
Alaska,Wade Hampton Census Area,14,170,89,81
Alaska,Wade Hampton Census Area,15,109,41,68
Alaska,Wade Hampton Census Area,16,72,28,44
Alaska,Wade Hampton Census Area,17,43,19,24
Alaska,Wade Hampton Census Area,18,24,4,20
Alaska,Wrangell City and Borough,0,2364,1225,1139
Alaska,Wrangell City and Borough,1,113,42,71
Alaska,Wrangell City and Borough,2,131,65,66
Alaska,Wrangell City and Borough,3,145,77,68
Alaska,Wrangell City and Borough,4,154,80,74
Alaska,Wrangell City and Borough,5,134,78,56
Alaska,Wrangell City and Borough,6,128,67,61
Alaska,Wrangell City and Borough,7,122,65,57
Alaska,Wrangell City and Borough,8,79,37,42
Alaska,Wrangell City and Borough,9,117,57,60
Alaska,Wrangell City and Borough,10,143,72,71
Alaska,Wrangell City and Borough,11,204,99,105
Alaska,Wrangell City and Borough,12,255,133,122
Alaska,Wrangell City and Borough,13,217,126,91
Alaska,Wrangell City and Borough,14,171,97,74
Alaska,Wrangell City and Borough,15,92,44,48
Alaska,Wrangell City and Borough,16,81,48,33
Alaska,Wrangell City and Borough,17,51,30,21
Alaska,Wrangell City and Borough,18,27,8,19
Alaska,Yakutat City and Borough,0,635,352,283
Alaska,Yakutat City and Borough,1,36,17,19
Alaska,Yakutat City and Borough,2,26,15,11
Alaska,Yakutat City and Borough,3,35,17,18
Alaska,Yakutat City and Borough,4,40,20,20
Alaska,Yakutat City and Borough,5,50,30,20
Alaska,Yakutat City and Borough,6,41,22,19
Alaska,Yakutat City and Borough,7,38,22,16
Alaska,Yakutat City and Borough,8,38,21,17
Alaska,Yakutat City and Borough,9,40,22,18
Alaska,Yakutat City and Borough,10,57,36,21
Alaska,Yakutat City and Borough,11,50,29,21
Alaska,Yakutat City and Borough,12,52,32,20
Alaska,Yakutat City and Borough,13,51,31,20
Alaska,Yakutat City and Borough,14,34,18,16
Alaska,Yakutat City and Borough,15,16,10,6
Alaska,Yakutat City and Borough,16,17,8,9
Alaska,Yakutat City and Borough,17,6,0,6
Alaska,Yakutat City and Borough,18,8,2,6
Arizona,Apache County,0,71828,35513,36315
Arizona,Apache County,1,5482,2772,2710
Arizona,Apache County,2,5980,2969,3011
Arizona,Apache County,3,5972,2936,3036
Arizona,Apache County,4,5734,2880,2854
Arizona,Apache County,5,5241,2720,2521
Arizona,Apache County,6,4415,2307,2108
Arizona,Apache County,7,4028,2104,1924
Arizona,Apache County,8,3849,1939,1910
Arizona,Apache County,9,3944,1999,1945
Arizona,Apache County,10,4260,2098,2162
Arizona,Apache County,11,4782,2378,2404
Arizona,Apache County,12,4565,2137,2428
Arizona,Apache County,13,3911,1864,2047
Arizona,Apache County,14,3249,1526,1723
Arizona,Apache County,15,2549,1175,1374
Arizona,Apache County,16,1845,856,989
Arizona,Apache County,17,1099,477,622
Arizona,Apache County,18,923,376,547
Arizona,Cochise County,0,127448,64771,62677
Arizona,Cochise County,1,8243,4176,4067
Arizona,Cochise County,2,7972,4083,3889
Arizona,Cochise County,3,7706,3870,3836
Arizona,Cochise County,4,7915,4205,3710
Arizona,Cochise County,5,7967,4400,3567
Arizona,Cochise County,6,8039,4481,3558
Arizona,Cochise County,7,8297,4531,3766
Arizona,Cochise County,8,6927,3630,3297
Arizona,Cochise County,9,6576,3449,3127
Arizona,Cochise County,10,7086,3551,3535
Arizona,Cochise County,11,8164,4016,4148
Arizona,Cochise County,12,8689,4107,4582
Arizona,Cochise County,13,8476,4085,4391
Arizona,Cochise County,14,8031,3919,4112
Arizona,Cochise County,15,6730,3246,3484
Arizona,Cochise County,16,4912,2441,2471
Arizona,Cochise County,17,3049,1470,1579
Arizona,Cochise County,18,2669,1111,1558
Arizona,Coconino County,0,137682,67947,69735
Arizona,Coconino County,1,8334,4299,4035
Arizona,Coconino County,2,8581,4376,4205
Arizona,Coconino County,3,8199,4227,3972
Arizona,Coconino County,4,13099,6070,7029
Arizona,Coconino County,5,18947,8980,9967
Arizona,Coconino County,6,9865,5236,4629
Arizona,Coconino County,7,8598,4442,4156
Arizona,Coconino County,8,7577,3831,3746
Arizona,Coconino County,9,7286,3724,3562
Arizona,Coconino County,10,7273,3648,3625
Arizona,Coconino County,11,8365,4037,4328
Arizona,Coconino County,12,8672,4118,4554
Arizona,Coconino County,13,7634,3779,3855
Arizona,Coconino County,14,5777,2876,2901
Arizona,Coconino County,15,3910,1864,2046
Arizona,Coconino County,16,2453,1173,1280
Arizona,Coconino County,17,1570,714,856
Arizona,Coconino County,18,1542,553,989
Arizona,Gila County,0,53119,26359,26760
Arizona,Gila County,1,3016,1556,1460
Arizona,Gila County,2,3048,1579,1469
Arizona,Gila County,3,3020,1524,1496
Arizona,Gila County,4,2799,1441,1358
Arizona,Gila County,5,2778,1414,1364
Arizona,Gila County,6,2536,1303,1233
Arizona,Gila County,7,2389,1249,1140
Arizona,Gila County,8,2141,1069,1072
Arizona,Gila County,9,2378,1191,1187
Arizona,Gila County,10,2879,1408,1471
Arizona,Gila County,11,3502,1721,1781
Arizona,Gila County,12,4168,1988,2180
Arizona,Gila County,13,4318,2083,2235
Arizona,Gila County,14,4631,2278,2353
Arizona,Gila County,15,3804,1909,1895
Arizona,Gila County,16,2547,1267,1280
Arizona,Gila County,17,1811,878,933
Arizona,Gila County,18,1354,501,853
Arizona,Graham County,0,37957,20289,17668
Arizona,Graham County,1,2927,1495,1432
Arizona,Graham County,2,3154,1610,1544
Arizona,Graham County,3,2925,1457,1468
Arizona,Graham County,4,2871,1504,1367
Arizona,Graham County,5,3074,1701,1373
Arizona,Graham County,6,2867,1682,1185
Arizona,Graham County,7,2750,1688,1062
Arizona,Graham County,8,2459,1421,1038
Arizona,Graham County,9,2257,1331,926
Arizona,Graham County,10,2093,1220,873
Arizona,Graham County,11,2039,1066,973
Arizona,Graham County,12,2099,1109,990
Arizona,Graham County,13,1775,854,921
Arizona,Graham County,14,1549,759,790
Arizona,Graham County,15,1126,532,594
Arizona,Graham County,16,897,412,485
Arizona,Graham County,17,628,253,375
Arizona,Graham County,18,467,195,272
Arizona,Greenlee County,0,9346,4886,4460
Arizona,Greenlee County,1,634,307,327
Arizona,Greenlee County,2,814,423,391
Arizona,Greenlee County,3,694,362,332
Arizona,Greenlee County,4,741,424,317
Arizona,Greenlee County,5,580,298,282
Arizona,Greenlee County,6,662,337,325
Arizona,Greenlee County,7,703,386,317
Arizona,Greenlee County,8,614,313,301
Arizona,Greenlee County,9,548,290,258
Arizona,Greenlee County,10,582,291,291
Arizona,Greenlee County,11,590,324,266
Arizona,Greenlee County,12,587,335,252
Arizona,Greenlee County,13,517,269,248
Arizona,Greenlee County,14,334,192,142
Arizona,Greenlee County,15,275,131,144
Arizona,Greenlee County,16,180,95,85
Arizona,Greenlee County,17,182,82,100
Arizona,Greenlee County,18,109,27,82
Arizona,La Paz County,0,20231,10347,9884
Arizona,La Paz County,1,922,491,431
Arizona,La Paz County,2,1066,559,507
Arizona,La Paz County,3,956,498,458
Arizona,La Paz County,4,948,488,460
Arizona,La Paz County,5,915,495,420
Arizona,La Paz County,6,831,449,382
Arizona,La Paz County,7,836,450,386
Arizona,La Paz County,8,732,374,358
Arizona,La Paz County,9,789,403,386
Arizona,La Paz County,10,904,450,454
Arizona,La Paz County,11,1198,549,649
Arizona,La Paz County,12,1343,638,705
Arizona,La Paz County,13,1493,705,788
Arizona,La Paz County,14,1919,981,938
Arizona,La Paz County,15,2040,1016,1024
Arizona,La Paz County,16,1672,913,759
Arizona,La Paz County,17,1076,613,463
Arizona,La Paz County,18,591,275,316
Arizona,Maricopa County,0,4087191,2019993,2067198
Arizona,Maricopa County,1,272519,139274,133245
Arizona,Maricopa County,2,290854,148239,142615
Arizona,Maricopa County,3,289330,147690,141640
Arizona,Maricopa County,4,278458,142821,135637
Arizona,Maricopa County,5,286805,146284,140521
Arizona,Maricopa County,6,294070,149976,144094
Arizona,Maricopa County,7,285888,144243,141645
Arizona,Maricopa County,8,268540,133725,134815
Arizona,Maricopa County,9,274835,136679,138156
Arizona,Maricopa County,10,261078,130219,130859
Arizona,Maricopa County,11,266588,131167,135421
Arizona,Maricopa County,12,241884,116501,125383
Arizona,Maricopa County,13,210408,98776,111632
Arizona,Maricopa County,14,187400,87314,100086
Arizona,Maricopa County,15,139911,64542,75369
Arizona,Maricopa County,16,98941,45580,53361
Arizona,Maricopa County,17,69452,30661,38791
Arizona,Maricopa County,18,70230,26302,43928
Arizona,Mohave County,0,203361,102281,101080
Arizona,Mohave County,1,9374,4687,4687
Arizona,Mohave County,2,10749,5401,5348
Arizona,Mohave County,3,11000,5577,5423
Arizona,Mohave County,4,10604,5528,5076
Arizona,Mohave County,5,10071,5358,4713
Arizona,Mohave County,6,10241,5434,4807
Arizona,Mohave County,7,9725,5198,4527
Arizona,Mohave County,8,9248,4737,4511
Arizona,Mohave County,9,9933,5108,4825
Arizona,Mohave County,10,11164,5622,5542
Arizona,Mohave County,11,14251,6985,7266
Arizona,Mohave County,12,15801,7643,8158
Arizona,Mohave County,13,16445,7848,8597
Arizona,Mohave County,14,17553,8722,8831
Arizona,Mohave County,15,14859,7527,7332
Arizona,Mohave County,16,10905,5519,5386
Arizona,Mohave County,17,6430,3249,3181
Arizona,Mohave County,18,5008,2138,2870
Arizona,Navajo County,0,108101,54228,53873
Arizona,Navajo County,1,7912,4028,3884
Arizona,Navajo County,2,8811,4451,4360
Arizona,Navajo County,3,8359,4315,4044
Arizona,Navajo County,4,8027,4196,3831
Arizona,Navajo County,5,7268,3837,3431
Arizona,Navajo County,6,6382,3383,2999
Arizona,Navajo County,7,6077,3095,2982
Arizona,Navajo County,8,5623,2963,2660
Arizona,Navajo County,9,5779,2942,2837
Arizona,Navajo County,10,5987,3016,2971
Arizona,Navajo County,11,7104,3437,3667
Arizona,Navajo County,12,7065,3393,3672
Arizona,Navajo County,13,6646,3187,3459
Arizona,Navajo County,14,5904,2808,3096
Arizona,Navajo County,15,4666,2220,2446
Arizona,Navajo County,16,3137,1532,1605
Arizona,Navajo County,17,1767,806,961
Arizona,Navajo County,18,1587,619,968
Arizona,Pima County,0,1004516,494061,510455
Arizona,Pima County,1,59675,30473,29202
Arizona,Pima County,2,61680,31541,30139
Arizona,Pima County,3,61451,31113,30338
Arizona,Pima County,4,68211,34813,33398
Arizona,Pima County,5,91307,46607,44700
Arizona,Pima County,6,60498,31544,28954
Arizona,Pima County,7,62972,32106,30866
Arizona,Pima County,8,57176,28613,28563
Arizona,Pima County,9,57231,28468,28763
Arizona,Pima County,10,55970,27689,28281
Arizona,Pima County,11,63471,31061,32410
Arizona,Pima County,12,64882,30703,34179
Arizona,Pima County,13,61804,28876,32928
Arizona,Pima County,14,56690,26773,29917
Arizona,Pima County,15,43708,19974,23734
Arizona,Pima County,16,31583,14664,16919
Arizona,Pima County,17,22879,10208,12671
Arizona,Pima County,18,23328,8835,14493
Arizona,Pinal County,0,401918,209818,192100
Arizona,Pinal County,1,24240,12285,11955
Arizona,Pinal County,2,29777,15248,14529
Arizona,Pinal County,3,28206,14361,13845
Arizona,Pinal County,4,24697,12864,11833
Arizona,Pinal County,5,22959,13421,9538
Arizona,Pinal County,6,25462,14618,10844
Arizona,Pinal County,7,28458,15721,12737
Arizona,Pinal County,8,27375,15062,12313
Arizona,Pinal County,9,25841,14412,11429
Arizona,Pinal County,10,22426,12302,10124
Arizona,Pinal County,11,23240,12116,11124
Arizona,Pinal County,12,23255,11045,12210
Arizona,Pinal County,13,23533,11002,12531
Arizona,Pinal County,14,25844,12341,13503
Arizona,Pinal County,15,20266,10027,10239
Arizona,Pinal County,16,13225,6714,6511
Arizona,Pinal County,17,7657,3863,3794
Arizona,Pinal County,18,5457,2416,3041
Arizona,Santa Cruz County,0,46695,22412,24283
Arizona,Santa Cruz County,1,3391,1812,1579
Arizona,Santa Cruz County,2,3661,1879,1782
Arizona,Santa Cruz County,3,3828,1902,1926
Arizona,Santa Cruz County,4,3791,1966,1825
Arizona,Santa Cruz County,5,3078,1553,1525
Arizona,Santa Cruz County,6,2380,1184,1196
Arizona,Santa Cruz County,7,2430,1121,1309
Arizona,Santa Cruz County,8,2373,1049,1324
Arizona,Santa Cruz County,9,2773,1254,1519
Arizona,Santa Cruz County,10,2788,1276,1512
Arizona,Santa Cruz County,11,3028,1416,1612
Arizona,Santa Cruz County,12,3053,1405,1648
Arizona,Santa Cruz County,13,2752,1246,1506
Arizona,Santa Cruz County,14,2459,1164,1295
Arizona,Santa Cruz County,15,1920,919,1001
Arizona,Santa Cruz County,16,1298,594,704
Arizona,Santa Cruz County,17,932,385,547
Arizona,Santa Cruz County,18,760,287,473
Arizona,Yavapai County,0,218844,106914,111930
Arizona,Yavapai County,1,9011,4563,4448
Arizona,Yavapai County,2,10842,5438,5404
Arizona,Yavapai County,3,11054,5694,5360
Arizona,Yavapai County,4,11700,6268,5432
Arizona,Yavapai County,5,10404,5563,4841
Arizona,Yavapai County,6,9944,5099,4845
Arizona,Yavapai County,7,9734,4978,4756
Arizona,Yavapai County,8,9395,4606,4789
Arizona,Yavapai County,9,10248,4978,5270
Arizona,Yavapai County,10,11278,5417,5861
Arizona,Yavapai County,11,15135,7120,8015
Arizona,Yavapai County,12,18082,8369,9713
Arizona,Yavapai County,13,20422,9391,11031
Arizona,Yavapai County,14,20306,9845,10461
Arizona,Yavapai County,15,16278,7859,8419
Arizona,Yavapai County,16,10858,5361,5497
Arizona,Yavapai County,17,7266,3586,3680
Arizona,Yavapai County,18,6887,2779,4108
Arizona,Yuma County,0,203247,104028,99219
Arizona,Yuma County,1,15208,7773,7435
Arizona,Yuma County,2,14720,7564,7156
Arizona,Yuma County,3,14474,7239,7235
Arizona,Yuma County,4,15070,7982,7088
Arizona,Yuma County,5,17682,10455,7227
Arizona,Yuma County,6,13960,7562,6398
Arizona,Yuma County,7,12708,6883,5825
Arizona,Yuma County,8,11085,5794,5291
Arizona,Yuma County,9,11061,5399,5662
Arizona,Yuma County,10,11154,5582,5572
Arizona,Yuma County,11,11124,5473,5651
Arizona,Yuma County,12,10430,5000,5430
Arizona,Yuma County,13,9205,4355,4850
Arizona,Yuma County,14,9459,4466,4993
Arizona,Yuma County,15,9339,4309,5030
Arizona,Yuma County,16,7504,3754,3750
Arizona,Yuma County,17,5204,2638,2566
Arizona,Yuma County,18,3860,1800,2060
Arkansas,Arkansas County,0,18594,8993,9601
Arkansas,Arkansas County,1,1256,627,629
Arkansas,Arkansas County,2,1120,558,562
Arkansas,Arkansas County,3,1187,594,593
Arkansas,Arkansas County,4,1130,601,529
Arkansas,Arkansas County,5,1146,548,598
Arkansas,Arkansas County,6,1042,525,517
Arkansas,Arkansas County,7,1056,495,561
Arkansas,Arkansas County,8,1157,559,598
Arkansas,Arkansas County,9,1101,562,539
Arkansas,Arkansas County,10,1096,523,573
Arkansas,Arkansas County,11,1329,633,696
Arkansas,Arkansas County,12,1410,692,718
Arkansas,Arkansas County,13,1314,656,658
Arkansas,Arkansas County,14,1041,516,525
Arkansas,Arkansas County,15,739,340,399
Arkansas,Arkansas County,16,604,252,352
Arkansas,Arkansas County,17,431,168,263
Arkansas,Arkansas County,18,435,144,291
Arkansas,Ashley County,0,20948,10105,10843
Arkansas,Ashley County,1,1357,651,706
Arkansas,Ashley County,2,1334,658,676
Arkansas,Ashley County,3,1353,689,664
Arkansas,Ashley County,4,1338,697,641
Arkansas,Ashley County,5,1254,626,628
Arkansas,Ashley County,6,1108,524,584
Arkansas,Ashley County,7,1116,561,555
Arkansas,Ashley County,8,1175,536,639
Arkansas,Ashley County,9,1360,633,727
Arkansas,Ashley County,10,1359,667,692
Arkansas,Ashley County,11,1529,728,801
Arkansas,Ashley County,12,1457,719,738
Arkansas,Ashley County,13,1364,666,698
Arkansas,Ashley County,14,1262,598,664
Arkansas,Ashley County,15,1003,499,504
Arkansas,Ashley County,16,701,323,378
Arkansas,Ashley County,17,486,194,292
Arkansas,Ashley County,18,392,136,256
Arkansas,Baxter County,0,40857,19681,21176
Arkansas,Baxter County,1,1797,911,886
Arkansas,Baxter County,2,2139,1103,1036
Arkansas,Baxter County,3,2077,1079,998
Arkansas,Baxter County,4,1958,1022,936
Arkansas,Baxter County,5,1756,892,864
Arkansas,Baxter County,6,1806,879,927
Arkansas,Baxter County,7,1921,895,1026
Arkansas,Baxter County,8,1795,890,905
Arkansas,Baxter County,9,1997,978,1019
Arkansas,Baxter County,10,2237,1078,1159
Arkansas,Baxter County,11,2841,1314,1527
Arkansas,Baxter County,12,3074,1433,1641
Arkansas,Baxter County,13,3188,1467,1721
Arkansas,Baxter County,14,3541,1624,1917
Arkansas,Baxter County,15,3231,1538,1693
Arkansas,Baxter County,16,2399,1220,1179
Arkansas,Baxter County,17,1651,764,887
Arkansas,Baxter County,18,1449,594,855
Arkansas,Benton County,0,242321,119911,122410
Arkansas,Benton County,1,17427,8937,8490
Arkansas,Benton County,2,18942,9614,9328
Arkansas,Benton County,3,18624,9456,9168
Arkansas,Benton County,4,16082,8122,7960
Arkansas,Benton County,5,13894,7015,6879
Arkansas,Benton County,6,16565,8286,8279
Arkansas,Benton County,7,18789,9364,9425
Arkansas,Benton County,8,17407,8885,8522
Arkansas,Benton County,9,17050,8440,8610
Arkansas,Benton County,10,15520,7870,7650
Arkansas,Benton County,11,15485,7675,7810
Arkansas,Benton County,12,13677,6655,7022
Arkansas,Benton County,13,11456,5386,6070
Arkansas,Benton County,14,10357,4863,5494
Arkansas,Benton County,15,7766,3630,4136
Arkansas,Benton County,16,5669,2593,3076
Arkansas,Benton County,17,3841,1729,2112
Arkansas,Benton County,18,3770,1391,2379
Arkansas,Boone County,0,37196,18283,18913
Arkansas,Boone County,1,2239,1143,1096
Arkansas,Boone County,2,2303,1154,1149
Arkansas,Boone County,3,2369,1238,1131
Arkansas,Boone County,4,2252,1200,1052
Arkansas,Boone County,5,2196,1123,1073
Arkansas,Boone County,6,2037,1030,1007
Arkansas,Boone County,7,2127,1074,1053
Arkansas,Boone County,8,2082,1033,1049
Arkansas,Boone County,9,2316,1172,1144
Arkansas,Boone County,10,2306,1126,1180
Arkansas,Boone County,11,2660,1313,1347
Arkansas,Boone County,12,2518,1188,1330
Arkansas,Boone County,13,2425,1160,1265
Arkansas,Boone County,14,2301,1103,1198
Arkansas,Boone County,15,1838,875,963
Arkansas,Boone County,16,1378,626,752
Arkansas,Boone County,17,931,403,528
Arkansas,Boone County,18,918,322,596
Arkansas,Bradley County,0,11148,5448,5700
Arkansas,Bradley County,1,766,397,369
Arkansas,Bradley County,2,753,415,338
Arkansas,Bradley County,3,707,350,357
Arkansas,Bradley County,4,590,276,314
Arkansas,Bradley County,5,652,315,337
Arkansas,Bradley County,6,683,365,318
Arkansas,Bradley County,7,643,337,306
Arkansas,Bradley County,8,658,322,336
Arkansas,Bradley County,9,667,339,328
Arkansas,Bradley County,10,698,342,356
Arkansas,Bradley County,11,779,344,435
Arkansas,Bradley County,12,780,386,394
Arkansas,Bradley County,13,727,369,358
Arkansas,Bradley County,14,620,304,316
Arkansas,Bradley County,15,516,229,287
Arkansas,Bradley County,16,367,172,195
Arkansas,Bradley County,17,298,112,186
Arkansas,Bradley County,18,244,74,170
Arkansas,Calhoun County,0,5202,2645,2557
Arkansas,Calhoun County,1,259,135,124
Arkansas,Calhoun County,2,240,117,123
Arkansas,Calhoun County,3,256,126,130
Arkansas,Calhoun County,4,307,171,136
Arkansas,Calhoun County,5,381,212,169
Arkansas,Calhoun County,6,274,161,113
Arkansas,Calhoun County,7,260,147,113
Arkansas,Calhoun County,8,260,142,118
Arkansas,Calhoun County,9,311,145,166
Arkansas,Calhoun County,10,365,178,187
Arkansas,Calhoun County,11,473,255,218
Arkansas,Calhoun County,12,407,210,197
Arkansas,Calhoun County,13,379,196,183
Arkansas,Calhoun County,14,323,155,168
Arkansas,Calhoun County,15,242,112,130
Arkansas,Calhoun County,16,199,81,118
Arkansas,Calhoun County,17,136,54,82
Arkansas,Calhoun County,18,130,48,82
Arkansas,Carroll County,0,27744,13664,14080
Arkansas,Carroll County,1,1535,763,772
Arkansas,Carroll County,2,1709,878,831
Arkansas,Carroll County,3,1801,928,873
Arkansas,Carroll County,4,1646,826,820
Arkansas,Carroll County,5,1418,737,681
Arkansas,Carroll County,6,1438,761,677
Arkansas,Carroll County,7,1477,728,749
Arkansas,Carroll County,8,1416,701,715
Arkansas,Carroll County,9,1578,780,798
Arkansas,Carroll County,10,1638,828,810
Arkansas,Carroll County,11,1913,964,949
Arkansas,Carroll County,12,2119,988,1131
Arkansas,Carroll County,13,2193,1051,1142
Arkansas,Carroll County,14,2041,978,1063
Arkansas,Carroll County,15,1521,745,776
Arkansas,Carroll County,16,995,465,530
Arkansas,Carroll County,17,682,307,375
Arkansas,Carroll County,18,624,236,388
Arkansas,Chicot County,0,11180,5502,5678
Arkansas,Chicot County,1,744,369,375
Arkansas,Chicot County,2,770,384,386
Arkansas,Chicot County,3,644,335,309
Arkansas,Chicot County,4,650,328,322
Arkansas,Chicot County,5,682,400,282
Arkansas,Chicot County,6,576,323,253
Arkansas,Chicot County,7,653,348,305
Arkansas,Chicot County,8,558,285,273
Arkansas,Chicot County,9,659,331,328
Arkansas,Chicot County,10,643,309,334
Arkansas,Chicot County,11,802,396,406
Arkansas,Chicot County,12,888,452,436
Arkansas,Chicot County,13,759,365,394
Arkansas,Chicot County,14,600,264,336
Arkansas,Chicot County,15,518,234,284
Arkansas,Chicot County,16,388,147,241
Arkansas,Chicot County,17,301,121,180
Arkansas,Chicot County,18,345,111,234
Arkansas,Clark County,0,22576,10817,11759
Arkansas,Clark County,1,1114,652,462
Arkansas,Clark County,2,1272,628,644
Arkansas,Clark County,3,1193,591,602
Arkansas,Clark County,4,2298,1086,1212
Arkansas,Clark County,5,3333,1595,1738
Arkansas,Clark County,6,1286,657,629
Arkansas,Clark County,7,1131,568,563
Arkansas,Clark County,8,1078,500,578
Arkansas,Clark County,9,1189,598,591
Arkansas,Clark County,10,1139,533,606
Arkansas,Clark County,11,1356,615,741
Arkansas,Clark County,12,1362,657,705
Arkansas,Clark County,13,1200,561,639
Arkansas,Clark County,14,1089,536,553
Arkansas,Clark County,15,893,395,498
Arkansas,Clark County,16,657,292,365
Arkansas,Clark County,17,528,199,329
Arkansas,Clark County,18,458,154,304
Arkansas,Clay County,0,15118,7395,7723
Arkansas,Clay County,1,649,338,311
Arkansas,Clay County,2,897,448,449
Arkansas,Clay County,3,945,484,461
Arkansas,Clay County,4,909,475,434
Arkansas,Clay County,5,938,492,446
Arkansas,Clay County,6,761,381,380
Arkansas,Clay County,7,787,388,399
Arkansas,Clay County,8,866,442,424
Arkansas,Clay County,9,902,444,458
Arkansas,Clay County,10,1038,531,507
Arkansas,Clay County,11,1091,533,558
Arkansas,Clay County,12,1076,540,536
Arkansas,Clay County,13,1021,479,542
Arkansas,Clay County,14,972,461,511
Arkansas,Clay County,15,831,365,466
Arkansas,Clay County,16,629,290,339
Arkansas,Clay County,17,428,173,255
Arkansas,Clay County,18,378,131,247
Arkansas,Cleburne County,0,25634,12648,12986
Arkansas,Cleburne County,1,1227,627,600
Arkansas,Cleburne County,2,1422,698,724
Arkansas,Cleburne County,3,1491,761,730
Arkansas,Cleburne County,4,1391,715,676
Arkansas,Cleburne County,5,1219,648,571
Arkansas,Cleburne County,6,1253,664,589
Arkansas,Cleburne County,7,1303,651,652
Arkansas,Cleburne County,8,1273,616,657
Arkansas,Cleburne County,9,1348,706,642
Arkansas,Cleburne County,10,1595,800,795
Arkansas,Cleburne County,11,1913,944,969
Arkansas,Cleburne County,12,1905,916,989
Arkansas,Cleburne County,13,1784,840,944
Arkansas,Cleburne County,14,1912,946,966
Arkansas,Cleburne County,15,1726,812,914
Arkansas,Cleburne County,16,1260,617,643
Arkansas,Cleburne County,17,859,400,459
Arkansas,Cleburne County,18,753,287,466
Arkansas,Cleveland County,0,8449,4135,4314
Arkansas,Cleveland County,1,432,216,216
Arkansas,Cleveland County,2,586,289,297
Arkansas,Cleveland County,3,590,297,293
Arkansas,Cleveland County,4,532,260,272
Arkansas,Cleveland County,5,461,246,215
Arkansas,Cleveland County,6,449,217,232
Arkansas,Cleveland County,7,460,228,232
Arkansas,Cleveland County,8,461,202,259
Arkansas,Cleveland County,9,561,276,285
Arkansas,Cleveland County,10,517,293,224
Arkansas,Cleveland County,11,655,308,347
Arkansas,Cleveland County,12,579,304,275
Arkansas,Cleveland County,13,552,251,301
Arkansas,Cleveland County,14,550,269,281
Arkansas,Cleveland County,15,369,181,188
Arkansas,Cleveland County,16,328,148,180
Arkansas,Cleveland County,17,225,107,118
Arkansas,Cleveland County,18,142,43,99
Arkansas,Columbia County,0,23933,11484,12449
Arkansas,Columbia County,1,1384,701,683
Arkansas,Columbia County,2,1416,725,691
Arkansas,Columbia County,3,1380,706,674
Arkansas,Columbia County,4,2287,1141,1146
Arkansas,Columbia County,5,2626,1327,1299
Arkansas,Columbia County,6,1291,635,656
Arkansas,Columbia County,7,1319,614,705
Arkansas,Columbia County,8,1195,559,636
Arkansas,Columbia County,9,1293,584,709
Arkansas,Columbia County,10,1366,676,690
Arkansas,Columbia County,11,1516,713,803
Arkansas,Columbia County,12,1481,723,758
Arkansas,Columbia County,13,1396,697,699
Arkansas,Columbia County,14,1173,545,628
Arkansas,Columbia County,15,917,407,510
Arkansas,Columbia County,16,751,309,442
Arkansas,Columbia County,17,538,205,333
Arkansas,Columbia County,18,604,217,387
Arkansas,Conway County,0,21083,10356,10727
Arkansas,Conway County,1,1239,598,641
Arkansas,Conway County,2,1349,681,668
Arkansas,Conway County,3,1423,734,689
Arkansas,Conway County,4,1268,650,618
Arkansas,Conway County,5,1301,678,623
Arkansas,Conway County,6,1221,591,630
Arkansas,Conway County,7,1219,601,618
Arkansas,Conway County,8,1134,580,554
Arkansas,Conway County,9,1251,636,615
Arkansas,Conway County,10,1311,643,668
Arkansas,Conway County,11,1594,775,819
Arkansas,Conway County,12,1609,792,817
Arkansas,Conway County,13,1310,647,663
Arkansas,Conway County,14,1201,587,614
Arkansas,Conway County,15,939,451,488
Arkansas,Conway County,16,681,312,369
Arkansas,Conway County,17,530,210,320
Arkansas,Conway County,18,503,190,313
Arkansas,Craighead County,0,102518,49926,52592
Arkansas,Craighead County,1,7063,3594,3469
Arkansas,Craighead County,2,7313,3733,3580
Arkansas,Craighead County,3,7024,3636,3388
Arkansas,Craighead County,4,7508,3923,3585
Arkansas,Craighead County,5,8401,4199,4202
Arkansas,Craighead County,6,8331,4064,4267
Arkansas,Craighead County,7,7274,3554,3720
Arkansas,Craighead County,8,6564,3233,3331
Arkansas,Craighead County,9,6368,3170,3198
Arkansas,Craighead County,10,5965,2847,3118
Arkansas,Craighead County,11,6313,3082,3231
Arkansas,Craighead County,12,5877,2770,3107
Arkansas,Craighead County,13,5212,2463,2749
Arkansas,Craighead County,14,4396,1995,2401
Arkansas,Craighead County,15,3324,1457,1867
Arkansas,Craighead County,16,2297,1002,1295
Arkansas,Craighead County,17,1642,629,1013
Arkansas,Craighead County,18,1646,575,1071
Arkansas,Crawford County,0,61697,30395,31302
Arkansas,Crawford County,1,3698,1887,1811
Arkansas,Crawford County,2,4323,2190,2133
Arkansas,Crawford County,3,4572,2337,2235
Arkansas,Crawford County,4,4287,2189,2098
Arkansas,Crawford County,5,3611,1836,1775
Arkansas,Crawford County,6,3816,1905,1911
Arkansas,Crawford County,7,3730,1814,1916
Arkansas,Crawford County,8,3711,1803,1908
Arkansas,Crawford County,9,3964,1993,1971
Arkansas,Crawford County,10,4122,2048,2074
Arkansas,Crawford County,11,4506,2305,2201
Arkansas,Crawford County,12,4228,2056,2172
Arkansas,Crawford County,13,3666,1767,1899
Arkansas,Crawford County,14,3247,1538,1709
Arkansas,Crawford County,15,2481,1205,1276
Arkansas,Crawford County,16,1706,749,957
Arkansas,Crawford County,17,1096,464,632
Arkansas,Crawford County,18,933,309,624
Arkansas,Crittenden County,0,49548,23468,26080
Arkansas,Crittenden County,1,3819,1960,1859
Arkansas,Crittenden County,2,3894,1928,1966
Arkansas,Crittenden County,3,3847,1963,1884
Arkansas,Crittenden County,4,3548,1778,1770
Arkansas,Crittenden County,5,3479,1718,1761
Arkansas,Crittenden County,6,3270,1473,1797
Arkansas,Crittenden County,7,3149,1435,1714
Arkansas,Crittenden County,8,3045,1439,1606
Arkansas,Crittenden County,9,3009,1340,1669
Arkansas,Crittenden County,10,3099,1401,1698
Arkansas,Crittenden County,11,3444,1675,1769
Arkansas,Crittenden County,12,3277,1568,1709
Arkansas,Crittenden County,13,2666,1233,1433
Arkansas,Crittenden County,14,2071,970,1101
Arkansas,Crittenden County,15,1564,691,873
Arkansas,Crittenden County,16,1011,419,592
Arkansas,Crittenden County,17,683,260,423
Arkansas,Crittenden County,18,673,217,456
Arkansas,Cross County,0,17227,8367,8860
Arkansas,Cross County,1,1183,603,580
Arkansas,Cross County,2,1107,576,531
Arkansas,Cross County,3,1154,605,549
Arkansas,Cross County,4,1100,568,532
Arkansas,Cross County,5,1033,522,511
Arkansas,Cross County,6,910,444,466
Arkansas,Cross County,7,1011,493,518
Arkansas,Cross County,8,1011,475,536
Arkansas,Cross County,9,1096,536,560
Arkansas,Cross County,10,1066,532,534
Arkansas,Cross County,11,1302,624,678
Arkansas,Cross County,12,1187,580,607
Arkansas,Cross County,13,1037,486,551
Arkansas,Cross County,14,1027,484,543
Arkansas,Cross County,15,764,346,418
Arkansas,Cross County,16,513,231,282
Arkansas,Cross County,17,353,131,222
Arkansas,Cross County,18,373,131,242
Arkansas,Dallas County,0,7755,3748,4007
Arkansas,Dallas County,1,428,204,224
Arkansas,Dallas County,2,468,234,234
Arkansas,Dallas County,3,491,260,231
Arkansas,Dallas County,4,479,241,238
Arkansas,Dallas County,5,416,216,200
Arkansas,Dallas County,6,450,234,216
Arkansas,Dallas County,7,424,232,192
Arkansas,Dallas County,8,373,163,210
Arkansas,Dallas County,9,456,247,209
Arkansas,Dallas County,10,427,204,223
Arkansas,Dallas County,11,566,264,302
Arkansas,Dallas County,12,598,307,291
Arkansas,Dallas County,13,589,303,286
Arkansas,Dallas County,14,478,207,271
Arkansas,Dallas County,15,393,162,231
Arkansas,Dallas County,16,280,124,156
Arkansas,Dallas County,17,207,76,131
Arkansas,Dallas County,18,232,70,162
Arkansas,Desha County,0,12264,5740,6524
Arkansas,Desha County,1,838,416,422
Arkansas,Desha County,2,933,455,478
Arkansas,Desha County,3,863,431,432
Arkansas,Desha County,4,767,362,405
Arkansas,Desha County,5,741,359,382
Arkansas,Desha County,6,705,329,376
Arkansas,Desha County,7,696,315,381
Arkansas,Desha County,8,654,315,339
Arkansas,Desha County,9,645,294,351
Arkansas,Desha County,10,703,318,385
Arkansas,Desha County,11,827,371,456
Arkansas,Desha County,12,974,483,491
Arkansas,Desha County,13,816,388,428
Arkansas,Desha County,14,677,324,353
Arkansas,Desha County,15,550,236,314
Arkansas,Desha County,16,357,165,192
Arkansas,Desha County,17,267,88,179
Arkansas,Desha County,18,251,91,160
Arkansas,Drew County,0,18622,9091,9531
Arkansas,Drew County,1,1173,654,519
Arkansas,Drew County,2,1102,563,539
Arkansas,Drew County,3,1159,619,540
Arkansas,Drew County,4,1474,725,749
Arkansas,Drew County,5,1867,957,910
Arkansas,Drew County,6,1095,567,528
Arkansas,Drew County,7,1061,517,544
Arkansas,Drew County,8,1001,484,517
Arkansas,Drew County,9,1054,483,571
Arkansas,Drew County,10,1057,479,578
Arkansas,Drew County,11,1280,590,690
Arkansas,Drew County,12,1204,616,588
Arkansas,Drew County,13,1093,521,572
Arkansas,Drew County,14,882,431,451
Arkansas,Drew County,15,735,340,395
Arkansas,Drew County,16,616,259,357
Arkansas,Drew County,17,401,161,240
Arkansas,Drew County,18,368,125,243
Arkansas,Faulkner County,0,120768,59110,61658
Arkansas,Faulkner County,1,7926,4120,3806
Arkansas,Faulkner County,2,8133,4196,3937
Arkansas,Faulkner County,3,8078,4038,4040
Arkansas,Faulkner County,4,8804,4403,4401
Arkansas,Faulkner County,5,14524,6879,7645
Arkansas,Faulkner County,6,9348,4702,4646
Arkansas,Faulkner County,7,8420,4300,4120
Arkansas,Faulkner County,8,7498,3700,3798
Arkansas,Faulkner County,9,7567,3741,3826
Arkansas,Faulkner County,10,6970,3440,3530
Arkansas,Faulkner County,11,7622,3725,3897
Arkansas,Faulkner County,12,6782,3262,3520
Arkansas,Faulkner County,13,5515,2608,2907
Arkansas,Faulkner County,14,4849,2291,2558
Arkansas,Faulkner County,15,3410,1554,1856
Arkansas,Faulkner County,16,2331,1092,1239
Arkansas,Faulkner County,17,1533,588,945
Arkansas,Faulkner County,18,1458,471,987
Arkansas,Franklin County,0,17805,8822,8983
Arkansas,Franklin County,1,1044,524,520
Arkansas,Franklin County,2,1176,585,591
Arkansas,Franklin County,3,1195,606,589
Arkansas,Franklin County,4,1245,685,560
Arkansas,Franklin County,5,1109,602,507
Arkansas,Franklin County,6,901,465,436
Arkansas,Franklin County,7,1045,526,519
Arkansas,Franklin County,8,1016,515,501
Arkansas,Franklin County,9,1107,546,561
Arkansas,Franklin County,10,1117,563,554
Arkansas,Franklin County,11,1281,619,662
Arkansas,Franklin County,12,1226,593,633
Arkansas,Franklin County,13,1144,576,568
Arkansas,Franklin County,14,1002,487,515
Arkansas,Franklin County,15,791,353,438
Arkansas,Franklin County,16,563,268,295
Arkansas,Franklin County,17,409,165,244
Arkansas,Franklin County,18,434,144,290
Arkansas,Fulton County,0,12125,6001,6124
Arkansas,Fulton County,1,585,324,261
Arkansas,Fulton County,2,668,347,321
Arkansas,Fulton County,3,773,400,373
Arkansas,Fulton County,4,700,386,314
Arkansas,Fulton County,5,531,268,263
Arkansas,Fulton County,6,514,269,245
Arkansas,Fulton County,7,540,252,288
Arkansas,Fulton County,8,543,285,258
Arkansas,Fulton County,9,669,321,348
Arkansas,Fulton County,10,759,369,390
Arkansas,Fulton County,11,867,406,461
Arkansas,Fulton County,12,932,441,491
Arkansas,Fulton County,13,961,459,502
Arkansas,Fulton County,14,976,461,515
Arkansas,Fulton County,15,831,392,439
Arkansas,Fulton County,16,579,323,256
Arkansas,Fulton County,17,345,169,176
Arkansas,Fulton County,18,352,129,223
Arkansas,Garland County,0,97322,46964,50358
Arkansas,Garland County,1,5542,2849,2693
Arkansas,Garland County,2,5645,2896,2749
Arkansas,Garland County,3,5614,2883,2731
Arkansas,Garland County,4,5569,2877,2692
Arkansas,Garland County,5,5524,2777,2747
Arkansas,Garland County,6,5326,2601,2725
Arkansas,Garland County,7,5543,2712,2831
Arkansas,Garland County,8,5262,2580,2682
Arkansas,Garland County,9,5609,2661,2948
Arkansas,Garland County,10,5819,2832,2987
Arkansas,Garland County,11,6783,3273,3510
Arkansas,Garland County,12,6998,3285,3713
Arkansas,Garland County,13,6983,3269,3714
Arkansas,Garland County,14,6618,3064,3554
Arkansas,Garland County,15,5247,2430,2817
Arkansas,Garland County,16,3899,1865,2034
Arkansas,Garland County,17,2750,1183,1567
Arkansas,Garland County,18,2591,927,1664
Arkansas,Grant County,0,18144,9024,9120
Arkansas,Grant County,1,1027,529,498
Arkansas,Grant County,2,1236,676,560
Arkansas,Grant County,3,1224,606,618
Arkansas,Grant County,4,1167,609,558
Arkansas,Grant County,5,1011,517,494
Arkansas,Grant County,6,1091,547,544
Arkansas,Grant County,7,1140,579,561
Arkansas,Grant County,8,1089,537,552
Arkansas,Grant County,9,1233,622,611
Arkansas,Grant County,10,1242,594,648
Arkansas,Grant County,11,1407,708,699
Arkansas,Grant County,12,1236,617,619
Arkansas,Grant County,13,1112,561,551
Arkansas,Grant County,14,976,480,496
Arkansas,Grant County,15,804,356,448
Arkansas,Grant County,16,537,252,285
Arkansas,Grant County,17,338,139,199
Arkansas,Grant County,18,274,95,179
Arkansas,Greene County,0,43694,21501,22193
Arkansas,Greene County,1,2866,1382,1484
Arkansas,Greene County,2,3000,1563,1437
Arkansas,Greene County,3,3075,1570,1505
Arkansas,Greene County,4,2859,1497,1362
Arkansas,Greene County,5,2814,1424,1390
Arkansas,Greene County,6,2790,1390,1400
Arkansas,Greene County,7,2725,1365,1360
Arkansas,Greene County,8,2782,1426,1356
Arkansas,Greene County,9,3049,1543,1506
Arkansas,Greene County,10,2905,1436,1469
Arkansas,Greene County,11,3054,1520,1534
Arkansas,Greene County,12,2709,1327,1382
Arkansas,Greene County,13,2505,1200,1305
Arkansas,Greene County,14,2211,1045,1166
Arkansas,Greene County,15,1677,745,932
Arkansas,Greene County,16,1216,522,694
Arkansas,Greene County,17,803,328,475
Arkansas,Greene County,18,654,218,436
Arkansas,Hempstead County,0,22327,10802,11525
Arkansas,Hempstead County,1,1623,839,784
Arkansas,Hempstead County,2,1687,837,850
Arkansas,Hempstead County,3,1625,845,780
Arkansas,Hempstead County,4,1452,749,703
Arkansas,Hempstead County,5,1317,630,687
Arkansas,Hempstead County,6,1221,596,625
Arkansas,Hempstead County,7,1291,598,693
Arkansas,Hempstead County,8,1303,591,712
Arkansas,Hempstead County,9,1280,614,666
Arkansas,Hempstead County,10,1341,661,680
Arkansas,Hempstead County,11,1636,811,825
Arkansas,Hempstead County,12,1595,774,821
Arkansas,Hempstead County,13,1312,638,674
Arkansas,Hempstead County,14,1134,520,614
Arkansas,Hempstead County,15,970,481,489
Arkansas,Hempstead County,16,675,302,373
Arkansas,Hempstead County,17,421,168,253
Arkansas,Hempstead County,18,444,148,296
Arkansas,Hot Spring County,0,33368,17333,16035
Arkansas,Hot Spring County,1,1779,917,862
Arkansas,Hot Spring County,2,2015,1037,978
Arkansas,Hot Spring County,3,1995,1022,973
Arkansas,Hot Spring County,4,2169,1243,926
Arkansas,Hot Spring County,5,2087,1137,950
Arkansas,Hot Spring County,6,2068,1129,939
Arkansas,Hot Spring County,7,2053,1158,895
Arkansas,Hot Spring County,8,2031,1092,939
Arkansas,Hot Spring County,9,2105,1118,987
Arkansas,Hot Spring County,10,2202,1222,980
Arkansas,Hot Spring County,11,2431,1261,1170
Arkansas,Hot Spring County,12,2413,1236,1177
Arkansas,Hot Spring County,13,2267,1081,1186
Arkansas,Hot Spring County,14,2006,999,1007
Arkansas,Hot Spring County,15,1450,678,772
Arkansas,Hot Spring County,16,968,430,538
Arkansas,Hot Spring County,17,718,324,394
Arkansas,Hot Spring County,18,611,249,362
Arkansas,Howard County,0,13500,6570,6930
Arkansas,Howard County,1,933,510,423
Arkansas,Howard County,2,1025,556,469
Arkansas,Howard County,3,979,475,504
Arkansas,Howard County,4,893,448,445
Arkansas,Howard County,5,774,377,397
Arkansas,Howard County,6,779,366,413
Arkansas,Howard County,7,802,392,410
Arkansas,Howard County,8,753,357,396
Arkansas,Howard County,9,766,339,427
Arkansas,Howard County,10,846,416,430
Arkansas,Howard County,11,998,491,507
Arkansas,Howard County,12,873,434,439
Arkansas,Howard County,13,802,408,394
Arkansas,Howard County,14,725,333,392
Arkansas,Howard County,15,560,254,306
Arkansas,Howard County,16,413,187,226
Arkansas,Howard County,17,294,125,169
Arkansas,Howard County,18,285,102,183
Arkansas,Independence County,0,36959,17996,18963
Arkansas,Independence County,1,2380,1204,1176
Arkansas,Independence County,2,2513,1277,1236
Arkansas,Independence County,3,2534,1293,1241
Arkansas,Independence County,4,2435,1200,1235
Arkansas,Independence County,5,2185,1086,1099
Arkansas,Independence County,6,2178,1089,1089
Arkansas,Independence County,7,2200,1084,1116
Arkansas,Independence County,8,2228,1113,1115
Arkansas,Independence County,9,2373,1162,1211
Arkansas,Independence County,10,2287,1118,1169
Arkansas,Independence County,11,2539,1216,1323
Arkansas,Independence County,12,2564,1315,1249
Arkansas,Independence County,13,2244,1085,1159
Arkansas,Independence County,14,2017,971,1046
Arkansas,Independence County,15,1489,703,786
Arkansas,Independence County,16,1194,514,680
Arkansas,Independence County,17,829,333,496
Arkansas,Independence County,18,770,233,537
Arkansas,Izard County,0,13486,7071,6415
Arkansas,Izard County,1,601,323,278
Arkansas,Izard County,2,664,365,299
Arkansas,Izard County,3,719,392,327
Arkansas,Izard County,4,715,365,350
Arkansas,Izard County,5,676,402,274
Arkansas,Izard County,6,656,380,276
Arkansas,Izard County,7,696,392,304
Arkansas,Izard County,8,710,388,322
Arkansas,Izard County,9,783,431,352
Arkansas,Izard County,10,893,514,379
Arkansas,Izard County,11,990,505,485
Arkansas,Izard County,12,994,506,488
Arkansas,Izard County,13,1018,501,517
Arkansas,Izard County,14,1038,512,526
Arkansas,Izard County,15,853,427,426
Arkansas,Izard County,16,667,318,349
Arkansas,Izard County,17,393,178,215
Arkansas,Izard County,18,420,172,248
Arkansas,Jackson County,0,17534,8709,8825
Arkansas,Jackson County,1,975,473,502
Arkansas,Jackson County,2,994,523,471
Arkansas,Jackson County,3,1023,517,506
Arkansas,Jackson County,4,903,463,440
Arkansas,Jackson County,5,1062,548,514
Arkansas,Jackson County,6,1291,674,617
Arkansas,Jackson County,7,1211,618,593
Arkansas,Jackson County,8,1160,615,545
Arkansas,Jackson County,9,1172,590,582
Arkansas,Jackson County,10,1149,583,566
Arkansas,Jackson County,11,1311,657,654
Arkansas,Jackson County,12,1273,623,650
Arkansas,Jackson County,13,1074,513,561
Arkansas,Jackson County,14,985,463,522
Arkansas,Jackson County,15,753,356,397
Arkansas,Jackson County,16,511,223,288
Arkansas,Jackson County,17,349,148,201
Arkansas,Jackson County,18,338,122,216
Arkansas,Jefferson County,0,72297,35534,36763
Arkansas,Jefferson County,1,4496,2288,2208
Arkansas,Jefferson County,2,4618,2383,2235
Arkansas,Jefferson County,3,4799,2570,2229
Arkansas,Jefferson County,4,5022,2550,2472
Arkansas,Jefferson County,5,5340,2698,2642
Arkansas,Jefferson County,6,4733,2418,2315
Arkansas,Jefferson County,7,4555,2331,2224
Arkansas,Jefferson County,8,4052,2073,1979
Arkansas,Jefferson County,9,4224,2113,2111
Arkansas,Jefferson County,10,4466,2160,2306
Arkansas,Jefferson County,11,5119,2514,2605
Arkansas,Jefferson County,12,5240,2491,2749
Arkansas,Jefferson County,13,4723,2194,2529
Arkansas,Jefferson County,14,3718,1813,1905
Arkansas,Jefferson County,15,2605,1211,1394
Arkansas,Jefferson County,16,1885,823,1062
Arkansas,Jefferson County,17,1312,505,807
Arkansas,Jefferson County,18,1390,399,991
Arkansas,Johnson County,0,26005,12920,13085
Arkansas,Johnson County,1,1842,985,857
Arkansas,Johnson County,2,1773,881,892
Arkansas,Johnson County,3,1809,898,911
Arkansas,Johnson County,4,1769,886,883
Arkansas,Johnson County,5,1793,891,902
Arkansas,Johnson County,6,1636,828,808
Arkansas,Johnson County,7,1658,858,800
Arkansas,Johnson County,8,1514,772,742
Arkansas,Johnson County,9,1489,730,759
Arkansas,Johnson County,10,1649,832,817
Arkansas,Johnson County,11,1812,917,895
Arkansas,Johnson County,12,1680,838,842
Arkansas,Johnson County,13,1464,712,752
Arkansas,Johnson County,14,1360,673,687
Arkansas,Johnson County,15,1016,489,527
Arkansas,Johnson County,16,746,324,422
Arkansas,Johnson County,17,521,229,292
Arkansas,Johnson County,18,474,177,297
Arkansas,Lafayette County,0,7111,3435,3676
Arkansas,Lafayette County,1,333,165,168
Arkansas,Lafayette County,2,401,205,196
Arkansas,Lafayette County,3,402,206,196
Arkansas,Lafayette County,4,435,240,195
Arkansas,Lafayette County,5,440,236,204
Arkansas,Lafayette County,6,358,176,182
Arkansas,Lafayette County,7,343,159,184
Arkansas,Lafayette County,8,373,178,195
Arkansas,Lafayette County,9,361,165,196
Arkansas,Lafayette County,10,477,222,255
Arkansas,Lafayette County,11,583,281,302
Arkansas,Lafayette County,12,585,282,303
Arkansas,Lafayette County,13,492,234,258
Arkansas,Lafayette County,14,465,212,253
Arkansas,Lafayette County,15,410,196,214
Arkansas,Lafayette County,16,290,126,164
Arkansas,Lafayette County,17,177,83,94
Arkansas,Lafayette County,18,186,69,117
Arkansas,Lawrence County,0,16931,8377,8554
Arkansas,Lawrence County,1,947,514,433
Arkansas,Lawrence County,2,1048,553,495
Arkansas,Lawrence County,3,1143,647,496
Arkansas,Lawrence County,4,1186,587,599
Arkansas,Lawrence County,5,1154,595,559
Arkansas,Lawrence County,6,882,435,447
Arkansas,Lawrence County,7,944,491,453
Arkansas,Lawrence County,8,906,436,470
Arkansas,Lawrence County,9,1022,500,522
Arkansas,Lawrence County,10,1045,513,532
Arkansas,Lawrence County,11,1200,601,599
Arkansas,Lawrence County,12,1178,561,617
Arkansas,Lawrence County,13,1001,498,503
Arkansas,Lawrence County,14,994,468,526
Arkansas,Lawrence County,15,817,365,452
Arkansas,Lawrence County,16,612,274,338
Arkansas,Lawrence County,17,425,188,237
Arkansas,Lawrence County,18,427,151,276
Arkansas,Lee County,0,9860,5526,4334
Arkansas,Lee County,1,529,234,295
Arkansas,Lee County,2,539,269,270
Arkansas,Lee County,3,542,286,256
Arkansas,Lee County,4,508,248,260
Arkansas,Lee County,5,723,436,287
Arkansas,Lee County,6,751,525,226
Arkansas,Lee County,7,706,516,190
Arkansas,Lee County,8,631,441,190
Arkansas,Lee County,9,674,433,241
Arkansas,Lee County,10,679,415,264
Arkansas,Lee County,11,630,348,282
Arkansas,Lee County,12,684,358,326
Arkansas,Lee County,13,620,298,322
Arkansas,Lee County,14,529,242,287
Arkansas,Lee County,15,391,187,204
Arkansas,Lee County,16,289,130,159
Arkansas,Lee County,17,212,85,127
Arkansas,Lee County,18,223,75,148
Arkansas,Lincoln County,0,13970,8529,5441
Arkansas,Lincoln County,1,614,291,323
Arkansas,Lincoln County,2,672,320,352
Arkansas,Lincoln County,3,744,375,369
Arkansas,Lincoln County,4,791,445,346
Arkansas,Lincoln County,5,1213,870,343
Arkansas,Lincoln County,6,1143,864,279
Arkansas,Lincoln County,7,1167,856,311
Arkansas,Lincoln County,8,1051,742,309
Arkansas,Lincoln County,9,1000,695,305
Arkansas,Lincoln County,10,1025,657,368
Arkansas,Lincoln County,11,1084,685,399
Arkansas,Lincoln County,12,826,478,348
Arkansas,Lincoln County,13,749,396,353
Arkansas,Lincoln County,14,614,328,286
Arkansas,Lincoln County,15,428,200,228
Arkansas,Lincoln County,16,400,176,224
Arkansas,Lincoln County,17,237,82,155
Arkansas,Lincoln County,18,212,69,143
Arkansas,Little River County,0,12532,6157,6375
Arkansas,Little River County,1,664,358,306
Arkansas,Little River County,2,769,417,352
Arkansas,Little River County,3,811,448,363
Arkansas,Little River County,4,814,415,399
Arkansas,Little River County,5,672,358,314
Arkansas,Little River County,6,666,328,338
Arkansas,Little River County,7,679,347,332
Arkansas,Little River County,8,739,348,391
Arkansas,Little River County,9,806,383,423
Arkansas,Little River County,10,815,406,409
Arkansas,Little River County,11,882,404,478
Arkansas,Little River County,12,894,429,465
Arkansas,Little River County,13,880,421,459
Arkansas,Little River County,14,829,384,445
Arkansas,Little River County,15,671,333,338
Arkansas,Little River County,16,415,187,228
Arkansas,Little River County,17,282,113,169
Arkansas,Little River County,18,244,78,166
Arkansas,Logan County,0,21958,10935,11023
Arkansas,Logan County,1,1225,612,613
Arkansas,Logan County,2,1293,649,644
Arkansas,Logan County,3,1413,728,685
Arkansas,Logan County,4,1519,877,642
Arkansas,Logan County,5,1288,655,633
Arkansas,Logan County,6,1141,570,571
Arkansas,Logan County,7,1136,563,573
Arkansas,Logan County,8,1180,586,594
Arkansas,Logan County,9,1362,671,691
Arkansas,Logan County,10,1513,785,728
Arkansas,Logan County,11,1701,861,840
Arkansas,Logan County,12,1536,737,799
Arkansas,Logan County,13,1441,721,720
Arkansas,Logan County,14,1315,643,672
Arkansas,Logan County,15,1091,506,585
Arkansas,Logan County,16,824,386,438
Arkansas,Logan County,17,487,209,278
Arkansas,Logan County,18,493,176,317
Arkansas,Lonoke County,0,71557,35393,36164
Arkansas,Lonoke County,1,4828,2507,2321
Arkansas,Lonoke County,2,5121,2667,2454
Arkansas,Lonoke County,3,5627,2902,2725
Arkansas,Lonoke County,4,5033,2588,2445
Arkansas,Lonoke County,5,4411,2300,2111
Arkansas,Lonoke County,6,4830,2406,2424
Arkansas,Lonoke County,7,5137,2565,2572
Arkansas,Lonoke County,8,4900,2416,2484
Arkansas,Lonoke County,9,5002,2470,2532
Arkansas,Lonoke County,10,4753,2372,2381
Arkansas,Lonoke County,11,4932,2437,2495
Arkansas,Lonoke County,12,4399,2119,2280
Arkansas,Lonoke County,13,3593,1691,1902
Arkansas,Lonoke County,14,3106,1477,1629
Arkansas,Lonoke County,15,2364,1114,1250
Arkansas,Lonoke County,16,1580,667,913
Arkansas,Lonoke County,17,1084,427,657
Arkansas,Lonoke County,18,857,268,589
Arkansas,Madison County,0,15740,7880,7860
Arkansas,Madison County,1,976,507,469
Arkansas,Madison County,2,1015,518,497
Arkansas,Madison County,3,1051,532,519
Arkansas,Madison County,4,1006,509,497
Arkansas,Madison County,5,869,455,414
Arkansas,Madison County,6,833,421,412
Arkansas,Madison County,7,871,425,446
Arkansas,Madison County,8,892,447,445
Arkansas,Madison County,9,967,498,469
Arkansas,Madison County,10,1031,539,492
Arkansas,Madison County,11,1208,625,583
Arkansas,Madison County,12,1181,589,592
Arkansas,Madison County,13,1093,529,564
Arkansas,Madison County,14,909,454,455
Arkansas,Madison County,15,730,361,369
Arkansas,Madison County,16,493,225,268
Arkansas,Madison County,17,326,141,185
Arkansas,Madison County,18,289,105,184
Arkansas,Marion County,0,16367,8130,8237
Arkansas,Marion County,1,728,381,347
Arkansas,Marion County,2,758,374,384
Arkansas,Marion County,3,826,439,387
Arkansas,Marion County,4,804,402,402
Arkansas,Marion County,5,728,380,348
Arkansas,Marion County,6,700,354,346
Arkansas,Marion County,7,703,349,354
Arkansas,Marion County,8,656,341,315
Arkansas,Marion County,9,851,417,434
Arkansas,Marion County,10,997,498,499
Arkansas,Marion County,11,1262,626,636
Arkansas,Marion County,12,1495,703,792
Arkansas,Marion County,13,1471,719,752
Arkansas,Marion County,14,1510,743,767
Arkansas,Marion County,15,1215,611,604
Arkansas,Marion County,16,824,434,390
Arkansas,Marion County,17,453,226,227
Arkansas,Marion County,18,386,133,253
Arkansas,Miller County,0,43428,21367,22061
Arkansas,Miller County,1,3044,1524,1520
Arkansas,Miller County,2,2972,1518,1454
Arkansas,Miller County,3,2804,1424,1380
Arkansas,Miller County,4,2540,1365,1175
Arkansas,Miller County,5,2783,1482,1301
Arkansas,Miller County,6,2955,1503,1452
Arkansas,Miller County,7,2971,1484,1487
Arkansas,Miller County,8,2709,1343,1366
Arkansas,Miller County,9,2691,1320,1371
Arkansas,Miller County,10,2866,1441,1425
Arkansas,Miller County,11,2954,1435,1519
Arkansas,Miller County,12,2902,1398,1504
Arkansas,Miller County,13,2655,1283,1372
Arkansas,Miller County,14,2196,992,1204
Arkansas,Miller County,15,1725,781,944
Arkansas,Miller County,16,1139,526,613
Arkansas,Miller County,17,788,297,491
Arkansas,Miller County,18,734,251,483
Arkansas,Mississippi County,0,44235,21543,22692
Arkansas,Mississippi County,1,3105,1582,1523
Arkansas,Mississippi County,2,3281,1668,1613
Arkansas,Mississippi County,3,3366,1732,1634
Arkansas,Mississippi County,4,3172,1579,1593
Arkansas,Mississippi County,5,3041,1554,1487
Arkansas,Mississippi County,6,2972,1516,1456
Arkansas,Mississippi County,7,2785,1378,1407
Arkansas,Mississippi County,8,2690,1256,1434
Arkansas,Mississippi County,9,2546,1220,1326
Arkansas,Mississippi County,10,2752,1344,1408
Arkansas,Mississippi County,11,3082,1495,1587
Arkansas,Mississippi County,12,3012,1459,1553
Arkansas,Mississippi County,13,2494,1236,1258
Arkansas,Mississippi County,14,1984,904,1080
Arkansas,Mississippi County,15,1438,674,764
Arkansas,Mississippi County,16,1068,454,614
Arkansas,Mississippi County,17,753,299,454
Arkansas,Mississippi County,18,694,193,501
Arkansas,Monroe County,0,7582,3599,3983
Arkansas,Monroe County,1,439,224,215
Arkansas,Monroe County,2,471,252,219
Arkansas,Monroe County,3,414,212,202
Arkansas,Monroe County,4,452,201,251
Arkansas,Monroe County,5,494,224,270
Arkansas,Monroe County,6,363,185,178
Arkansas,Monroe County,7,364,198,166
Arkansas,Monroe County,8,380,177,203
Arkansas,Monroe County,9,399,194,205
Arkansas,Monroe County,10,491,236,255
Arkansas,Monroe County,11,554,263,291
Arkansas,Monroe County,12,628,285,343
Arkansas,Monroe County,13,593,287,306
Arkansas,Monroe County,14,462,221,241
Arkansas,Monroe County,15,362,151,211
Arkansas,Monroe County,16,283,135,148
Arkansas,Monroe County,17,229,101,128
Arkansas,Monroe County,18,204,53,151
Arkansas,Montgomery County,0,9082,4529,4553
Arkansas,Montgomery County,1,392,213,179
Arkansas,Montgomery County,2,466,217,249
Arkansas,Montgomery County,3,513,271,242
Arkansas,Montgomery County,4,543,295,248
Arkansas,Montgomery County,5,417,228,189
Arkansas,Montgomery County,6,367,185,182
Arkansas,Montgomery County,7,380,189,191
Arkansas,Montgomery County,8,412,204,208
Arkansas,Montgomery County,9,506,242,264
Arkansas,Montgomery County,10,612,304,308
Arkansas,Montgomery County,11,738,398,340
Arkansas,Montgomery County,12,710,346,364
Arkansas,Montgomery County,13,717,351,366
Arkansas,Montgomery County,14,695,346,349
Arkansas,Montgomery County,15,589,293,296
Arkansas,Montgomery County,16,464,211,253
Arkansas,Montgomery County,17,326,144,182
Arkansas,Montgomery County,18,235,92,143
Arkansas,Nevada County,0,8723,4306,4417
Arkansas,Nevada County,1,562,279,283
Arkansas,Nevada County,2,554,291,263
Arkansas,Nevada County,3,529,283,246
Arkansas,Nevada County,4,503,269,234
Arkansas,Nevada County,5,522,278,244
Arkansas,Nevada County,6,463,233,230
Arkansas,Nevada County,7,467,231,236
Arkansas,Nevada County,8,454,220,234
Arkansas,Nevada County,9,518,255,263
Arkansas,Nevada County,10,555,258,297
Arkansas,Nevada County,11,640,317,323
Arkansas,Nevada County,12,655,309,346
Arkansas,Nevada County,13,613,314,299
Arkansas,Nevada County,14,525,246,279
Arkansas,Nevada County,15,420,208,212
Arkansas,Nevada County,16,301,135,166
Arkansas,Nevada County,17,230,106,124
Arkansas,Nevada County,18,212,74,138
Arkansas,Newton County,0,7904,3989,3915
Arkansas,Newton County,1,377,193,184
Arkansas,Newton County,2,389,204,185
Arkansas,Newton County,3,482,273,209
Arkansas,Newton County,4,436,229,207
Arkansas,Newton County,5,369,181,188
Arkansas,Newton County,6,396,206,190
Arkansas,Newton County,7,393,214,179
Arkansas,Newton County,8,392,185,207
Arkansas,Newton County,9,413,212,201
Arkansas,Newton County,10,466,235,231
Arkansas,Newton County,11,582,295,287
Arkansas,Newton County,12,627,313,314
Arkansas,Newton County,13,665,344,321
Arkansas,Newton County,14,634,328,306
Arkansas,Newton County,15,536,264,272
Arkansas,Newton County,16,325,156,169
Arkansas,Newton County,17,246,103,143
Arkansas,Newton County,18,176,54,122
Arkansas,Ouachita County,0,24828,11771,13057
Arkansas,Ouachita County,1,1546,768,778
Arkansas,Ouachita County,2,1693,851,842
Arkansas,Ouachita County,3,1549,820,729
Arkansas,Ouachita County,4,1420,725,695
Arkansas,Ouachita County,5,1443,722,721
Arkansas,Ouachita County,6,1436,679,757
Arkansas,Ouachita County,7,1348,640,708
Arkansas,Ouachita County,8,1312,590,722
Arkansas,Ouachita County,9,1375,660,715
Arkansas,Ouachita County,10,1463,669,794
Arkansas,Ouachita County,11,1906,902,1004
Arkansas,Ouachita County,12,1971,922,1049
Arkansas,Ouachita County,13,1814,880,934
Arkansas,Ouachita County,14,1460,691,769
Arkansas,Ouachita County,15,1071,500,571
Arkansas,Ouachita County,16,799,338,461
Arkansas,Ouachita County,17,630,237,393
Arkansas,Ouachita County,18,592,177,415
Arkansas,Perry County,0,10245,5092,5153
Arkansas,Perry County,1,534,288,246
Arkansas,Perry County,2,659,324,335
Arkansas,Perry County,3,650,320,330
Arkansas,Perry County,4,652,356,296
Arkansas,Perry County,5,600,318,282
Arkansas,Perry County,6,530,252,278
Arkansas,Perry County,7,527,274,253
Arkansas,Perry County,8,580,293,287
Arkansas,Perry County,9,689,355,334
Arkansas,Perry County,10,732,364,368
Arkansas,Perry County,11,792,394,398
Arkansas,Perry County,12,735,362,373
Arkansas,Perry County,13,727,352,375
Arkansas,Perry County,14,617,288,329
Arkansas,Perry County,15,461,224,237
Arkansas,Perry County,16,319,155,164
Arkansas,Perry County,17,216,105,111
Arkansas,Perry County,18,225,68,157
Arkansas,Phillips County,0,19930,9363,10567
Arkansas,Phillips County,1,1603,839,764
Arkansas,Phillips County,2,1451,756,695
Arkansas,Phillips County,3,1486,767,719
Arkansas,Phillips County,4,1419,703,716
Arkansas,Phillips County,5,1316,605,711
Arkansas,Phillips County,6,1065,484,581
Arkansas,Phillips County,7,1098,480,618
Arkansas,Phillips County,8,1050,461,589
Arkansas,Phillips County,9,1015,480,535
Arkansas,Phillips County,10,1078,492,586
Arkansas,Phillips County,11,1391,656,735
Arkansas,Phillips County,12,1428,636,792
Arkansas,Phillips County,13,1285,588,697
Arkansas,Phillips County,14,1046,508,538
Arkansas,Phillips County,15,831,373,458
Arkansas,Phillips County,16,585,245,340
Arkansas,Phillips County,17,377,167,210
Arkansas,Phillips County,18,406,123,283
Arkansas,Pike County,0,11024,5492,5532
Arkansas,Pike County,1,644,328,316
Arkansas,Pike County,2,688,380,308
Arkansas,Pike County,3,678,342,336
Arkansas,Pike County,4,783,410,373
Arkansas,Pike County,5,605,315,290
Arkansas,Pike County,6,625,329,296
Arkansas,Pike County,7,571,297,274
Arkansas,Pike County,8,625,309,316
Arkansas,Pike County,9,736,373,363
Arkansas,Pike County,10,726,369,357
Arkansas,Pike County,11,808,414,394
Arkansas,Pike County,12,792,395,397
Arkansas,Pike County,13,696,290,406
Arkansas,Pike County,14,655,319,336
Arkansas,Pike County,15,534,260,274
Arkansas,Pike County,16,401,171,230
Arkansas,Pike County,17,243,107,136
Arkansas,Pike County,18,214,84,130
Arkansas,Poinsett County,0,24246,11793,12453
Arkansas,Poinsett County,1,1556,779,777
Arkansas,Poinsett County,2,1599,805,794
Arkansas,Poinsett County,3,1568,768,800
Arkansas,Poinsett County,4,1533,812,721
Arkansas,Poinsett County,5,1643,866,777
Arkansas,Poinsett County,6,1491,716,775
Arkansas,Poinsett County,7,1319,650,669
Arkansas,Poinsett County,8,1408,703,705
Arkansas,Poinsett County,9,1527,737,790
Arkansas,Poinsett County,10,1575,812,763
Arkansas,Poinsett County,11,1742,854,888
Arkansas,Poinsett County,12,1661,832,829
Arkansas,Poinsett County,13,1487,685,802
Arkansas,Poinsett County,14,1344,636,708
Arkansas,Poinsett County,15,1099,475,624
Arkansas,Poinsett County,16,785,342,443
Arkansas,Poinsett County,17,517,194,323
Arkansas,Poinsett County,18,392,127,265
Arkansas,Polk County,0,20225,9952,10273
Arkansas,Polk County,1,1201,609,592
Arkansas,Polk County,2,1295,663,632
Arkansas,Polk County,3,1380,688,692
Arkansas,Polk County,4,1270,688,582
Arkansas,Polk County,5,1110,545,565
Arkansas,Polk County,6,950,499,451
Arkansas,Polk County,7,1026,506,520
Arkansas,Polk County,8,1019,510,509
Arkansas,Polk County,9,1126,530,596
Arkansas,Polk County,10,1179,604,575
Arkansas,Polk County,11,1424,688,736
Arkansas,Polk County,12,1392,672,720
Arkansas,Polk County,13,1460,697,763
Arkansas,Polk County,14,1423,688,735
Arkansas,Polk County,15,1181,574,607
Arkansas,Polk County,16,822,390,432
Arkansas,Polk County,17,512,259,253
Arkansas,Polk County,18,455,142,313
Arkansas,Pope County,0,63201,31557,31644
Arkansas,Pope County,1,3925,2048,1877
Arkansas,Pope County,2,4173,2097,2076
Arkansas,Pope County,3,3887,2006,1881
Arkansas,Pope County,4,5210,2656,2554
Arkansas,Pope County,5,6027,3102,2925
Arkansas,Pope County,6,4428,2270,2158
Arkansas,Pope County,7,3874,1977,1897
Arkansas,Pope County,8,3515,1880,1635
Arkansas,Pope County,9,3732,1900,1832
Arkansas,Pope County,10,3846,1869,1977
Arkansas,Pope County,11,4209,2165,2044
Arkansas,Pope County,12,3901,1883,2018
Arkansas,Pope County,13,3399,1643,1756
Arkansas,Pope County,14,3011,1459,1552
Arkansas,Pope County,15,2281,1046,1235
Arkansas,Pope County,16,1640,755,885
Arkansas,Pope County,17,1109,479,630
Arkansas,Pope County,18,1034,322,712
Arkansas,Prairie County,0,8304,4106,4198
Arkansas,Prairie County,1,418,243,175
Arkansas,Prairie County,2,467,254,213
Arkansas,Prairie County,3,494,250,244
Arkansas,Prairie County,4,480,268,212
Arkansas,Prairie County,5,420,199,221
Arkansas,Prairie County,6,420,208,212
Arkansas,Prairie County,7,429,210,219
Arkansas,Prairie County,8,407,186,221
Arkansas,Prairie County,9,514,243,271
Arkansas,Prairie County,10,570,264,306
Arkansas,Prairie County,11,626,320,306
Arkansas,Prairie County,12,644,310,334
Arkansas,Prairie County,13,586,303,283
Arkansas,Prairie County,14,539,277,262
Arkansas,Prairie County,15,489,238,251
Arkansas,Prairie County,16,335,153,182
Arkansas,Prairie County,17,249,99,150
Arkansas,Prairie County,18,217,81,136
Arkansas,Pulaski County,0,392702,188355,204347
Arkansas,Pulaski County,1,27351,13965,13386
Arkansas,Pulaski County,2,26306,13313,12993
Arkansas,Pulaski County,3,24883,12688,12195
Arkansas,Pulaski County,4,23160,11754,11406
Arkansas,Pulaski County,5,27268,13877,13391
Arkansas,Pulaski County,6,30107,14537,15570
Arkansas,Pulaski County,7,29505,14389,15116
Arkansas,Pulaski County,8,25365,12223,13142
Arkansas,Pulaski County,9,24786,11833,12953
Arkansas,Pulaski County,10,23632,11345,12287
Arkansas,Pulaski County,11,26893,12655,14238
Arkansas,Pulaski County,12,26700,12507,14193
Arkansas,Pulaski County,13,23759,10994,12765
Arkansas,Pulaski County,14,18591,8570,10021
Arkansas,Pulaski County,15,12287,5522,6765
Arkansas,Pulaski County,16,8789,3677,5112
Arkansas,Pulaski County,17,6311,2403,3908
Arkansas,Pulaski County,18,7009,2103,4906
Arkansas,Randolph County,0,17571,8619,8952
Arkansas,Randolph County,1,998,490,508
Arkansas,Randolph County,2,1109,582,527
Arkansas,Randolph County,3,1124,556,568
Arkansas,Randolph County,4,1056,583,473
Arkansas,Randolph County,5,1035,527,508
Arkansas,Randolph County,6,1042,539,503
Arkansas,Randolph County,7,1029,529,500
Arkansas,Randolph County,8,967,484,483
Arkansas,Randolph County,9,1016,501,515
Arkansas,Randolph County,10,1149,585,564
Arkansas,Randolph County,11,1207,579,628
Arkansas,Randolph County,12,1199,614,585
Arkansas,Randolph County,13,1138,526,612
Arkansas,Randolph County,14,1078,514,564
Arkansas,Randolph County,15,885,409,476
Arkansas,Randolph County,16,596,265,331
Arkansas,Randolph County,17,481,178,303
Arkansas,Randolph County,18,462,158,304
Arkansas,Saline County,0,115719,56755,58964
Arkansas,Saline County,1,6955,3546,3409
Arkansas,Saline County,2,7860,3917,3943
Arkansas,Saline County,3,7909,4102,3807
Arkansas,Saline County,4,7094,3685,3409
Arkansas,Saline County,5,6106,3010,3096
Arkansas,Saline County,6,6949,3383,3566
Arkansas,Saline County,7,7978,3886,4092
Arkansas,Saline County,8,7653,3782,3871
Arkansas,Saline County,9,7967,3985,3982
Arkansas,Saline County,10,7424,3725,3699
Arkansas,Saline County,11,7964,3909,4055
Arkansas,Saline County,12,7331,3591,3740
Arkansas,Saline County,13,6794,3153,3641
Arkansas,Saline County,14,6696,3170,3526
Arkansas,Saline County,15,5292,2515,2777
Arkansas,Saline County,16,3645,1714,1931
Arkansas,Saline County,17,2256,985,1271
Arkansas,Saline County,18,1846,697,1149
Arkansas,Scott County,0,10693,5387,5306
Arkansas,Scott County,1,605,319,286
Arkansas,Scott County,2,726,387,339
Arkansas,Scott County,3,762,392,370
Arkansas,Scott County,4,689,373,316
Arkansas,Scott County,5,650,331,319
Arkansas,Scott County,6,568,308,260
Arkansas,Scott County,7,568,285,283
Arkansas,Scott County,8,529,267,262
Arkansas,Scott County,9,629,321,308
Arkansas,Scott County,10,700,356,344
Arkansas,Scott County,11,859,396,463
Arkansas,Scott County,12,723,363,360
Arkansas,Scott County,13,683,352,331
Arkansas,Scott County,14,612,311,301
Arkansas,Scott County,15,582,271,311
Arkansas,Scott County,16,376,182,194
Arkansas,Scott County,17,212,84,128
Arkansas,Scott County,18,220,89,131
Arkansas,Searcy County,0,7929,3995,3934
Arkansas,Searcy County,1,398,210,188
Arkansas,Searcy County,2,438,234,204
Arkansas,Searcy County,3,478,248,230
Arkansas,Searcy County,4,438,225,213
Arkansas,Searcy County,5,367,202,165
Arkansas,Searcy County,6,387,170,217
Arkansas,Searcy County,7,388,209,179
Arkansas,Searcy County,8,404,207,197
Arkansas,Searcy County,9,421,228,193
Arkansas,Searcy County,10,476,231,245
Arkansas,Searcy County,11,614,314,300
Arkansas,Searcy County,12,600,316,284
Arkansas,Searcy County,13,645,330,315
Arkansas,Searcy County,14,606,301,305
Arkansas,Searcy County,15,472,217,255
Arkansas,Searcy County,16,346,169,177
Arkansas,Searcy County,17,206,89,117
Arkansas,Searcy County,18,245,95,150
Arkansas,Sebastian County,0,126776,62058,64718
Arkansas,Sebastian County,1,8585,4410,4175
Arkansas,Sebastian County,2,8672,4402,4270
Arkansas,Sebastian County,3,8624,4338,4286
Arkansas,Sebastian County,4,8195,4170,4025
Arkansas,Sebastian County,5,8777,4323,4454
Arkansas,Sebastian County,6,8582,4338,4244
Arkansas,Sebastian County,7,8174,4150,4024
Arkansas,Sebastian County,8,7720,3822,3898
Arkansas,Sebastian County,9,7978,3954,4024
Arkansas,Sebastian County,10,8281,4176,4105
Arkansas,Sebastian County,11,8896,4378,4518
Arkansas,Sebastian County,12,8516,4171,4345
Arkansas,Sebastian County,13,7411,3504,3907
Arkansas,Sebastian County,14,6064,2817,3247
Arkansas,Sebastian County,15,4604,2106,2498
Arkansas,Sebastian County,16,3119,1369,1750
Arkansas,Sebastian County,17,2268,887,1381
Arkansas,Sebastian County,18,2310,743,1567
Arkansas,Sevier County,0,17426,8666,8760
Arkansas,Sevier County,1,1345,639,706
Arkansas,Sevier County,2,1457,711,746
Arkansas,Sevier County,3,1400,750,650
Arkansas,Sevier County,4,1288,656,632
Arkansas,Sevier County,5,1137,564,573
Arkansas,Sevier County,6,1036,555,481
Arkansas,Sevier County,7,1095,566,529
Arkansas,Sevier County,8,1040,511,529
Arkansas,Sevier County,9,1207,577,630
Arkansas,Sevier County,10,1063,551,512
Arkansas,Sevier County,11,1126,562,564
Arkansas,Sevier County,12,957,488,469
Arkansas,Sevier County,13,910,468,442
Arkansas,Sevier County,14,788,382,406
Arkansas,Sevier County,15,551,271,280
Arkansas,Sevier County,16,437,190,247
Arkansas,Sevier County,17,313,134,179
Arkansas,Sevier County,18,276,91,185
Arkansas,Sharp County,0,16906,8351,8555
Arkansas,Sharp County,1,880,429,451
Arkansas,Sharp County,2,967,496,471
Arkansas,Sharp County,3,971,513,458
Arkansas,Sharp County,4,952,516,436
Arkansas,Sharp County,5,844,425,419
Arkansas,Sharp County,6,801,433,368
Arkansas,Sharp County,7,776,366,410
Arkansas,Sharp County,8,799,408,391
Arkansas,Sharp County,9,886,418,468
Arkansas,Sharp County,10,968,496,472
Arkansas,Sharp County,11,1225,591,634
Arkansas,Sharp County,12,1206,580,626
Arkansas,Sharp County,13,1280,604,676
Arkansas,Sharp County,14,1359,641,718
Arkansas,Sharp County,15,1135,549,586
Arkansas,Sharp County,16,797,429,368
Arkansas,Sharp County,17,581,267,314
Arkansas,Sharp County,18,479,190,289
Arkansas,Stone County,0,12494,6193,6301
Arkansas,Stone County,1,612,336,276
Arkansas,Stone County,2,705,357,348
Arkansas,Stone County,3,734,358,376
Arkansas,Stone County,4,712,358,354
Arkansas,Stone County,5,580,301,279
Arkansas,Stone County,6,536,267,269
Arkansas,Stone County,7,565,280,285
Arkansas,Stone County,8,652,345,307
Arkansas,Stone County,9,589,295,294
Arkansas,Stone County,10,698,342,356
Arkansas,Stone County,11,921,451,470
Arkansas,Stone County,12,1008,495,513
Arkansas,Stone County,13,1009,493,516
Arkansas,Stone County,14,988,489,499
Arkansas,Stone County,15,895,428,467
Arkansas,Stone County,16,563,278,285
Arkansas,Stone County,17,404,175,229
Arkansas,Stone County,18,323,145,178
Arkansas,Union County,0,40227,19556,20671
Arkansas,Union County,1,2603,1279,1324
Arkansas,Union County,2,2730,1432,1298
Arkansas,Union County,3,2658,1382,1276
Arkansas,Union County,4,2489,1270,1219
Arkansas,Union County,5,2374,1257,1117
Arkansas,Union County,6,2263,1085,1178
Arkansas,Union County,7,2464,1175,1289
Arkansas,Union County,8,2298,1130,1168
Arkansas,Union County,9,2555,1217,1338
Arkansas,Union County,10,2515,1236,1279
Arkansas,Union County,11,2982,1457,1525
Arkansas,Union County,12,2925,1446,1479
Arkansas,Union County,13,2694,1271,1423
Arkansas,Union County,14,2127,1036,1091
Arkansas,Union County,15,1562,702,860
Arkansas,Union County,16,1181,531,650
Arkansas,Union County,17,940,345,595
Arkansas,Union County,18,867,305,562
Arkansas,Van Buren County,0,16851,8382,8469
Arkansas,Van Buren County,1,821,412,409
Arkansas,Van Buren County,2,943,497,446
Arkansas,Van Buren County,3,1001,510,491
Arkansas,Van Buren County,4,880,451,429
Arkansas,Van Buren County,5,820,436,384
Arkansas,Van Buren County,6,787,390,397
Arkansas,Van Buren County,7,861,418,443
Arkansas,Van Buren County,8,780,373,407
Arkansas,Van Buren County,9,976,540,436
Arkansas,Van Buren County,10,1003,509,494
Arkansas,Van Buren County,11,1281,642,639
Arkansas,Van Buren County,12,1359,653,706
Arkansas,Van Buren County,13,1202,579,623
Arkansas,Van Buren County,14,1273,628,645
Arkansas,Van Buren County,15,1037,496,541
Arkansas,Van Buren County,16,766,391,375
Arkansas,Van Buren County,17,546,251,295
Arkansas,Van Buren County,18,515,206,309
Arkansas,Washington County,0,220792,110540,110252
Arkansas,Washington County,1,16343,8313,8030
Arkansas,Washington County,2,15766,8131,7635
Arkansas,Washington County,3,15167,7764,7403
Arkansas,Washington County,4,17429,8770,8659
Arkansas,Washington County,5,23783,12564,11219
Arkansas,Washington County,6,17107,8649,8458
Arkansas,Washington County,7,16703,8708,7995
Arkansas,Washington County,8,14908,7571,7337
Arkansas,Washington County,9,13344,6742,6602
Arkansas,Washington County,10,12127,6175,5952
Arkansas,Washington County,11,12963,6455,6508
Arkansas,Washington County,12,11499,5621,5878
Arkansas,Washington County,13,9992,4818,5174
Arkansas,Washington County,14,8065,3779,4286
Arkansas,Washington County,15,5854,2604,3250
Arkansas,Washington County,16,3936,1730,2206
Arkansas,Washington County,17,2900,1182,1718
Arkansas,Washington County,18,2906,964,1942
Arkansas,White County,0,78592,38462,40130
Arkansas,White County,1,5144,2680,2464
Arkansas,White County,2,5269,2728,2541
Arkansas,White County,3,5202,2603,2599
Arkansas,White County,4,5936,2961,2975
Arkansas,White County,5,6780,3360,3420
Arkansas,White County,6,5014,2487,2527
Arkansas,White County,7,4778,2312,2466
Arkansas,White County,8,4450,2247,2203
Arkansas,White County,9,4887,2430,2457
Arkansas,White County,10,4744,2314,2430
Arkansas,White County,11,5490,2786,2704
Arkansas,White County,12,4856,2359,2497
Arkansas,White County,13,4137,2000,2137
Arkansas,White County,14,3906,1834,2072
Arkansas,White County,15,3018,1344,1674
Arkansas,White County,16,2105,919,1186
Arkansas,White County,17,1545,627,918
Arkansas,White County,18,1331,471,860
Arkansas,Woodruff County,0,6910,3316,3594
Arkansas,Woodruff County,1,391,203,188
Arkansas,Woodruff County,2,403,189,214
Arkansas,Woodruff County,3,430,217,213
Arkansas,Woodruff County,4,432,211,221
Arkansas,Woodruff County,5,382,188,194
Arkansas,Woodruff County,6,337,177,160
Arkansas,Woodruff County,7,349,162,187
Arkansas,Woodruff County,8,351,177,174
Arkansas,Woodruff County,9,418,207,211
Arkansas,Woodruff County,10,395,200,195
Arkansas,Woodruff County,11,491,256,235
Arkansas,Woodruff County,12,530,240,290
Arkansas,Woodruff County,13,539,262,277
Arkansas,Woodruff County,14,508,255,253
Arkansas,Woodruff County,15,333,139,194
Arkansas,Woodruff County,16,242,110,132
Arkansas,Woodruff County,17,178,58,120
Arkansas,Woodruff County,18,201,65,136
Arkansas,Yell County,0,21951,10925,11026
Arkansas,Yell County,1,1429,727,702
Arkansas,Yell County,2,1556,781,775
Arkansas,Yell County,3,1544,819,725
Arkansas,Yell County,4,1476,770,706
Arkansas,Yell County,5,1260,675,585
Arkansas,Yell County,6,1278,652,626
Arkansas,Yell County,7,1235,630,605
Arkansas,Yell County,8,1306,645,661
Arkansas,Yell County,9,1397,681,716
Arkansas,Yell County,10,1394,710,684
Arkansas,Yell County,11,1612,818,794
Arkansas,Yell County,12,1422,684,738
Arkansas,Yell County,13,1290,644,646
Arkansas,Yell County,14,1148,577,571
Arkansas,Yell County,15,951,433,518
Arkansas,Yell County,16,730,333,397
Arkansas,Yell County,17,519,224,295
Arkansas,Yell County,18,404,122,282
California,Alameda County,0,1610921,789318,821603
California,Alameda County,1,98013,49895,48118
California,Alameda County,2,98422,50480,47942
California,Alameda County,3,93660,47685,45975
California,Alameda County,4,94873,48299,46574
California,Alameda County,5,108534,54472,54062
California,Alameda County,6,127356,63494,63862
California,Alameda County,7,129459,63663,65796
California,Alameda County,8,119907,59483,60424
California,Alameda County,9,118837,58858,59979
California,Alameda County,10,111539,55671,55868
California,Alameda County,11,114995,56267,58728
California,Alameda County,12,105498,51447,54051
California,Alameda County,13,89162,42107,47055
California,Alameda County,14,69985,32728,37257
California,Alameda County,15,45997,20966,25031
California,Alameda County,16,32447,14142,18305
California,Alameda County,17,23797,9795,14002
California,Alameda County,18,28440,9866,18574
California,Alpine County,0,1116,580,536
California,Alpine County,1,37,21,16
California,Alpine County,2,74,32,42
California,Alpine County,3,72,42,30
California,Alpine County,4,67,34,33
California,Alpine County,5,48,30,18
California,Alpine County,6,48,29,19
California,Alpine County,7,43,23,20
California,Alpine County,8,50,21,29
California,Alpine County,9,68,39,29
California,Alpine County,10,71,31,40
California,Alpine County,11,99,58,41
California,Alpine County,12,97,49,48
California,Alpine County,13,107,57,50
California,Alpine County,14,110,53,57
California,Alpine County,15,48,27,21
California,Alpine County,16,40,18,22
California,Alpine County,17,20,11,9
California,Alpine County,18,17,5,12
California,Amador County,0,36742,19506,17236
California,Amador County,1,1365,691,674
California,Amador County,2,1525,736,789
California,Amador County,3,1670,831,839
California,Amador County,4,1726,897,829
California,Amador County,5,1763,958,805
California,Amador County,6,1726,1044,682
California,Amador County,7,1926,1133,793
California,Amador County,8,1850,1154,696
California,Amador County,9,2112,1288,824
California,Amador County,10,2369,1416,953
California,Amador County,11,3001,1632,1369
California,Amador County,12,3099,1588,1511
California,Amador County,13,3403,1658,1745
California,Amador County,14,3274,1598,1676
California,Amador County,15,2270,1157,1113
California,Amador County,16,1551,761,790
California,Amador County,17,974,480,494
California,Amador County,18,1138,484,654
California,Butte County,0,224241,111106,113135
California,Butte County,1,12049,6202,5847
California,Butte County,2,12630,6418,6212
California,Butte County,3,12783,6515,6268
California,Butte County,4,15944,8076,7868
California,Butte County,5,27357,14074,13283
California,Butte County,6,13510,7202,6308
California,Butte County,7,13416,6968,6448
California,Butte County,8,11555,5865,5690
California,Butte County,9,11520,5855,5665
California,Butte County,10,11871,5854,6017
California,Butte County,11,13755,6657,7098
California,Butte County,12,14888,7235,7653
California,Butte County,13,14754,7057,7697
California,Butte County,14,12640,6076,6564
California,Butte County,15,8701,4035,4666
California,Butte County,16,6335,2858,3477
California,Butte County,17,4701,2081,2620
California,Butte County,18,5832,2078,3754
California,Calaveras County,0,44624,22311,22313
California,Calaveras County,1,1760,908,852
California,Calaveras County,2,2097,1031,1066
California,Calaveras County,3,2342,1236,1106
California,Calaveras County,4,2638,1430,1208
California,Calaveras County,5,2032,1085,947
California,Calaveras County,6,1946,1002,944
California,Calaveras County,7,1908,979,929
California,Calaveras County,8,1903,996,907
California,Calaveras County,9,2149,1052,1097
California,Calaveras County,10,2644,1300,1344
California,Calaveras County,11,3581,1737,1844
California,Calaveras County,12,4170,2026,2144
California,Calaveras County,13,4256,2051,2205
California,Calaveras County,14,4020,2021,1999
California,Calaveras County,15,2981,1485,1496
California,Calaveras County,16,1980,978,1002
California,Calaveras County,17,1146,567,579
California,Calaveras County,18,1071,427,644
California,Colusa County,0,21419,11003,10416
California,Colusa County,1,1581,778,803
California,Colusa County,2,1801,948,853
California,Colusa County,3,1621,858,763
California,Colusa County,4,1613,882,731
California,Colusa County,5,1462,778,684
California,Colusa County,6,1380,730,650
California,Colusa County,7,1407,732,675
California,Colusa County,8,1282,642,640
California,Colusa County,9,1240,638,602
California,Colusa County,10,1317,687,630
California,Colusa County,11,1388,703,685
California,Colusa County,12,1355,705,650
California,Colusa County,13,1162,577,585
California,Colusa County,14,918,471,447
California,Colusa County,15,701,361,340
California,Colusa County,16,473,228,245
California,Colusa County,17,326,140,186
California,Colusa County,18,392,145,247
California,Contra Costa County,0,1111339,541705,569634
California,Contra Costa County,1,64601,32727,31874
California,Contra Costa County,2,73426,37533,35893
California,Contra Costa County,3,76472,38924,37548
California,Contra Costa County,4,72439,37273,35166
California,Contra Costa County,5,69046,35087,33959
California,Contra Costa County,6,67392,33985,33407
California,Contra Costa County,7,72221,35499,36722
California,Contra Costa County,8,71652,34647,37005
California,Contra Costa County,9,77565,37925,39640
California,Contra Costa County,10,80952,39509,41443
California,Contra Costa County,11,84763,41379,43384
California,Contra Costa County,12,77115,37318,39797
California,Contra Costa County,13,65496,30897,34599
California,Contra Costa County,14,54224,25058,29166
California,Contra Costa County,15,37550,17064,20486
California,Contra Costa County,16,25885,11574,14311
California,Contra Costa County,17,18792,7844,10948
California,Contra Costa County,18,21748,7462,14286
California,Del Norte County,0,27212,14912,12300
California,Del Norte County,1,1568,791,777
California,Del Norte County,2,1657,842,815
California,Del Norte County,3,1574,819,755
California,Del Norte County,4,1548,847,701
California,Del Norte County,5,1626,972,654
California,Del Norte County,6,1883,1183,700
California,Del Norte County,7,2057,1321,736
California,Del Norte County,8,1804,1179,625
California,Del Norte County,9,1645,992,653
California,Del Norte County,10,1688,988,700
California,Del Norte County,11,2017,1077,940
California,Del Norte County,12,2052,987,1065
California,Del Norte County,13,1836,914,922
California,Del Norte County,14,1454,759,695
California,Del Norte County,15,1050,487,563
California,Del Norte County,16,709,308,401
California,Del Norte County,17,561,256,305
California,Del Norte County,18,483,190,293
California,El Dorado County,0,183087,91665,91422
California,El Dorado County,1,8011,4143,3868
California,El Dorado County,2,10722,5487,5235
California,El Dorado County,3,11835,6082,5753
California,El Dorado County,4,11823,6196,5627
California,El Dorado County,5,10195,5420,4775
California,El Dorado County,6,8844,4672,4172
California,El Dorado County,7,9261,4725,4536
California,El Dorado County,8,9298,4582,4716
California,El Dorado County,9,11004,5477,5527
California,El Dorado County,10,12536,6175,6361
California,El Dorado County,11,15663,7637,8026
California,El Dorado County,12,16409,8027,8382
California,El Dorado County,13,14604,7273,7331
California,El Dorado County,14,12020,6030,5990
California,El Dorado County,15,8134,3973,4161
California,El Dorado County,16,5292,2642,2650
California,El Dorado County,17,3704,1706,1998
California,El Dorado County,18,3732,1418,2314
California,Fresno County,0,965974,482163,483811
California,Fresno County,1,79899,40601,39298
California,Fresno County,2,79353,40695,38658
California,Fresno County,3,74818,38115,36703
California,Fresno County,4,72788,37146,35642
California,Fresno County,5,78668,40258,38410
California,Fresno County,6,74871,38599,36272
California,Fresno County,7,68349,34847,33502
California,Fresno County,8,60107,30507,29600
California,Fresno County,9,57141,28653,28488
California,Fresno County,10,55929,28109,27820
California,Fresno County,11,57907,28799,29108
California,Fresno County,12,53151,26100,27051
California,Fresno County,13,45107,21807,23300
California,Fresno County,14,35927,17226,18701
California,Fresno County,15,25457,11642,13815
California,Fresno County,16,18131,8078,10053
California,Fresno County,17,13474,5560,7914
California,Fresno County,18,14897,5421,9476
California,Glenn County,0,27955,14097,13858
California,Glenn County,1,1963,1036,927
California,Glenn County,2,2160,1118,1042
California,Glenn County,3,2012,1026,986
California,Glenn County,4,2099,1079,1020
California,Glenn County,5,1793,929,864
California,Glenn County,6,1807,928,879
California,Glenn County,7,1746,899,847
California,Glenn County,8,1630,814,816
California,Glenn County,9,1582,778,804
California,Glenn County,10,1595,818,777
California,Glenn County,11,1904,937,967
California,Glenn County,12,1865,933,932
California,Glenn County,13,1645,846,799
California,Glenn County,14,1273,642,631
California,Glenn County,15,1038,514,524
California,Glenn County,16,756,357,399
California,Glenn County,17,541,235,306
California,Glenn County,18,546,208,338
California,Humboldt County,0,134809,67372,67437
California,Humboldt County,1,7247,3713,3534
California,Humboldt County,2,7491,3863,3628
California,Humboldt County,3,7082,3570,3512
California,Humboldt County,4,8941,4480,4461
California,Humboldt County,5,13226,6552,6674
California,Humboldt County,6,8926,4717,4209
California,Humboldt County,7,9589,4987,4602
California,Humboldt County,8,8511,4475,4036
California,Humboldt County,9,7709,4072,3637
California,Humboldt County,10,7031,3608,3423
California,Humboldt County,11,8732,4341,4391
California,Humboldt County,12,9638,4661,4977
California,Humboldt County,13,9906,4777,5129
California,Humboldt County,14,7894,3902,3992
California,Humboldt County,15,4723,2276,2447
California,Humboldt County,16,3179,1468,1711
California,Humboldt County,17,2252,930,1322
California,Humboldt County,18,2732,980,1752
California,Imperial County,0,179091,91429,87662
California,Imperial County,1,14929,7644,7285
California,Imperial County,2,13957,7057,6900
California,Imperial County,3,13769,6986,6783
California,Imperial County,4,13737,7221,6516
California,Imperial County,5,14440,7865,6575
California,Imperial County,6,13044,7337,5707
California,Imperial County,7,12256,6767,5489
California,Imperial County,8,10922,5908,5014
California,Imperial County,9,10681,5469,5212
California,Imperial County,10,10775,5455,5320
California,Imperial County,11,10731,5287,5444
California,Imperial County,12,10076,4834,5242
California,Imperial County,13,8251,3927,4324
California,Imperial County,14,6728,3213,3515
California,Imperial County,15,4967,2185,2782
California,Imperial County,16,3972,1783,2189
California,Imperial County,17,2956,1304,1652
California,Imperial County,18,2900,1187,1713
California,Inyo County,0,18410,9228,9182
California,Inyo County,1,1103,540,563
California,Inyo County,2,1049,534,515
California,Inyo County,3,968,513,455
California,Inyo County,4,1066,544,522
California,Inyo County,5,893,439,454
California,Inyo County,6,928,491,437
California,Inyo County,7,1071,549,522
California,Inyo County,8,998,532,466
California,Inyo County,9,945,480,465
California,Inyo County,10,1021,502,519
California,Inyo County,11,1405,704,701
California,Inyo County,12,1592,799,793
California,Inyo County,13,1439,710,729
California,Inyo County,14,1221,634,587
California,Inyo County,15,912,451,461
California,Inyo County,16,710,345,365
California,Inyo County,17,521,253,268
California,Inyo County,18,568,208,360
California,Kern County,0,874589,448453,426136
California,Kern County,1,73210,37065,36145
California,Kern County,2,73992,37509,36483
California,Kern County,3,68963,35053,33910
California,Kern County,4,66672,34496,32176
California,Kern County,5,71372,38606,32766
California,Kern County,6,67953,36886,31067
California,Kern County,7,63333,34213,29120
California,Kern County,8,55983,29533,26450
California,Kern County,9,53431,27715,25716
California,Kern County,10,51843,26874,24969
California,Kern County,11,53770,27139,26631
California,Kern County,12,48841,24737,24104
California,Kern County,13,39028,19331,19697
California,Kern County,14,29788,14281,15507
California,Kern County,15,21767,10337,11430
California,Kern County,16,15055,6947,8108
California,Kern County,17,9944,4193,5751
California,Kern County,18,9644,3538,6106
California,Kings County,0,150269,82900,67369
California,Kings County,1,11859,6048,5811
California,Kings County,2,12132,6143,5989
California,Kings County,3,10876,5506,5370
California,Kings County,4,10585,5519,5066
California,Kings County,5,13194,7777,5417
California,Kings County,6,13053,7823,5230
California,Kings County,7,12064,7132,4932
California,Kings County,8,10583,6335,4248
California,Kings County,9,9862,5964,3898
California,Kings County,10,9432,5692,3740
California,Kings County,11,9151,5210,3941
California,Kings County,12,7756,4263,3493
California,Kings County,13,6044,3216,2828
California,Kings County,14,4658,2310,2348
California,Kings County,15,3262,1538,1724
California,Kings County,16,2463,1108,1355
California,Kings County,17,1731,732,999
California,Kings County,18,1564,584,980
California,Lake County,0,64184,32115,32069
California,Lake County,1,3697,1883,1814
California,Lake County,2,3596,1895,1701
California,Lake County,3,3547,1798,1749
California,Lake County,4,3555,1892,1663
California,Lake County,5,3519,1817,1702
California,Lake County,6,3512,1847,1665
California,Lake County,7,3419,1773,1646
California,Lake County,8,3196,1665,1531
California,Lake County,9,3368,1619,1749
California,Lake County,10,3905,1908,1997
California,Lake County,11,4751,2316,2435
California,Lake County,12,5510,2645,2865
California,Lake County,13,5375,2614,2761
California,Lake County,14,4801,2455,2346
California,Lake County,15,3288,1600,1688
California,Lake County,16,2239,1101,1138
California,Lake County,17,1445,685,760
California,Lake County,18,1461,602,859
California,Lassen County,0,31749,20232,11517
California,Lassen County,1,1436,708,728
California,Lassen County,2,1419,734,685
California,Lassen County,3,1478,781,697
California,Lassen County,4,1807,1011,796
California,Lassen County,5,2591,1978,613
California,Lassen County,6,2988,2377,611
California,Lassen County,7,2790,2122,668
California,Lassen County,8,2389,1806,583
California,Lassen County,9,2353,1645,708
California,Lassen County,10,2316,1593,723
California,Lassen County,11,2279,1392,887
California,Lassen County,12,2039,1124,915
California,Lassen County,13,1887,1023,864
California,Lassen County,14,1469,747,722
California,Lassen County,15,944,476,468
California,Lassen County,16,610,297,313
California,Lassen County,17,458,223,235
California,Lassen County,18,496,195,301
California,Los Angeles County,0,10116705,4982799,5133906
California,Los Angeles County,1,644444,328958,315486
California,Los Angeles County,2,629150,321835,307315
California,Los Angeles County,3,628505,320465,308040
California,Los Angeles County,4,682784,348037,334747
California,Los Angeles County,5,780608,394640,385968
California,Los Angeles County,6,816611,417590,399021
California,Los Angeles County,7,757867,384271,373596
California,Los Angeles County,8,696668,347787,348881
California,Los Angeles County,9,712263,353399,358864
California,Los Angeles County,10,697425,346748,350677
California,Los Angeles County,11,692630,340694,351936
California,Los Angeles County,12,629431,303967,325464
California,Los Angeles County,13,515312,243509,271803
California,Los Angeles County,14,402167,185318,216849
California,Los Angeles County,15,285992,127512,158480
California,Los Angeles County,16,212629,91718,120911
California,Los Angeles County,17,156673,63924,92749
California,Los Angeles County,18,175546,62427,113119
California,Madera County,0,154548,74311,80237
California,Madera County,1,11521,5776,5745
California,Madera County,2,12306,6194,6112
California,Madera County,3,11620,5891,5729
California,Madera County,4,11388,5897,5491
California,Madera County,5,11509,5661,5848
California,Madera County,6,10822,5053,5769
California,Madera County,7,10554,4842,5712
California,Madera County,8,9706,4434,5272
California,Madera County,9,9648,4386,5262
California,Madera County,10,9283,4306,4977
California,Madera County,11,9450,4363,5087
California,Madera County,12,8835,4257,4578
California,Madera County,13,8165,3942,4223
California,Madera County,14,6781,3269,3512
California,Madera County,15,4906,2366,2540
California,Madera County,16,3466,1665,1801
California,Madera County,17,2362,1108,1254
California,Madera County,18,2226,901,1325
California,Marin County,0,260750,127246,133504
California,Marin County,1,12567,6396,6171
California,Marin County,2,15847,8046,7801
California,Marin County,3,16150,8161,7989
California,Marin County,4,13863,6965,6898
California,Marin County,5,11619,6195,5424
California,Marin County,6,10901,5930,4971
California,Marin County,7,12735,6536,6199
California,Marin County,8,14757,7244,7513
California,Marin County,9,19227,9603,9624
California,Marin County,10,20909,10410,10499
California,Marin County,11,21092,10333,10759
California,Marin County,12,20458,9666,10792
California,Marin County,13,20037,9386,10651
California,Marin County,14,17298,8011,9287
California,Marin County,15,12201,5699,6502
California,Marin County,16,7877,3638,4239
California,Marin County,17,5698,2433,3265
California,Marin County,18,7514,2594,4920
California,Mariposa County,0,17682,8986,8696
California,Mariposa County,1,777,384,393
California,Mariposa County,2,792,395,397
California,Mariposa County,3,818,445,373
California,Mariposa County,4,891,445,446
California,Mariposa County,5,898,472,426
California,Mariposa County,6,873,461,412
California,Mariposa County,7,857,454,403
California,Mariposa County,8,743,379,364
California,Mariposa County,9,828,433,395
California,Mariposa County,10,1007,499,508
California,Mariposa County,11,1493,753,740
California,Mariposa County,12,1725,857,868
California,Mariposa County,13,1644,814,830
California,Mariposa County,14,1464,784,680
California,Mariposa County,15,1107,559,548
California,Mariposa County,16,769,402,367
California,Mariposa County,17,514,254,260
California,Mariposa County,18,482,196,286
California,Mendocino County,0,87869,43726,44143
California,Mendocino County,1,5430,2760,2670
California,Mendocino County,2,5354,2767,2587
California,Mendocino County,3,5208,2639,2569
California,Mendocino County,4,5181,2684,2497
California,Mendocino County,5,4883,2585,2298
California,Mendocino County,6,4977,2596,2381
California,Mendocino County,7,5345,2757,2588
California,Mendocino County,8,5142,2618,2524
California,Mendocino County,9,5081,2587,2494
California,Mendocino County,10,5043,2575,2468
California,Mendocino County,11,5859,2821,3038
California,Mendocino County,12,6587,3207,3380
California,Mendocino County,13,7151,3381,3770
California,Mendocino County,14,6446,3219,3227
California,Mendocino County,15,3954,1945,2009
California,Mendocino County,16,2406,1145,1261
California,Mendocino County,17,1687,735,952
California,Mendocino County,18,2135,705,1430
California,Merced County,0,266353,134557,131796
California,Merced County,1,21475,10920,10555
California,Merced County,2,22729,11666,11063
California,Merced County,3,22463,11425,11038
California,Merced County,4,22796,11845,10951
California,Merced County,5,22034,11491,10543
California,Merced County,6,19326,10139,9187
California,Merced County,7,18099,9447,8652
California,Merced County,8,16602,8416,8186
California,Merced County,9,16089,8079,8010
California,Merced County,10,15632,7979,7653
California,Merced County,11,15697,7814,7883
California,Merced County,12,14113,7111,7002
California,Merced County,13,11461,5623,5838
California,Merced County,14,9345,4538,4807
California,Merced County,15,6740,3160,3580
California,Merced County,16,4796,2160,2636
California,Merced County,17,3455,1451,2004
California,Merced County,18,3501,1293,2208
California,Modoc County,0,9023,4553,4470
California,Modoc County,1,426,218,208
California,Modoc County,2,509,262,247
California,Modoc County,3,559,308,251
California,Modoc County,4,520,265,255
California,Modoc County,5,419,232,187
California,Modoc County,6,421,210,211
California,Modoc County,7,465,245,220
California,Modoc County,8,451,221,230
California,Modoc County,9,498,272,226
California,Modoc County,10,512,248,264
California,Modoc County,11,686,342,344
California,Modoc County,12,713,331,382
California,Modoc County,13,755,360,395
California,Modoc County,14,735,376,359
California,Modoc County,15,546,286,260
California,Modoc County,16,340,170,170
California,Modoc County,17,245,110,135
California,Modoc County,18,223,97,126
California,Mono County,0,13997,7460,6537
California,Mono County,1,697,320,377
California,Mono County,2,827,394,433
California,Mono County,3,762,377,385
California,Mono County,4,771,414,357
California,Mono County,5,1003,574,429
California,Mono County,6,1150,654,496
California,Mono County,7,1121,602,519
California,Mono County,8,861,475,386
California,Mono County,9,928,511,417
California,Mono County,10,907,498,409
California,Mono County,11,1162,592,570
California,Mono County,12,1146,650,496
California,Mono County,13,1005,538,467
California,Mono County,14,644,339,305
California,Mono County,15,421,225,196
California,Mono County,16,272,132,140
California,Mono County,17,183,102,81
California,Mono County,18,137,63,74
California,Monterey County,0,431344,220084,211260
California,Monterey County,1,33372,17054,16318
California,Monterey County,2,33159,16966,16193
California,Monterey County,3,30039,15330,14709
California,Monterey County,4,29973,15434,14539
California,Monterey County,5,33322,17537,15785
California,Monterey County,6,31859,16859,15000
California,Monterey County,7,32129,17193,14936
California,Monterey County,8,28454,15215,13239
California,Monterey County,9,27602,14721,12881
California,Monterey County,10,26195,13911,12284
California,Monterey County,11,26381,13338,13043
California,Monterey County,12,25266,12475,12791
California,Monterey County,13,22009,10887,11122
California,Monterey County,14,17365,8407,8958
California,Monterey County,15,11590,5456,6134
California,Monterey County,16,8124,3684,4440
California,Monterey County,17,6667,2803,3864
California,Monterey County,18,7838,2814,5024
California,Napa County,0,141667,70389,71278
California,Napa County,1,7664,3895,3769
California,Napa County,2,8574,4431,4143
California,Napa County,3,9008,4500,4508
California,Napa County,4,9235,4736,4499
California,Napa County,5,9266,4837,4429
California,Napa County,6,8662,4516,4146
California,Napa County,7,8955,4555,4400
California,Napa County,8,8690,4425,4265
California,Napa County,9,9257,4629,4628
California,Napa County,10,9505,4784,4721
California,Napa County,11,10075,5081,4994
California,Napa County,12,9789,4855,4934
California,Napa County,13,9165,4354,4811
California,Napa County,14,7756,3788,3968
California,Napa County,15,5586,2598,2988
California,Napa County,16,3980,1829,2151
California,Napa County,17,2923,1331,1592
California,Napa County,18,3577,1245,2332
California,Nevada County,0,98893,48664,50229
California,Nevada County,1,4185,2132,2053
California,Nevada County,2,4786,2400,2386
California,Nevada County,3,5169,2626,2543
California,Nevada County,4,5358,2831,2527
California,Nevada County,5,4824,2479,2345
California,Nevada County,6,4636,2446,2190
California,Nevada County,7,5188,2648,2540
California,Nevada County,8,5104,2630,2474
California,Nevada County,9,5167,2681,2486
California,Nevada County,10,5647,2798,2849
California,Nevada County,11,7457,3518,3939
California,Nevada County,12,8803,4059,4744
California,Nevada County,13,9390,4483,4907
California,Nevada County,14,8354,4203,4151
California,Nevada County,15,5540,2692,2848
California,Nevada County,16,3678,1813,1865
California,Nevada County,17,2462,1125,1337
California,Nevada County,18,3145,1100,2045
California,Orange County,0,3145515,1553309,1592206
California,Orange County,1,192416,98555,93861
California,Orange County,2,197597,101122,96475
California,Orange County,3,204457,104422,100035
California,Orange County,4,211311,107625,103686
California,Orange County,5,229788,117169,112619
California,Orange County,6,226571,117117,109454
California,Orange County,7,215972,109606,106366
California,Orange County,8,202555,100402,102153
California,Orange County,9,223697,109637,114060
California,Orange County,10,227967,112451,115516
California,Orange County,11,230214,113965,116249
California,Orange County,12,204551,100427,104124
California,Orange County,13,164823,78687,86136
California,Orange County,14,134393,62836,71557
California,Orange County,15,97822,44971,52851
California,Orange County,16,71043,31539,39504
California,Orange County,17,52789,22059,30730
California,Orange County,18,57549,20719,36830
California,Placer County,0,371694,181221,190473
California,Placer County,1,20069,10006,10063
California,Placer County,2,23784,12086,11698
California,Placer County,3,25512,13094,12418
California,Placer County,4,24321,12527,11794
California,Placer County,5,20760,10686,10074
California,Placer County,6,19286,9833,9453
California,Placer County,7,21940,10922,11018
California,Placer County,8,22517,11083,11434
California,Placer County,9,24844,12089,12755
California,Placer County,10,25660,12524,13136
California,Placer County,11,27657,13496,14161
California,Placer County,12,25815,12402,13413
California,Placer County,13,23290,10939,12351
California,Placer County,14,21487,10047,11440
California,Placer County,15,15941,7313,8628
California,Placer County,16,11588,5314,6274
California,Placer County,17,8371,3665,4706
California,Placer County,18,8852,3195,5657
California,Plumas County,0,18606,9331,9275
California,Plumas County,1,817,464,353
California,Plumas County,2,929,478,451
California,Plumas County,3,901,438,463
California,Plumas County,4,954,514,440
California,Plumas County,5,926,491,435
California,Plumas County,6,821,424,397
California,Plumas County,7,836,421,415
California,Plumas County,8,854,431,423
California,Plumas County,9,838,428,410
California,Plumas County,10,982,495,487
California,Plumas County,11,1438,689,749
California,Plumas County,12,1770,807,963
California,Plumas County,13,1945,985,960
California,Plumas County,14,1668,828,840
California,Plumas County,15,1228,651,577
California,Plumas County,16,806,414,392
California,Plumas County,17,441,201,240
California,Plumas County,18,452,172,280
California,Riverside County,0,2329271,1158406,1170865
California,Riverside County,1,157766,80633,77133
California,Riverside County,2,171678,87573,84105
California,Riverside County,3,175280,88995,86285
California,Riverside County,4,178541,90989,87552
California,Riverside County,5,173491,88872,84619
California,Riverside County,6,159105,81627,77478
California,Riverside County,7,155608,78177,77431
California,Riverside County,8,147057,72623,74434
California,Riverside County,9,150935,74688,76247
California,Riverside County,10,150498,75929,74569
California,Riverside County,11,152708,76691,76017
California,Riverside County,12,136841,67955,68886
California,Riverside County,13,112492,53905,58587
California,Riverside County,14,98446,46640,51806
California,Riverside County,15,75220,34754,40466
California,Riverside County,16,55732,25618,30114
California,Riverside County,17,39756,17898,21858
California,Riverside County,18,38117,14839,23278
California,Sacramento County,0,1482026,724852,757174
California,Sacramento County,1,98691,50922,47769
California,Sacramento County,2,102711,52495,50216
California,Sacramento County,3,99496,50628,48868
California,Sacramento County,4,95874,49287,46587
California,Sacramento County,5,105810,53520,52290
California,Sacramento County,6,114951,57476,57475
California,Sacramento County,7,109249,54435,54814
California,Sacramento County,8,96361,47877,48484
California,Sacramento County,9,96319,47272,49047
California,Sacramento County,10,95235,47044,48191
California,Sacramento County,11,102012,49559,52453
California,Sacramento County,12,95377,45394,49983
California,Sacramento County,13,80249,37462,42787
California,Sacramento County,14,64504,29623,34881
California,Sacramento County,15,43242,19156,24086
California,Sacramento County,16,31869,13581,18288
California,Sacramento County,17,23728,9960,13768
California,Sacramento County,18,26348,9161,17187
California,San Benito County,0,58267,29233,29034
California,San Benito County,1,3916,1973,1943
California,San Benito County,2,4398,2177,2221
California,San Benito County,3,4489,2323,2166
California,San Benito County,4,4477,2323,2154
California,San Benito County,5,4015,2081,1934
California,San Benito County,6,3695,1920,1775
California,San Benito County,7,3913,2012,1901
California,San Benito County,8,3755,1897,1858
California,San Benito County,9,3770,1902,1868
California,San Benito County,10,4064,2009,2055
California,San Benito County,11,4219,2085,2134
California,San Benito County,12,3743,1889,1854
California,San Benito County,13,3173,1550,1623
California,San Benito County,14,2343,1181,1162
California,San Benito County,15,1590,762,828
California,San Benito County,16,959,471,488
California,San Benito County,17,859,341,518
California,San Benito County,18,889,337,552
California,San Bernardino County,0,2112619,1051255,1061364
California,San Bernardino County,1,154099,78689,75410
California,San Bernardino County,2,160701,82298,78403
California,San Bernardino County,3,160017,82054,77963
California,San Bernardino County,4,163794,84451,79343
California,San Bernardino County,5,175873,91733,84140
California,San Bernardino County,6,159598,81311,78287
California,San Bernardino County,7,147874,74595,73279
California,San Bernardino County,8,135850,67488,68362
California,San Bernardino County,9,136392,66985,69407
California,San Bernardino County,10,134909,66978,67931
California,San Bernardino County,11,138647,67903,70744
California,San Bernardino County,12,125819,60962,64857
California,San Bernardino County,13,100728,48272,52456
California,San Bernardino County,14,77473,37022,40451
California,San Bernardino County,15,53349,24610,28739
California,San Bernardino County,16,36992,16261,20731
California,San Bernardino County,17,25762,10778,14984
California,San Bernardino County,18,24742,8865,15877
California,San Diego County,0,3263431,1639868,1623563
California,San Diego County,1,213779,109148,104631
California,San Diego County,2,200517,102212,98305
California,San Diego County,3,194579,99385,95194
California,San Diego County,4,212319,111095,101224
California,San Diego County,5,273182,152042,121140
California,San Diego County,6,275719,144594,131125
California,San Diego County,7,249691,129176,120515
California,San Diego County,8,216944,110201,106743
California,San Diego County,9,212814,106645,106169
California,San Diego County,10,208378,104029,104349
California,San Diego County,11,218546,108569,109977
California,San Diego County,12,202510,98746,103764
California,San Diego County,13,169622,81404,88218
California,San Diego County,14,137274,64623,72651
California,San Diego County,15,94201,42982,51219
California,San Diego County,16,69148,30271,38877
California,San Diego County,17,53362,22518,30844
California,San Diego County,18,60846,22228,38618
California,San Francisco County,0,852469,434041,418428
California,San Francisco County,1,39440,20215,19225
California,San Francisco County,2,30786,15632,15154
California,San Francisco County,3,27813,14188,13625
California,San Francisco County,4,30956,15108,15848
California,San Francisco County,5,51375,24970,26405
California,San Francisco County,6,99444,50712,48732
California,San Francisco County,7,94360,49445,44915
California,San Francisco County,8,70969,37456,33513
California,San Francisco County,9,65346,35312,30034
California,San Francisco County,10,59388,32755,26633
California,San Francisco County,11,56338,30554,25784
California,San Francisco County,12,53575,28040,25535
California,San Francisco County,13,49764,24956,24808
California,San Francisco County,14,39186,19011,20175
California,San Francisco County,15,25967,12034,13933
California,San Francisco County,16,21158,9499,11659
California,San Francisco County,17,16992,7232,9760
California,San Francisco County,18,19612,6922,12690
California,San Joaquin County,0,715597,356209,359388
California,San Joaquin County,1,52479,26939,25540
California,San Joaquin County,2,56529,29014,27515
California,San Joaquin County,3,55905,28603,27302
California,San Joaquin County,4,54693,28228,26465
California,San Joaquin County,5,53127,27411,25716
California,San Joaquin County,6,48462,24821,23641
California,San Joaquin County,7,48413,24430,23983
California,San Joaquin County,8,45705,22781,22924
California,San Joaquin County,9,45740,22531,23209
California,San Joaquin County,10,45787,23104,22683
California,San Joaquin County,11,46753,23285,23468
California,San Joaquin County,12,42355,20990,21365
California,San Joaquin County,13,35439,16972,18467
California,San Joaquin County,14,28697,13478,15219
California,San Joaquin County,15,20173,9212,10961
California,San Joaquin County,16,13968,6166,7802
California,San Joaquin County,17,10051,4174,5877
California,San Joaquin County,18,11321,4070,7251
California,San Luis Obispo County,0,279083,142132,136951
California,San Luis Obispo County,1,13490,6971,6519
California,San Luis Obispo County,2,14153,7196,6957
California,San Luis Obispo County,3,14062,7167,6895
California,San Luis Obispo County,4,21976,11406,10570
California,San Luis Obispo County,5,30751,17205,13546
California,San Luis Obispo County,6,15827,8617,7210
California,San Luis Obispo County,7,16748,8902,7846
California,San Luis Obispo County,8,14758,7930,6828
California,San Luis Obispo County,9,14809,7905,6904
California,San Luis Obispo County,10,15548,8204,7344
California,San Luis Obispo County,11,18531,9235,9296
California,San Luis Obispo County,12,19997,9479,10518
California,San Luis Obispo County,13,19456,9414,10042
California,San Luis Obispo County,14,16442,8078,8364
California,San Luis Obispo County,15,11529,5454,6075
California,San Luis Obispo County,16,7897,3590,4307
California,San Luis Obispo County,17,5972,2660,3312
California,San Luis Obispo County,18,7137,2719,4418
California,San Mateo County,0,758581,373431,385150
California,San Mateo County,1,46193,23540,22653
California,San Mateo County,2,46322,23680,22642
California,San Mateo County,3,44528,22816,21712
California,San Mateo County,4,40761,20838,19923
California,San Mateo County,5,42536,22054,20482
California,San Mateo County,6,50688,26462,24226
California,San Mateo County,7,56419,28719,27700
California,San Mateo County,8,54886,27404,27482
California,San Mateo County,9,55940,27993,27947
California,San Mateo County,10,54751,26924,27827
California,San Mateo County,11,56472,27645,28827
California,San Mateo County,12,52712,25596,27116
California,San Mateo County,13,45167,21642,23525
California,San Mateo County,14,36426,16884,19542
California,San Mateo County,15,25339,11279,14060
California,San Mateo County,16,18408,8067,10341
California,San Mateo County,17,14028,5936,8092
California,San Mateo County,18,17005,5952,11053
California,Santa Barbara County,0,440668,220766,219902
California,Santa Barbara County,1,28238,14420,13818
California,Santa Barbara County,2,28004,14199,13805
California,Santa Barbara County,3,26169,13262,12907
California,Santa Barbara County,4,36139,18107,18032
California,Santa Barbara County,5,50875,26310,24565
California,Santa Barbara County,6,29198,15800,13398
California,Santa Barbara County,7,28992,15380,13612
California,Santa Barbara County,8,25188,13148,12040
California,Santa Barbara County,9,24841,12780,12061
California,Santa Barbara County,10,24835,12546,12289
California,Santa Barbara County,11,27368,13485,13883
California,Santa Barbara County,12,26276,12965,13311
California,Santa Barbara County,13,22962,11064,11898
California,Santa Barbara County,14,18806,8967,9839
California,Santa Barbara County,15,13628,6278,7350
California,Santa Barbara County,16,10505,4651,5854
California,Santa Barbara County,17,8516,3722,4794
California,Santa Barbara County,18,10128,3682,6446
California,Santa Clara County,0,1894605,952707,941898
California,Santa Clara County,1,122407,62851,59556
California,Santa Clara County,2,125675,64272,61403
California,Santa Clara County,3,121099,61977,59122
California,Santa Clara County,4,113333,58252,55081
California,Santa Clara County,5,121443,63562,57881
California,Santa Clara County,6,139731,73885,65846
California,Santa Clara County,7,147200,76305,70895
California,Santa Clara County,8,140321,71667,68654
California,Santa Clara County,9,143261,72299,70962
California,Santa Clara County,10,137088,69456,67632
California,Santa Clara County,11,136754,69613,67141
California,Santa Clara County,12,119664,60217,59447
California,Santa Clara County,13,95056,45742,49314
California,Santa Clara County,14,74596,35083,39513
California,Santa Clara County,15,54596,24814,29782
California,Santa Clara County,16,40491,18026,22465
California,Santa Clara County,17,29377,12697,16680
California,Santa Clara County,18,32513,11989,20524
California,Santa Cruz County,0,271804,134866,136938
California,Santa Cruz County,1,15165,7752,7413
California,Santa Cruz County,2,15230,7789,7441
California,Santa Cruz County,3,14979,7701,7278
California,Santa Cruz County,4,22270,10908,11362
California,Santa Cruz County,5,28842,14692,14150
California,Santa Cruz County,6,16122,8482,7640
California,Santa Cruz County,7,16570,8399,8171
California,Santa Cruz County,8,15946,8005,7941
California,Santa Cruz County,9,16292,8305,7987
California,Santa Cruz County,10,17032,8444,8588
California,Santa Cruz County,11,18690,9255,9435
California,Santa Cruz County,12,19493,9454,10039
California,Santa Cruz County,13,18549,9158,9391
California,Santa Cruz County,14,14097,6983,7114
California,Santa Cruz County,15,8361,3931,4430
California,Santa Cruz County,16,5160,2374,2786
California,Santa Cruz County,17,3855,1541,2314
California,Santa Cruz County,18,5151,1693,3458
California,Shasta County,0,179804,88172,91632
California,Shasta County,1,10348,5165,5183
California,Shasta County,2,10642,5413,5229
California,Shasta County,3,10942,5674,5268
California,Shasta County,4,10958,5761,5197
California,Shasta County,5,11089,5680,5409
California,Shasta County,6,11297,5729,5568
California,Shasta County,7,10875,5422,5453
California,Shasta County,8,9332,4659,4673
California,Shasta County,9,9696,4741,4955
California,Shasta County,10,10511,5173,5338
California,Shasta County,11,13110,6338,6772
California,Shasta County,12,13426,6400,7026
California,Shasta County,13,12978,6195,6783
California,Shasta County,14,11440,5508,5932
California,Shasta County,15,8718,4148,4570
California,Shasta County,16,6032,2780,3252
California,Shasta County,17,4220,1890,2330
California,Shasta County,18,4190,1496,2694
California,Sierra County,0,3003,1502,1501
California,Sierra County,1,100,43,57
California,Sierra County,2,148,74,74
California,Sierra County,3,140,74,66
California,Sierra County,4,148,84,64
California,Sierra County,5,121,70,51
California,Sierra County,6,85,47,38
California,Sierra County,7,131,61,70
California,Sierra County,8,132,68,64
California,Sierra County,9,139,61,78
California,Sierra County,10,166,78,88
California,Sierra County,11,261,132,129
California,Sierra County,12,285,128,157
California,Sierra County,13,342,173,169
California,Sierra County,14,318,164,154
California,Sierra County,15,195,98,97
California,Sierra County,16,121,64,57
California,Sierra County,17,109,50,59
California,Sierra County,18,62,33,29
California,Siskiyou County,0,43628,21663,21965
California,Siskiyou County,1,2339,1098,1241
California,Siskiyou County,2,2470,1280,1190
California,Siskiyou County,3,2449,1216,1233
California,Siskiyou County,4,2507,1317,1190
California,Siskiyou County,5,2244,1193,1051
California,Siskiyou County,6,2172,1140,1032
California,Siskiyou County,7,2271,1144,1127
California,Siskiyou County,8,1999,1035,964
California,Siskiyou County,9,2174,1116,1058
California,Siskiyou County,10,2297,1111,1186
California,Siskiyou County,11,3111,1520,1591
California,Siskiyou County,12,3776,1790,1986
California,Siskiyou County,13,3934,1878,2056
California,Siskiyou County,14,3527,1794,1733
California,Siskiyou County,15,2528,1318,1210
California,Siskiyou County,16,1570,780,790
California,Siskiyou County,17,1094,491,603
California,Siskiyou County,18,1166,442,724
California,Solano County,0,431131,214379,216752
California,Solano County,1,25955,13210,12745
California,Solano County,2,27853,14341,13512
California,Solano County,3,27841,14197,13644
California,Solano County,4,27679,14361,13318
California,Solano County,5,31804,16832,14972
California,Solano County,6,31609,16355,15254
California,Solano County,7,29668,15286,14382
California,Solano County,8,26108,13117,12991
California,Solano County,9,27029,13514,13515
California,Solano County,10,28211,14205,14006
California,Solano County,11,32038,15728,16310
California,Solano County,12,30796,14839,15957
California,Solano County,13,26264,12561,13703
California,Solano County,14,21217,10049,11168
California,Solano County,15,13560,6240,7320
California,Solano County,16,9528,4197,5331
California,Solano County,17,7039,2909,4130
California,Solano County,18,6932,2438,4494
California,Sonoma County,0,500292,245124,255168
California,Sonoma County,1,26500,13449,13051
California,Sonoma County,2,29072,14827,14245
California,Sonoma County,3,29435,15138,14297
California,Sonoma County,4,30753,15442,15311
California,Sonoma County,5,32200,16783,15417
California,Sonoma County,6,32345,16798,15547
California,Sonoma County,7,32910,16639,16271
California,Sonoma County,8,30071,15305,14766
California,Sonoma County,9,30625,15351,15274
California,Sonoma County,10,32478,16210,16268
California,Sonoma County,11,36993,17709,19284
California,Sonoma County,12,37448,17880,19568
California,Sonoma County,13,36013,16924,19089
California,Sonoma County,14,30229,14159,16070
California,Sonoma County,15,19355,9018,10337
California,Sonoma County,16,12600,5616,6984
California,Sonoma County,17,9104,3756,5348
California,Sonoma County,18,12161,4120,8041
California,Stanislaus County,0,531997,263243,268754
California,Stanislaus County,1,38756,19818,18938
California,Stanislaus County,2,41174,20948,20226
California,Stanislaus County,3,40627,20836,19791
California,Stanislaus County,4,39951,20640,19311
California,Stanislaus County,5,39429,20140,19289
California,Stanislaus County,6,38101,19206,18895
California,Stanislaus County,7,36332,18228,18104
California,Stanislaus County,8,33438,16774,16664
California,Stanislaus County,9,33165,16507,16658
California,Stanislaus County,10,33139,16339,16800
California,Stanislaus County,11,35020,17247,17773
California,Stanislaus County,12,31809,15466,16343
California,Stanislaus County,13,26633,12789,13844
California,Stanislaus County,14,21733,10205,11528
California,Stanislaus County,15,15131,6847,8284
California,Stanislaus County,16,11248,4896,6352
California,Stanislaus County,17,7979,3311,4668
California,Stanislaus County,18,8332,3046,5286
California,Sutter County,0,95847,47638,48209
California,Sutter County,1,6466,3366,3100
California,Sutter County,2,7253,3681,3572
California,Sutter County,3,7232,3722,3510
California,Sutter County,4,6730,3457,3273
California,Sutter County,5,6758,3456,3302
California,Sutter County,6,6615,3446,3169
California,Sutter County,7,6282,3092,3190
California,Sutter County,8,5772,2942,2830
California,Sutter County,9,5784,2907,2877
California,Sutter County,10,5843,2876,2967
California,Sutter County,11,6432,3166,3266
California,Sutter County,12,5897,2907,2990
California,Sutter County,13,4892,2367,2525
California,Sutter County,14,4393,2096,2297
California,Sutter County,15,3314,1509,1805
California,Sutter County,16,2550,1146,1404
California,Sutter County,17,1949,890,1059
California,Sutter County,18,1685,612,1073
California,Tehama County,0,63067,31405,31662
California,Tehama County,1,3906,2015,1891
California,Tehama County,2,4367,2234,2133
California,Tehama County,3,4220,2172,2048
California,Tehama County,4,4140,2114,2026
California,Tehama County,5,3876,2029,1847
California,Tehama County,6,3610,1794,1816
California,Tehama County,7,3597,1847,1750
California,Tehama County,8,3440,1792,1648
California,Tehama County,9,3506,1766,1740
California,Tehama County,10,3799,1881,1918
California,Tehama County,11,4791,2335,2456
California,Tehama County,12,4444,2175,2269
California,Tehama County,13,4134,1979,2155
California,Tehama County,14,3771,1861,1910
California,Tehama County,15,2781,1302,1479
California,Tehama County,16,2043,972,1071
California,Tehama County,17,1356,641,715
California,Tehama County,18,1286,496,790
California,Trinity County,0,13170,6716,6454
California,Trinity County,1,648,313,335
California,Trinity County,2,585,298,287
California,Trinity County,3,591,312,279
California,Trinity County,4,659,318,341
California,Trinity County,5,591,309,282
California,Trinity County,6,527,283,244
California,Trinity County,7,666,365,301
California,Trinity County,8,616,303,313
California,Trinity County,9,650,346,304
California,Trinity County,10,726,386,340
California,Trinity County,11,1090,538,552
California,Trinity County,12,1290,600,690
California,Trinity County,13,1376,709,667
California,Trinity County,14,1149,611,538
California,Trinity County,15,816,444,372
California,Trinity County,16,527,289,238
California,Trinity County,17,394,171,223
California,Trinity County,18,269,121,148
California,Tulare County,0,458198,229371,228827
California,Tulare County,1,40623,20869,19754
California,Tulare County,2,41600,21229,20371
California,Tulare County,3,39504,20110,19394
California,Tulare County,4,36839,18813,18026
California,Tulare County,5,35398,18186,17212
California,Tulare County,6,32268,16523,15745
California,Tulare County,7,32054,16271,15783
California,Tulare County,8,28853,14470,14383
California,Tulare County,9,27331,13851,13480
California,Tulare County,10,26290,13208,13082
California,Tulare County,11,26004,12963,13041
California,Tulare County,12,23843,11757,12086
California,Tulare County,13,19967,9604,10363
California,Tulare County,14,16168,7878,8290
California,Tulare County,15,11378,5316,6062
California,Tulare County,16,8243,3680,4563
California,Tulare County,17,5808,2430,3378
California,Tulare County,18,6027,2213,3814
California,Tuolumne County,0,53831,28082,25749
California,Tuolumne County,1,2262,1134,1128
California,Tuolumne County,2,2481,1286,1195
California,Tuolumne County,3,2555,1349,1206
California,Tuolumne County,4,2767,1459,1308
California,Tuolumne County,5,3028,1739,1289
California,Tuolumne County,6,3078,1822,1256
California,Tuolumne County,7,3151,1845,1306
California,Tuolumne County,8,2727,1568,1159
California,Tuolumne County,9,2845,1660,1185
California,Tuolumne County,10,3087,1678,1409
California,Tuolumne County,11,3830,1908,1922
California,Tuolumne County,12,4622,2268,2354
California,Tuolumne County,13,4772,2338,2434
California,Tuolumne County,14,4252,2131,2121
California,Tuolumne County,15,3094,1512,1582
California,Tuolumne County,16,2193,1073,1120
California,Tuolumne County,17,1523,718,805
California,Tuolumne County,18,1564,594,970
California,Ventura County,0,846178,418551,427627
California,Ventura County,1,53855,27376,26479
California,Ventura County,2,56880,28913,27967
California,Ventura County,3,57715,29203,28512
California,Ventura County,4,59253,30468,28785
California,Ventura County,5,61304,31399,29905
California,Ventura County,6,55296,28804,26492
California,Ventura County,7,54289,27788,26501
California,Ventura County,8,51702,25589,26113
California,Ventura County,9,55251,27450,27801
California,Ventura County,10,57858,28625,29233
California,Ventura County,11,62252,30489,31763
California,Ventura County,12,58023,28439,29584
California,Ventura County,13,47500,22816,24684
California,Ventura County,14,38394,18306,20088
California,Ventura County,15,27064,12539,14525
California,Ventura County,16,19051,8416,10635
California,Ventura County,17,14489,6221,8268
California,Ventura County,18,16002,5710,10292
California,Yolo County,0,207590,101021,106569
California,Yolo County,1,12125,6058,6067
California,Yolo County,2,12785,6519,6266
California,Yolo County,3,12558,6317,6241
California,Yolo County,4,17377,8376,9001
California,Yolo County,5,29817,14277,15540
California,Yolo County,6,14606,7496,7110
California,Yolo County,7,14026,7007,7019
California,Yolo County,8,12336,6168,6168
California,Yolo County,9,11830,5844,5986
California,Yolo County,10,11941,5897,6044
California,Yolo County,11,12307,5942,6365
California,Yolo County,12,11819,5650,6169
California,Yolo County,13,10203,4858,5345
California,Yolo County,14,8016,3771,4245
California,Yolo County,15,5536,2605,2931
California,Yolo County,16,3939,1734,2205
California,Yolo County,17,2915,1236,1679
California,Yolo County,18,3454,1266,2188
California,Yuba County,0,73966,37540,36426
California,Yuba County,1,5993,3124,2869
California,Yuba County,2,6010,3095,2915
California,Yuba County,3,5467,2873,2594
California,Yuba County,4,4988,2569,2419
California,Yuba County,5,5837,3214,2623
California,Yuba County,6,6081,3080,3001
California,Yuba County,7,5406,2724,2682
California,Yuba County,8,4600,2337,2263
California,Yuba County,9,4085,2069,2016
California,Yuba County,10,4125,2104,2021
California,Yuba County,11,4592,2272,2320
California,Yuba County,12,4453,2188,2265
California,Yuba County,13,3875,1948,1927
California,Yuba County,14,3003,1447,1556
California,Yuba County,15,2124,1013,1111
California,Yuba County,16,1468,671,797
California,Yuba County,17,986,462,524
California,Yuba County,18,873,350,523
Colorado,Adams County,0,480718,242129,238589
Colorado,Adams County,1,36559,18824,17735
Colorado,Adams County,2,38897,19913,18984
Colorado,Adams County,3,37425,19098,18327
Colorado,Adams County,4,31276,16147,15129
Colorado,Adams County,5,32410,16468,15942
Colorado,Adams County,6,37719,19313,18406
Colorado,Adams County,7,39569,20152,19417
Colorado,Adams County,8,36006,18719,17287
Colorado,Adams County,9,33941,17505,16436
Colorado,Adams County,10,30719,15666,15053
Colorado,Adams County,11,30670,15518,15152
Colorado,Adams County,12,27594,13731,13863
Colorado,Adams County,13,21935,10665,11270
Colorado,Adams County,14,17001,8102,8899
Colorado,Adams County,15,11152,4993,6159
Colorado,Adams County,16,7723,3346,4377
Colorado,Adams County,17,5343,2288,3055
Colorado,Adams County,18,4779,1681,3098
Colorado,Alamosa County,0,16177,8158,8019
Colorado,Alamosa County,1,1238,627,611
Colorado,Alamosa County,2,1114,569,545
Colorado,Alamosa County,3,970,515,455
Colorado,Alamosa County,4,1513,777,736
Colorado,Alamosa County,5,1900,952,948
Colorado,Alamosa County,6,1184,657,527
Colorado,Alamosa County,7,987,501,486
Colorado,Alamosa County,8,845,430,415
Colorado,Alamosa County,9,763,400,363
Colorado,Alamosa County,10,810,392,418
Colorado,Alamosa County,11,931,464,467
Colorado,Alamosa County,12,1010,488,522
Colorado,Alamosa County,13,869,426,443
Colorado,Alamosa County,14,702,343,359
Colorado,Alamosa County,15,500,248,252
Colorado,Alamosa County,16,365,175,190
Colorado,Alamosa County,17,219,92,127
Colorado,Alamosa County,18,257,102,155
Colorado,Arapahoe County,0,618821,304906,313915
Colorado,Arapahoe County,1,40358,20667,19691
Colorado,Arapahoe County,2,43503,22392,21111
Colorado,Arapahoe County,3,42697,21809,20888
Colorado,Arapahoe County,4,38859,20083,18776
Colorado,Arapahoe County,5,39917,20293,19624
Colorado,Arapahoe County,6,45525,22823,22702
Colorado,Arapahoe County,7,47035,23867,23168
Colorado,Arapahoe County,8,43740,21800,21940
Colorado,Arapahoe County,9,44086,21936,22150
Colorado,Arapahoe County,10,40612,19972,20640
Colorado,Arapahoe County,11,43196,20939,22257
Colorado,Arapahoe County,12,41041,19689,21352
Colorado,Arapahoe County,13,34739,16399,18340
Colorado,Arapahoe County,14,27098,12759,14339
Colorado,Arapahoe County,15,17301,7918,9383
Colorado,Arapahoe County,16,11652,5130,6522
Colorado,Arapahoe County,17,8302,3352,4950
Colorado,Arapahoe County,18,9160,3078,6082
Colorado,Archuleta County,0,12244,6138,6106
Colorado,Archuleta County,1,596,286,310
Colorado,Archuleta County,2,622,332,290
Colorado,Archuleta County,3,644,332,312
Colorado,Archuleta County,4,628,336,292
Colorado,Archuleta County,5,535,266,269
Colorado,Archuleta County,6,536,267,269
Colorado,Archuleta County,7,633,342,291
Colorado,Archuleta County,8,613,303,310
Colorado,Archuleta County,9,576,298,278
Colorado,Archuleta County,10,692,330,362
Colorado,Archuleta County,11,942,463,479
Colorado,Archuleta County,12,1105,522,583
Colorado,Archuleta County,13,1314,643,671
Colorado,Archuleta County,14,1184,614,570
Colorado,Archuleta County,15,694,376,318
Colorado,Archuleta County,16,403,196,207
Colorado,Archuleta County,17,302,142,160
Colorado,Archuleta County,18,225,90,135
Colorado,Baca County,0,3645,1818,1827
Colorado,Baca County,1,242,132,110
Colorado,Baca County,2,199,111,88
Colorado,Baca County,3,198,101,97
Colorado,Baca County,4,215,117,98
Colorado,Baca County,5,188,104,84
Colorado,Baca County,6,143,75,68
Colorado,Baca County,7,202,95,107
Colorado,Baca County,8,167,92,75
Colorado,Baca County,9,161,83,78
Colorado,Baca County,10,190,91,99
Colorado,Baca County,11,244,122,122
Colorado,Baca County,12,276,148,128
Colorado,Baca County,13,284,139,145
Colorado,Baca County,14,251,117,134
Colorado,Baca County,15,193,97,96
Colorado,Baca County,16,165,67,98
Colorado,Baca County,17,138,61,77
Colorado,Baca County,18,189,66,123
Colorado,Bent County,0,5630,3628,2002
Colorado,Bent County,1,210,110,100
Colorado,Bent County,2,268,130,138
Colorado,Bent County,3,270,129,141
Colorado,Bent County,4,271,146,125
Colorado,Bent County,5,392,294,98
Colorado,Bent County,6,487,396,91
Colorado,Bent County,7,415,331,84
Colorado,Bent County,8,384,295,89
Colorado,Bent County,9,441,337,104
Colorado,Bent County,10,379,280,99
Colorado,Bent County,11,419,261,158
Colorado,Bent County,12,386,232,154
Colorado,Bent County,13,357,211,146
Colorado,Bent County,14,315,181,134
Colorado,Bent County,15,204,106,98
Colorado,Bent County,16,165,80,85
Colorado,Bent County,17,140,56,84
Colorado,Bent County,18,127,53,74
Colorado,Boulder County,0,313333,157393,155940
Colorado,Boulder County,1,15822,8290,7532
Colorado,Boulder County,2,17951,9137,8814
Colorado,Boulder County,3,18829,9696,9133
Colorado,Boulder County,4,24685,12419,12266
Colorado,Boulder County,5,33908,17960,15948
Colorado,Boulder County,6,21656,11864,9792
Colorado,Boulder County,7,19563,10009,9554
Colorado,Boulder County,8,19687,9922,9765
Colorado,Boulder County,9,21014,10611,10403
Colorado,Boulder County,10,20487,10074,10413
Colorado,Boulder County,11,21907,10787,11120
Colorado,Boulder County,12,21238,10410,10828
Colorado,Boulder County,13,18318,8954,9364
Colorado,Boulder County,14,13989,6797,7192
Colorado,Boulder County,15,9060,4273,4787
Colorado,Boulder County,16,6022,2749,3273
Colorado,Boulder County,17,4253,1835,2418
Colorado,Boulder County,18,4944,1606,3338
Colorado,Broomfield County,0,62138,30808,31330
Colorado,Broomfield County,1,3757,1981,1776
Colorado,Broomfield County,2,4418,2214,2204
Colorado,Broomfield County,3,4603,2329,2274
Colorado,Broomfield County,4,3798,1941,1857
Colorado,Broomfield County,5,3647,1843,1804
Colorado,Broomfield County,6,4193,2228,1965
Colorado,Broomfield County,7,4296,2263,2033
Colorado,Broomfield County,8,4618,2261,2357
Colorado,Broomfield County,9,4931,2525,2406
Colorado,Broomfield County,10,4515,2268,2247
Colorado,Broomfield County,11,4393,2148,2245
Colorado,Broomfield County,12,4072,2013,2059
Colorado,Broomfield County,13,3332,1592,1740
Colorado,Broomfield County,14,2690,1233,1457
Colorado,Broomfield County,15,1758,798,960
Colorado,Broomfield County,16,1238,530,708
Colorado,Broomfield County,17,964,352,612
Colorado,Broomfield County,18,915,289,626
Colorado,Chaffee County,0,18363,9701,8662
Colorado,Chaffee County,1,741,373,368
Colorado,Chaffee County,2,796,414,382
Colorado,Chaffee County,3,848,414,434
Colorado,Chaffee County,4,825,433,392
Colorado,Chaffee County,5,945,575,370
Colorado,Chaffee County,6,1074,703,371
Colorado,Chaffee County,7,1107,665,442
Colorado,Chaffee County,8,998,589,409
Colorado,Chaffee County,9,1084,610,474
Colorado,Chaffee County,10,1075,609,466
Colorado,Chaffee County,11,1406,722,684
Colorado,Chaffee County,12,1552,733,819
Colorado,Chaffee County,13,1694,840,854
Colorado,Chaffee County,14,1460,681,779
Colorado,Chaffee County,15,1111,581,530
Colorado,Chaffee County,16,695,355,340
Colorado,Chaffee County,17,496,241,255
Colorado,Chaffee County,18,456,163,293
Colorado,Cheyenne County,0,1871,963,908
Colorado,Cheyenne County,1,156,70,86
Colorado,Cheyenne County,2,125,73,52
Colorado,Cheyenne County,3,109,53,56
Colorado,Cheyenne County,4,117,68,49
Colorado,Cheyenne County,5,78,39,39
Colorado,Cheyenne County,6,109,61,48
Colorado,Cheyenne County,7,117,52,65
Colorado,Cheyenne County,8,99,57,42
Colorado,Cheyenne County,9,99,58,41
Colorado,Cheyenne County,10,95,58,37
Colorado,Cheyenne County,11,158,81,77
Colorado,Cheyenne County,12,129,60,69
Colorado,Cheyenne County,13,140,72,68
Colorado,Cheyenne County,14,95,53,42
Colorado,Cheyenne County,15,72,34,38
Colorado,Cheyenne County,16,55,29,26
Colorado,Cheyenne County,17,56,26,30
Colorado,Cheyenne County,18,62,19,43
Colorado,Clear Creek County,0,9187,4773,4414
Colorado,Clear Creek County,1,349,171,178
Colorado,Clear Creek County,2,405,214,191
Colorado,Clear Creek County,3,415,201,214
Colorado,Clear Creek County,4,380,198,182
Colorado,Clear Creek County,5,393,205,188
Colorado,Clear Creek County,6,431,232,199
Colorado,Clear Creek County,7,458,243,215
Colorado,Clear Creek County,8,596,318,278
Colorado,Clear Creek County,9,652,347,305
Colorado,Clear Creek County,10,683,336,347
Colorado,Clear Creek County,11,855,433,422
Colorado,Clear Creek County,12,1017,541,476
Colorado,Clear Creek County,13,906,485,421
Colorado,Clear Creek County,14,739,397,342
Colorado,Clear Creek County,15,432,236,196
Colorado,Clear Creek County,16,224,109,115
Colorado,Clear Creek County,17,133,56,77
Colorado,Clear Creek County,18,119,51,68
Colorado,Conejos County,0,8265,4115,4150
Colorado,Conejos County,1,534,250,284
Colorado,Conejos County,2,632,321,311
Colorado,Conejos County,3,665,315,350
Colorado,Conejos County,4,637,329,308
Colorado,Conejos County,5,490,241,249
Colorado,Conejos County,6,434,233,201
Colorado,Conejos County,7,434,221,213
Colorado,Conejos County,8,416,222,194
Colorado,Conejos County,9,401,192,209
Colorado,Conejos County,10,473,243,230
Colorado,Conejos County,11,565,273,292
Colorado,Conejos County,12,584,304,280
Colorado,Conejos County,13,565,285,280
Colorado,Conejos County,14,462,221,241
Colorado,Conejos County,15,342,169,173
Colorado,Conejos County,16,279,141,138
Colorado,Conejos County,17,209,96,113
Colorado,Conejos County,18,143,59,84
Colorado,Costilla County,0,3568,1870,1698
Colorado,Costilla County,1,140,80,60
Colorado,Costilla County,2,193,99,94
Colorado,Costilla County,3,203,106,97
Colorado,Costilla County,4,212,118,94
Colorado,Costilla County,5,208,121,87
Colorado,Costilla County,6,150,74,76
Colorado,Costilla County,7,153,80,73
Colorado,Costilla County,8,122,64,58
Colorado,Costilla County,9,166,91,75
Colorado,Costilla County,10,194,101,93
Colorado,Costilla County,11,253,141,112
Colorado,Costilla County,12,335,164,171
Colorado,Costilla County,13,318,156,162
Colorado,Costilla County,14,315,171,144
Colorado,Costilla County,15,266,140,126
Colorado,Costilla County,16,161,87,74
Colorado,Costilla County,17,103,53,50
Colorado,Costilla County,18,76,24,52
Colorado,Crowley County,0,5360,3743,1617
Colorado,Crowley County,1,229,104,125
Colorado,Crowley County,2,180,74,106
Colorado,Crowley County,3,217,113,104
Colorado,Crowley County,4,209,124,85
Colorado,Crowley County,5,452,366,86
Colorado,Crowley County,6,554,482,72
Colorado,Crowley County,7,468,396,72
Colorado,Crowley County,8,453,372,81
Colorado,Crowley County,9,404,331,73
Colorado,Crowley County,10,450,364,86
Colorado,Crowley County,11,418,288,130
Colorado,Crowley County,12,326,203,123
Colorado,Crowley County,13,302,182,120
Colorado,Crowley County,14,246,129,117
Colorado,Crowley County,15,173,91,82
Colorado,Crowley County,16,106,59,47
Colorado,Crowley County,17,91,29,62
Colorado,Crowley County,18,82,36,46
Colorado,Custer County,0,4361,2218,2143
Colorado,Custer County,1,108,47,61
Colorado,Custer County,2,170,82,88
Colorado,Custer County,3,218,100,118
Colorado,Custer County,4,219,118,101
Colorado,Custer County,5,160,98,62
Colorado,Custer County,6,100,58,42
Colorado,Custer County,7,165,92,73
Colorado,Custer County,8,173,104,69
Colorado,Custer County,9,194,101,93
Colorado,Custer County,10,244,124,120
Colorado,Custer County,11,343,160,183
Colorado,Custer County,12,431,192,239
Colorado,Custer County,13,573,265,308
Colorado,Custer County,14,540,297,243
Colorado,Custer County,15,351,203,148
Colorado,Custer County,16,187,99,88
Colorado,Custer County,17,114,47,67
Colorado,Custer County,18,71,31,40
Colorado,Delta County,0,29870,14914,14956
Colorado,Delta County,1,1537,769,768
Colorado,Delta County,2,1673,843,830
Colorado,Delta County,3,1844,944,900
Colorado,Delta County,4,1848,954,894
Colorado,Delta County,5,1400,771,629
Colorado,Delta County,6,1384,731,653
Colorado,Delta County,7,1507,759,748
Colorado,Delta County,8,1485,784,701
Colorado,Delta County,9,1525,774,751
Colorado,Delta County,10,1582,799,783
Colorado,Delta County,11,2175,1063,1112
Colorado,Delta County,12,2420,1195,1225
Colorado,Delta County,13,2474,1175,1299
Colorado,Delta County,14,2283,1148,1135
Colorado,Delta County,15,1738,855,883
Colorado,Delta County,16,1294,621,673
Colorado,Delta County,17,869,395,474
Colorado,Delta County,18,832,334,498
Colorado,Denver County,0,663862,331919,331943
Colorado,Denver County,1,45286,23175,22111
Colorado,Denver County,2,40375,20630,19745
Colorado,Denver County,3,35063,17688,17375
Colorado,Denver County,4,31169,15307,15862
Colorado,Denver County,5,44220,21569,22651
Colorado,Denver County,6,74796,37543,37253
Colorado,Denver County,7,71296,36798,34498
Colorado,Denver County,8,54944,28496,26448
Colorado,Denver County,9,47867,25639,22228
Colorado,Denver County,10,39432,20938,18494
Colorado,Denver County,11,37632,19197,18435
Colorado,Denver County,12,36333,17882,18451
Colorado,Denver County,13,33272,16137,17135
Colorado,Denver County,14,25443,11922,13521
Colorado,Denver County,15,16296,7238,9058
Colorado,Denver County,16,11475,4826,6649
Colorado,Denver County,17,8658,3509,5149
Colorado,Denver County,18,10305,3425,6880
Colorado,Dolores County,0,1978,1028,950
Colorado,Dolores County,1,97,41,56
Colorado,Dolores County,2,125,65,60
Colorado,Dolores County,3,118,62,56
Colorado,Dolores County,4,107,63,44
Colorado,Dolores County,5,75,39,36
Colorado,Dolores County,6,76,41,35
Colorado,Dolores County,7,98,48,50
Colorado,Dolores County,8,119,61,58
Colorado,Dolores County,9,109,59,50
Colorado,Dolores County,10,131,68,63
Colorado,Dolores County,11,145,77,68
Colorado,Dolores County,12,192,99,93
Colorado,Dolores County,13,151,81,70
Colorado,Dolores County,14,148,80,68
Colorado,Dolores County,15,114,64,50
Colorado,Dolores County,16,74,39,35
Colorado,Dolores County,17,45,20,25
Colorado,Dolores County,18,54,21,33
Colorado,Douglas County,0,314638,156281,158357
Colorado,Douglas County,1,19716,10230,9486
Colorado,Douglas County,2,25504,13047,12457
Colorado,Douglas County,3,28578,14765,13813
Colorado,Douglas County,4,22785,11685,11100
Colorado,Douglas County,5,14704,7423,7281
Colorado,Douglas County,6,14055,6983,7072
Colorado,Douglas County,7,19197,9250,9947
Colorado,Douglas County,8,22778,11089,11689
Colorado,Douglas County,9,27865,13771,14094
Colorado,Douglas County,10,26490,13068,13422
Colorado,Douglas County,11,25082,12430,12652
Colorado,Douglas County,12,20535,10215,10320
Colorado,Douglas County,13,16091,7827,8264
Colorado,Douglas County,14,12801,6112,6689
Colorado,Douglas County,15,7940,3947,3993
Colorado,Douglas County,16,4542,2101,2441
Colorado,Douglas County,17,2938,1295,1643
Colorado,Douglas County,18,3037,1043,1994
Colorado,Eagle County,0,52921,28022,24899
Colorado,Eagle County,1,3210,1630,1580
Colorado,Eagle County,2,3673,1886,1787
Colorado,Eagle County,3,3514,1802,1712
Colorado,Eagle County,4,2873,1449,1424
Colorado,Eagle County,5,3034,1722,1312
Colorado,Eagle County,6,4547,2509,2038
Colorado,Eagle County,7,4516,2443,2073
Colorado,Eagle County,8,4335,2393,1942
Colorado,Eagle County,9,4449,2383,2066
Colorado,Eagle County,10,4156,2179,1977
Colorado,Eagle County,11,3728,1924,1804
Colorado,Eagle County,12,3617,1933,1684
Colorado,Eagle County,13,2957,1579,1378
Colorado,Eagle County,14,2118,1077,1041
Colorado,Eagle County,15,1156,610,546
Colorado,Eagle County,16,536,298,238
Colorado,Eagle County,17,269,121,148
Colorado,Eagle County,18,233,84,149
Colorado,Elbert County,0,24195,12142,12053
Colorado,Elbert County,1,944,483,461
Colorado,Elbert County,2,1459,743,716
Colorado,Elbert County,3,1838,895,943
Colorado,Elbert County,4,1835,979,856
Colorado,Elbert County,5,1153,582,571
Colorado,Elbert County,6,884,442,442
Colorado,Elbert County,7,982,493,489
Colorado,Elbert County,8,1201,593,608
Colorado,Elbert County,9,1624,786,838
Colorado,Elbert County,10,2013,982,1031
Colorado,Elbert County,11,2486,1239,1247
Colorado,Elbert County,12,2442,1228,1214
Colorado,Elbert County,13,1968,975,993
Colorado,Elbert County,14,1514,805,709
Colorado,Elbert County,15,852,462,390
Colorado,Elbert County,16,456,247,209
Colorado,Elbert County,17,258,123,135
Colorado,Elbert County,18,286,85,201
Colorado,El Paso County,0,663519,334684,328835
Colorado,El Paso County,1,46092,23954,22138
Colorado,El Paso County,2,46320,23628,22692
Colorado,El Paso County,3,46226,23546,22680
Colorado,El Paso County,4,47067,25132,21935
Colorado,El Paso County,5,57068,32507,24561
Colorado,El Paso County,6,52935,27745,25190
Colorado,El Paso County,7,47396,24404,22992
Colorado,El Paso County,8,41367,20923,20444
Colorado,El Paso County,9,40978,20550,20428
Colorado,El Paso County,10,40439,19939,20500
Colorado,El Paso County,11,45726,22150,23576
Colorado,El Paso County,12,41680,20045,21635
Colorado,El Paso County,13,34052,16322,17730
Colorado,El Paso County,14,27297,12964,14333
Colorado,El Paso County,15,18565,8562,10003
Colorado,El Paso County,16,12710,5472,7238
Colorado,El Paso County,17,9209,3953,5256
Colorado,El Paso County,18,8392,2888,5504
Colorado,Fremont County,0,46502,26827,19675
Colorado,Fremont County,1,1855,912,943
Colorado,Fremont County,2,2135,1076,1059
Colorado,Fremont County,3,2225,1126,1099
Colorado,Fremont County,4,2251,1197,1054
Colorado,Fremont County,5,2518,1645,873
Colorado,Fremont County,6,3250,2362,888
Colorado,Fremont County,7,3258,2316,942
Colorado,Fremont County,8,2987,2090,897
Colorado,Fremont County,9,3073,2069,1004
Colorado,Fremont County,10,3199,2031,1168
Colorado,Fremont County,11,3552,1975,1577
Colorado,Fremont County,12,3421,1787,1634
Colorado,Fremont County,13,3359,1703,1656
Colorado,Fremont County,14,3093,1553,1540
Colorado,Fremont County,15,2407,1192,1215
Colorado,Fremont County,16,1655,820,835
Colorado,Fremont County,17,1169,558,611
Colorado,Fremont County,18,1095,415,680
Colorado,Garfield County,0,57461,29343,28118
Colorado,Garfield County,1,4102,2048,2054
Colorado,Garfield County,2,4306,2172,2134
Colorado,Garfield County,3,4112,2120,1992
Colorado,Garfield County,4,3740,1998,1742
Colorado,Garfield County,5,3342,1757,1585
Colorado,Garfield County,6,3843,2035,1808
Colorado,Garfield County,7,4217,2166,2051
Colorado,Garfield County,8,4100,2063,2037
Colorado,Garfield County,9,4005,2088,1917
Colorado,Garfield County,10,3843,1953,1890
Colorado,Garfield County,11,4144,2109,2035
Colorado,Garfield County,12,3975,2030,1945
Colorado,Garfield County,13,3567,1812,1755
Colorado,Garfield County,14,2441,1287,1154
Colorado,Garfield County,15,1433,731,702
Colorado,Garfield County,16,965,481,484
Colorado,Garfield County,17,634,259,375
Colorado,Garfield County,18,692,234,458
Colorado,Gilpin County,0,5851,3082,2769
Colorado,Gilpin County,1,220,115,105
Colorado,Gilpin County,2,316,161,155
Colorado,Gilpin County,3,329,164,165
Colorado,Gilpin County,4,313,162,151
Colorado,Gilpin County,5,207,116,91
Colorado,Gilpin County,6,267,152,115
Colorado,Gilpin County,7,312,155,157
Colorado,Gilpin County,8,387,189,198
Colorado,Gilpin County,9,453,247,206
Colorado,Gilpin County,10,436,241,195
Colorado,Gilpin County,11,628,361,267
Colorado,Gilpin County,12,636,308,328
Colorado,Gilpin County,13,574,300,274
Colorado,Gilpin County,14,371,193,178
Colorado,Gilpin County,15,211,119,92
Colorado,Gilpin County,16,96,48,48
Colorado,Gilpin County,17,47,31,16
Colorado,Gilpin County,18,48,20,28
Colorado,Grand County,0,14546,7714,6832
Colorado,Grand County,1,606,294,312
Colorado,Grand County,2,785,371,414
Colorado,Grand County,3,847,454,393
Colorado,Grand County,4,721,362,359
Colorado,Grand County,5,773,423,350
Colorado,Grand County,6,998,536,462
Colorado,Grand County,7,949,524,425
Colorado,Grand County,8,944,509,435
Colorado,Grand County,9,996,566,430
Colorado,Grand County,10,987,503,484
Colorado,Grand County,11,1204,604,600
Colorado,Grand County,12,1447,744,703
Colorado,Grand County,13,1267,712,555
Colorado,Grand County,14,918,509,409
Colorado,Grand County,15,541,302,239
Colorado,Grand County,16,262,149,113
Colorado,Grand County,17,171,96,75
Colorado,Grand County,18,130,56,74
Colorado,Gunnison County,0,15725,8515,7210
Colorado,Gunnison County,1,755,422,333
Colorado,Gunnison County,2,809,461,348
Colorado,Gunnison County,3,844,399,445
Colorado,Gunnison County,4,1206,693,513
Colorado,Gunnison County,5,2085,1168,917
Colorado,Gunnison County,6,1129,677,452
Colorado,Gunnison County,7,1107,617,490
Colorado,Gunnison County,8,994,537,457
Colorado,Gunnison County,9,1068,570,498
Colorado,Gunnison County,10,913,503,410
Colorado,Gunnison County,11,969,450,519
Colorado,Gunnison County,12,1066,561,505
Colorado,Gunnison County,13,1015,543,472
Colorado,Gunnison County,14,745,399,346
Colorado,Gunnison County,15,495,259,236
Colorado,Gunnison County,16,224,123,101
Colorado,Gunnison County,17,152,74,78
Colorado,Gunnison County,18,149,59,90
Colorado,Hinsdale County,0,786,407,379
Colorado,Hinsdale County,1,49,32,17
Colorado,Hinsdale County,2,43,28,15
Colorado,Hinsdale County,3,37,19,18
Colorado,Hinsdale County,4,30,13,17
Colorado,Hinsdale County,5,34,20,14
Colorado,Hinsdale County,6,44,22,22
Colorado,Hinsdale County,7,31,16,15
Colorado,Hinsdale County,8,32,19,13
Colorado,Hinsdale County,9,37,13,24
Colorado,Hinsdale County,10,42,23,19
Colorado,Hinsdale County,11,65,32,33
Colorado,Hinsdale County,12,70,31,39
Colorado,Hinsdale County,13,70,32,38
Colorado,Hinsdale County,14,82,43,39
Colorado,Hinsdale County,15,61,34,27
Colorado,Hinsdale County,16,26,13,13
Colorado,Hinsdale County,17,20,10,10
Colorado,Hinsdale County,18,13,7,6
Colorado,Huerfano County,0,6462,3257,3205
Colorado,Huerfano County,1,244,137,107
Colorado,Huerfano County,2,269,146,123
Colorado,Huerfano County,3,323,176,147
Colorado,Huerfano County,4,266,122,144
Colorado,Huerfano County,5,304,159,145
Colorado,Huerfano County,6,249,117,132
Colorado,Huerfano County,7,260,143,117
Colorado,Huerfano County,8,260,141,119
Colorado,Huerfano County,9,258,137,121
Colorado,Huerfano County,10,340,181,159
Colorado,Huerfano County,11,513,243,270
Colorado,Huerfano County,12,579,255,324
Colorado,Huerfano County,13,675,340,335
Colorado,Huerfano County,14,635,326,309
Colorado,Huerfano County,15,505,253,252
Colorado,Huerfano County,16,324,174,150
Colorado,Huerfano County,17,212,109,103
Colorado,Huerfano County,18,246,98,148
Colorado,Jackson County,0,1396,744,652
Colorado,Jackson County,1,48,24,24
Colorado,Jackson County,2,69,44,25
Colorado,Jackson County,3,78,28,50
Colorado,Jackson County,4,80,48,32
Colorado,Jackson County,5,66,39,27
Colorado,Jackson County,6,89,60,29
Colorado,Jackson County,7,59,28,31
Colorado,Jackson County,8,89,46,43
Colorado,Jackson County,9,78,40,38
Colorado,Jackson County,10,88,47,41
Colorado,Jackson County,11,112,60,52
Colorado,Jackson County,12,137,84,53
Colorado,Jackson County,13,111,55,56
Colorado,Jackson County,14,89,49,40
Colorado,Jackson County,15,72,30,42
Colorado,Jackson County,16,53,22,31
Colorado,Jackson County,17,45,25,20
Colorado,Jackson County,18,33,15,18
Colorado,Jefferson County,0,558503,277625,280878
Colorado,Jefferson County,1,29401,15052,14349
Colorado,Jefferson County,2,32130,16523,15607
Colorado,Jefferson County,3,33986,17343,16643
Colorado,Jefferson County,4,33769,17765,16004
Colorado,Jefferson County,5,34120,17757,16363
Colorado,Jefferson County,6,38610,20516,18094
Colorado,Jefferson County,7,38342,19800,18542
Colorado,Jefferson County,8,35130,17821,17309
Colorado,Jefferson County,9,36577,18483,18094
Colorado,Jefferson County,10,37900,18611,19289
Colorado,Jefferson County,11,44997,21655,23342
Colorado,Jefferson County,12,43827,21482,22345
Colorado,Jefferson County,13,37780,18281,19499
Colorado,Jefferson County,14,29406,14086,15320
Colorado,Jefferson County,15,19332,8871,10461
Colorado,Jefferson County,16,13425,5992,7433
Colorado,Jefferson County,17,9624,4093,5531
Colorado,Jefferson County,18,10147,3494,6653
Colorado,Kiowa County,0,1402,690,712
Colorado,Kiowa County,1,90,53,37
Colorado,Kiowa County,2,68,25,43
Colorado,Kiowa County,3,78,38,40
Colorado,Kiowa County,4,85,51,34
Colorado,Kiowa County,5,87,42,45
Colorado,Kiowa County,6,46,19,27
Colorado,Kiowa County,7,74,40,34
Colorado,Kiowa County,8,64,32,32
Colorado,Kiowa County,9,68,29,39
Colorado,Kiowa County,10,61,31,30
Colorado,Kiowa County,11,120,57,63
Colorado,Kiowa County,12,101,52,49
Colorado,Kiowa County,13,122,69,53
Colorado,Kiowa County,14,88,39,49
Colorado,Kiowa County,15,76,42,34
Colorado,Kiowa County,16,72,26,46
Colorado,Kiowa County,17,31,16,15
Colorado,Kiowa County,18,71,29,42
Colorado,Kit Carson County,0,8072,4456,3616
Colorado,Kit Carson County,1,501,263,238
Colorado,Kit Carson County,2,547,273,274
Colorado,Kit Carson County,3,466,232,234
Colorado,Kit Carson County,4,456,251,205
Colorado,Kit Carson County,5,494,293,201
Colorado,Kit Carson County,6,525,331,194
Colorado,Kit Carson County,7,588,387,201
Colorado,Kit Carson County,8,523,313,210
Colorado,Kit Carson County,9,462,279,183
Colorado,Kit Carson County,10,484,292,192
Colorado,Kit Carson County,11,586,312,274
Colorado,Kit Carson County,12,587,317,270
Colorado,Kit Carson County,13,467,248,219
Colorado,Kit Carson County,14,378,203,175
Colorado,Kit Carson County,15,336,150,186
Colorado,Kit Carson County,16,244,124,120
Colorado,Kit Carson County,17,193,102,91
Colorado,Kit Carson County,18,235,86,149
Colorado,Lake County,0,7357,3924,3433
Colorado,Lake County,1,476,261,215
Colorado,Lake County,2,504,260,244
Colorado,Lake County,3,461,236,225
Colorado,Lake County,4,415,223,192
Colorado,Lake County,5,519,291,228
Colorado,Lake County,6,544,294,250
Colorado,Lake County,7,570,299,271
Colorado,Lake County,8,502,286,216
Colorado,Lake County,9,527,279,248
Colorado,Lake County,10,449,234,215
Colorado,Lake County,11,517,275,242
Colorado,Lake County,12,511,288,223
Colorado,Lake County,13,550,293,257
Colorado,Lake County,14,312,168,144
Colorado,Lake County,15,216,109,107
Colorado,Lake County,16,136,73,63
Colorado,Lake County,17,91,39,52
Colorado,Lake County,18,57,16,41
Colorado,La Plata County,0,53989,27427,26562
Colorado,La Plata County,1,2770,1493,1277
Colorado,La Plata County,2,2957,1569,1388
Colorado,La Plata County,3,2941,1479,1462
Colorado,La Plata County,4,3650,1891,1759
Colorado,La Plata County,5,3806,1980,1826
Colorado,La Plata County,6,3859,2022,1837
Colorado,La Plata County,7,3811,2015,1796
Colorado,La Plata County,8,3424,1780,1644
Colorado,La Plata County,9,3398,1756,1642
Colorado,La Plata County,10,3261,1576,1685
Colorado,La Plata County,11,3942,1898,2044
Colorado,La Plata County,12,4382,2119,2263
Colorado,La Plata County,13,4111,2053,2058
Colorado,La Plata County,14,3066,1597,1469
Colorado,La Plata County,15,1904,969,935
Colorado,La Plata County,16,1188,607,581
Colorado,La Plata County,17,741,349,392
Colorado,La Plata County,18,778,274,504
Colorado,Larimer County,0,324122,161543,162579
Colorado,Larimer County,1,17526,8966,8560
Colorado,Larimer County,2,18882,9643,9239
Colorado,Larimer County,3,18967,9720,9247
Colorado,Larimer County,4,22692,11332,11360
Colorado,Larimer County,5,35981,18552,17429
Colorado,Larimer County,6,23394,12345,11049
Colorado,Larimer County,7,21795,11226,10569
Colorado,Larimer County,8,19892,10284,9608
Colorado,Larimer County,9,19185,9915,9270
Colorado,Larimer County,10,17847,8806,9041
Colorado,Larimer County,11,20818,10020,10798
Colorado,Larimer County,12,21955,10538,11417
Colorado,Larimer County,13,20014,9639,10375
Colorado,Larimer County,14,16049,7815,8234
Colorado,Larimer County,15,11135,5275,5860
Colorado,Larimer County,16,7140,3272,3868
Colorado,Larimer County,17,5190,2245,2945
Colorado,Larimer County,18,5660,1950,3710
Colorado,Las Animas County,0,14052,7244,6808
Colorado,Las Animas County,1,714,375,339
Colorado,Las Animas County,2,736,385,351
Colorado,Las Animas County,3,775,388,387
Colorado,Las Animas County,4,832,431,401
Colorado,Las Animas County,5,830,471,359
Colorado,Las Animas County,6,773,438,335
Colorado,Las Animas County,7,759,429,330
Colorado,Las Animas County,8,679,359,320
Colorado,Las Animas County,9,734,374,360
Colorado,Las Animas County,10,805,432,373
Colorado,Las Animas County,11,987,511,476
Colorado,Las Animas County,12,1173,594,579
Colorado,Las Animas County,13,1122,574,548
Colorado,Las Animas County,14,1101,579,522
Colorado,Las Animas County,15,779,389,390
Colorado,Las Animas County,16,533,257,276
Colorado,Las Animas County,17,307,128,179
Colorado,Las Animas County,18,413,130,283
Colorado,Lincoln County,0,5510,3258,2252
Colorado,Lincoln County,1,306,182,124
Colorado,Lincoln County,2,303,163,140
Colorado,Lincoln County,3,285,140,145
Colorado,Lincoln County,4,293,151,142
Colorado,Lincoln County,5,372,241,131
Colorado,Lincoln County,6,423,305,118
Colorado,Lincoln County,7,435,308,127
Colorado,Lincoln County,8,344,228,116
Colorado,Lincoln County,9,317,203,114
Colorado,Lincoln County,10,382,229,153
Colorado,Lincoln County,11,419,263,156
Colorado,Lincoln County,12,359,202,157
Colorado,Lincoln County,13,311,169,142
Colorado,Lincoln County,14,245,124,121
Colorado,Lincoln County,15,237,136,101
Colorado,Lincoln County,16,175,77,98
Colorado,Lincoln County,17,138,72,66
Colorado,Lincoln County,18,166,65,101
Colorado,Logan County,0,22524,12731,9793
Colorado,Logan County,1,1131,556,575
Colorado,Logan County,2,1099,558,541
Colorado,Logan County,3,1188,605,583
Colorado,Logan County,4,1749,1012,737
Colorado,Logan County,5,1830,1128,702
Colorado,Logan County,6,1748,1185,563
Colorado,Logan County,7,1609,1074,535
Colorado,Logan County,8,1472,952,520
Colorado,Logan County,9,1332,822,510
Colorado,Logan County,10,1371,857,514
Colorado,Logan County,11,1566,848,718
Colorado,Logan County,12,1578,866,712
Colorado,Logan County,13,1321,700,621
Colorado,Logan County,14,1028,525,503
Colorado,Logan County,15,786,370,416
Colorado,Logan County,16,588,269,319
Colorado,Logan County,17,495,202,293
Colorado,Logan County,18,633,202,431
Colorado,Mesa County,0,148255,73624,74631
Colorado,Mesa County,1,9328,4817,4511
Colorado,Mesa County,2,9465,4760,4705
Colorado,Mesa County,3,9070,4708,4362
Colorado,Mesa County,4,9990,5196,4794
Colorado,Mesa County,5,10522,5313,5209
Colorado,Mesa County,6,10130,5269,4861
Colorado,Mesa County,7,9596,4988,4608
Colorado,Mesa County,8,8538,4362,4176
Colorado,Mesa County,9,8070,4110,3960
Colorado,Mesa County,10,8032,3994,4038
Colorado,Mesa County,11,10100,4857,5243
Colorado,Mesa County,12,10652,5210,5442
Colorado,Mesa County,13,9716,4693,5023
Colorado,Mesa County,14,8064,3856,4208
Colorado,Mesa County,15,5923,2809,3114
Colorado,Mesa County,16,4412,2044,2368
Colorado,Mesa County,17,3189,1393,1796
Colorado,Mesa County,18,3458,1245,2213
Colorado,Mineral County,0,698,366,332
Colorado,Mineral County,1,33,16,17
Colorado,Mineral County,2,15,9,6
Colorado,Mineral County,3,30,18,12
Colorado,Mineral County,4,18,11,7
Colorado,Mineral County,5,28,20,8
Colorado,Mineral County,6,28,14,14
Colorado,Mineral County,7,40,20,20
Colorado,Mineral County,8,29,17,12
Colorado,Mineral County,9,36,16,20
Colorado,Mineral County,10,30,17,13
Colorado,Mineral County,11,61,30,31
Colorado,Mineral County,12,62,24,38
Colorado,Mineral County,13,103,58,45
Colorado,Mineral County,14,81,42,39
Colorado,Mineral County,15,46,22,24
Colorado,Mineral County,16,24,15,9
Colorado,Mineral County,17,18,11,7
Colorado,Mineral County,18,16,6,10
Colorado,Moffat County,0,12928,6704,6224
Colorado,Moffat County,1,890,478,412
Colorado,Moffat County,2,965,553,412
Colorado,Moffat County,3,965,504,461
Colorado,Moffat County,4,795,414,381
Colorado,Moffat County,5,764,389,375
Colorado,Moffat County,6,792,398,394
Colorado,Moffat County,7,907,487,420
Colorado,Moffat County,8,764,407,357
Colorado,Moffat County,9,738,362,376
Colorado,Moffat County,10,769,397,372
Colorado,Moffat County,11,990,511,479
Colorado,Moffat County,12,1022,501,521
Colorado,Moffat County,13,905,489,416
Colorado,Moffat County,14,608,317,291
Colorado,Moffat County,15,442,226,216
Colorado,Moffat County,16,234,126,108
Colorado,Moffat County,17,200,86,114
Colorado,Moffat County,18,178,59,119
Colorado,Montezuma County,0,25772,12815,12957
Colorado,Montezuma County,1,1588,847,741
Colorado,Montezuma County,2,1607,860,747
Colorado,Montezuma County,3,1664,858,806
Colorado,Montezuma County,4,1500,776,724
Colorado,Montezuma County,5,1356,684,672
Colorado,Montezuma County,6,1377,723,654
Colorado,Montezuma County,7,1414,720,694
Colorado,Montezuma County,8,1339,651,688
Colorado,Montezuma County,9,1449,729,720
Colorado,Montezuma County,10,1508,724,784
Colorado,Montezuma County,11,1870,895,975
Colorado,Montezuma County,12,2070,974,1096
Colorado,Montezuma County,13,2106,1018,1088
Colorado,Montezuma County,14,1772,878,894
Colorado,Montezuma County,15,1196,554,642
Colorado,Montezuma County,16,797,413,384
Colorado,Montezuma County,17,575,275,300
Colorado,Montezuma County,18,584,236,348
Colorado,Montrose County,0,40873,20127,20746
Colorado,Montrose County,1,2283,1132,1151
Colorado,Montrose County,2,2524,1300,1224
Colorado,Montrose County,3,2705,1418,1287
Colorado,Montrose County,4,2607,1328,1279
Colorado,Montrose County,5,1970,1011,959
Colorado,Montrose County,6,1882,967,915
Colorado,Montrose County,7,2370,1197,1173
Colorado,Montrose County,8,2117,1022,1095
Colorado,Montrose County,9,2343,1169,1174
Colorado,Montrose County,10,2389,1186,1203
Colorado,Montrose County,11,2881,1409,1472
Colorado,Montrose County,12,3101,1487,1614
Colorado,Montrose County,13,3007,1418,1589
Colorado,Montrose County,14,2819,1376,1443
Colorado,Montrose County,15,2132,1049,1083
Colorado,Montrose County,16,1615,794,821
Colorado,Montrose County,17,1026,463,563
Colorado,Montrose County,18,1102,401,701
Colorado,Morgan County,0,28328,14116,14212
Colorado,Morgan County,1,2140,1062,1078
Colorado,Morgan County,2,2031,1005,1026
Colorado,Morgan County,3,2064,1094,970
Colorado,Morgan County,4,1980,1017,963
Colorado,Morgan County,5,1866,947,919
Colorado,Morgan County,6,1801,875,926
Colorado,Morgan County,7,1774,948,826
Colorado,Morgan County,8,1563,789,774
Colorado,Morgan County,9,1663,812,851
Colorado,Morgan County,10,1709,877,832
Colorado,Morgan County,11,1963,1020,943
Colorado,Morgan County,12,1862,937,925
Colorado,Morgan County,13,1543,760,783
Colorado,Morgan County,14,1247,608,639
Colorado,Morgan County,15,975,458,517
Colorado,Morgan County,16,838,403,435
Colorado,Morgan County,17,602,261,341
Colorado,Morgan County,18,707,243,464
Colorado,Otero County,0,18488,9169,9319
Colorado,Otero County,1,1198,606,592
Colorado,Otero County,2,1250,638,612
Colorado,Otero County,3,1301,700,601
Colorado,Otero County,4,1291,719,572
Colorado,Otero County,5,1170,622,548
Colorado,Otero County,6,975,472,503
Colorado,Otero County,7,1047,500,547
Colorado,Otero County,8,988,482,506
Colorado,Otero County,9,982,475,507
Colorado,Otero County,10,983,477,506
Colorado,Otero County,11,1268,612,656
Colorado,Otero County,12,1272,636,636
Colorado,Otero County,13,1248,620,628
Colorado,Otero County,14,1017,506,511
Colorado,Otero County,15,833,395,438
Colorado,Otero County,16,683,317,366
Colorado,Otero County,17,535,237,298
Colorado,Otero County,18,447,155,292
Colorado,Ouray County,0,4629,2272,2357
Colorado,Ouray County,1,156,58,98
Colorado,Ouray County,2,213,103,110
Colorado,Ouray County,3,243,115,128
Colorado,Ouray County,4,249,127,122
Colorado,Ouray County,5,165,92,73
Colorado,Ouray County,6,129,54,75
Colorado,Ouray County,7,197,96,101
Colorado,Ouray County,8,212,117,95
Colorado,Ouray County,9,250,129,121
Colorado,Ouray County,10,277,137,140
Colorado,Ouray County,11,404,190,214
Colorado,Ouray County,12,495,225,270
Colorado,Ouray County,13,498,242,256
Colorado,Ouray County,14,493,254,239
Colorado,Ouray County,15,326,164,162
Colorado,Ouray County,16,164,94,70
Colorado,Ouray County,17,81,44,37
Colorado,Ouray County,18,77,31,46
Colorado,Park County,0,16345,8609,7736
Colorado,Park County,1,612,320,292
Colorado,Park County,2,750,397,353
Colorado,Park County,3,845,426,419
Colorado,Park County,4,786,446,340
Colorado,Park County,5,634,357,277
Colorado,Park County,6,595,316,279
Colorado,Park County,7,758,403,355
Colorado,Park County,8,827,448,379
Colorado,Park County,9,1030,514,516
Colorado,Park County,10,1225,628,597
Colorado,Park County,11,1751,921,830
Colorado,Park County,12,2035,1038,997
Colorado,Park County,13,1845,962,883
Colorado,Park County,14,1301,712,589
Colorado,Park County,15,738,409,329
Colorado,Park County,16,311,180,131
Colorado,Park County,17,164,76,88
Colorado,Park County,18,138,56,82
Colorado,Phillips County,0,4363,2162,2201
Colorado,Phillips County,1,264,148,116
Colorado,Phillips County,2,307,168,139
Colorado,Phillips County,3,302,147,155
Colorado,Phillips County,4,266,133,133
Colorado,Phillips County,5,267,127,140
Colorado,Phillips County,6,205,98,107
Colorado,Phillips County,7,244,124,120
Colorado,Phillips County,8,212,113,99
Colorado,Phillips County,9,230,110,120
Colorado,Phillips County,10,259,144,115
Colorado,Phillips County,11,299,156,143
Colorado,Phillips County,12,325,165,160
Colorado,Phillips County,13,275,136,139
Colorado,Phillips County,14,219,112,107
Colorado,Phillips County,15,184,87,97
Colorado,Phillips County,16,178,77,101
Colorado,Phillips County,17,144,56,88
Colorado,Phillips County,18,183,61,122
Colorado,Pitkin County,0,17626,9231,8395
Colorado,Pitkin County,1,650,334,316
Colorado,Pitkin County,2,765,407,358
Colorado,Pitkin County,3,893,449,444
Colorado,Pitkin County,4,843,414,429
Colorado,Pitkin County,5,898,490,408
Colorado,Pitkin County,6,1307,716,591
Colorado,Pitkin County,7,1352,734,618
Colorado,Pitkin County,8,1100,543,557
Colorado,Pitkin County,9,1358,760,598
Colorado,Pitkin County,10,1388,748,640
Colorado,Pitkin County,11,1383,665,718
Colorado,Pitkin County,12,1513,786,727
Colorado,Pitkin County,13,1434,726,708
Colorado,Pitkin County,14,1157,603,554
Colorado,Pitkin County,15,787,415,372
Colorado,Pitkin County,16,381,224,157
Colorado,Pitkin County,17,223,124,99
Colorado,Pitkin County,18,194,93,101
Colorado,Prowers County,0,12034,6035,5999
Colorado,Prowers County,1,830,428,402
Colorado,Prowers County,2,873,472,401
Colorado,Prowers County,3,896,468,428
Colorado,Prowers County,4,986,518,468
Colorado,Prowers County,5,752,411,341
Colorado,Prowers County,6,643,323,320
Colorado,Prowers County,7,691,347,344
Colorado,Prowers County,8,685,327,358
Colorado,Prowers County,9,692,362,330
Colorado,Prowers County,10,609,291,318
Colorado,Prowers County,11,817,403,414
Colorado,Prowers County,12,854,430,424
Colorado,Prowers County,13,765,355,410
Colorado,Prowers County,14,633,335,298
Colorado,Prowers County,15,433,211,222
Colorado,Prowers County,16,335,151,184
Colorado,Prowers County,17,240,89,151
Colorado,Prowers County,18,300,114,186
Colorado,Pueblo County,0,161875,79798,82077
Colorado,Pueblo County,1,9662,5005,4657
Colorado,Pueblo County,2,10549,5476,5073
Colorado,Pueblo County,3,10882,5540,5342
Colorado,Pueblo County,4,11052,5819,5233
Colorado,Pueblo County,5,11006,5713,5293
Colorado,Pueblo County,6,10058,5024,5034
Colorado,Pueblo County,7,9894,4934,4960
Colorado,Pueblo County,8,9269,4608,4661
Colorado,Pueblo County,9,9574,4761,4813
Colorado,Pueblo County,10,9522,4720,4802
Colorado,Pueblo County,11,10972,5330,5642
Colorado,Pueblo County,12,11270,5387,5883
Colorado,Pueblo County,13,10554,5025,5529
Colorado,Pueblo County,14,9002,4393,4609
Colorado,Pueblo County,15,6334,2906,3428
Colorado,Pueblo County,16,4790,2216,2574
Colorado,Pueblo County,17,3681,1596,2085
Colorado,Pueblo County,18,3804,1345,2459
Colorado,Rio Blanco County,0,6707,3481,3226
Colorado,Rio Blanco County,1,455,243,212
Colorado,Rio Blanco County,2,509,260,249
Colorado,Rio Blanco County,3,433,232,201
Colorado,Rio Blanco County,4,516,259,257
Colorado,Rio Blanco County,5,449,254,195
Colorado,Rio Blanco County,6,450,232,218
Colorado,Rio Blanco County,7,445,238,207
Colorado,Rio Blanco County,8,377,208,169
Colorado,Rio Blanco County,9,380,189,191
Colorado,Rio Blanco County,10,366,195,171
Colorado,Rio Blanco County,11,488,241,247
Colorado,Rio Blanco County,12,526,267,259
Colorado,Rio Blanco County,13,397,222,175
Colorado,Rio Blanco County,14,308,154,154
Colorado,Rio Blanco County,15,233,118,115
Colorado,Rio Blanco County,16,161,75,86
Colorado,Rio Blanco County,17,102,50,52
Colorado,Rio Blanco County,18,112,44,68
Colorado,Rio Grande County,0,11607,5792,5815
Colorado,Rio Grande County,1,737,379,358
Colorado,Rio Grande County,2,762,384,378
Colorado,Rio Grande County,3,794,415,379
Colorado,Rio Grande County,4,734,380,354
Colorado,Rio Grande County,5,696,344,352
Colorado,Rio Grande County,6,691,354,337
Colorado,Rio Grande County,7,635,315,320
Colorado,Rio Grande County,8,608,300,308
Colorado,Rio Grande County,9,627,296,331
Colorado,Rio Grande County,10,652,311,341
Colorado,Rio Grande County,11,774,376,398
Colorado,Rio Grande County,12,899,459,440
Colorado,Rio Grande County,13,835,430,405
Colorado,Rio Grande County,14,705,350,355
Colorado,Rio Grande County,15,571,283,288
Colorado,Rio Grande County,16,330,163,167
Colorado,Rio Grande County,17,261,120,141
Colorado,Rio Grande County,18,296,133,163
Colorado,Routt County,0,23865,12499,11366
Colorado,Routt County,1,1040,533,507
Colorado,Routt County,2,1292,665,627
Colorado,Routt County,3,1404,717,687
Colorado,Routt County,4,1375,712,663
Colorado,Routt County,5,1437,792,645
Colorado,Routt County,6,1742,975,767
Colorado,Routt County,7,1749,917,832
Colorado,Routt County,8,1634,912,722
Colorado,Routt County,9,1857,985,872
Colorado,Routt County,10,1641,841,800
Colorado,Routt County,11,1847,920,927
Colorado,Routt County,12,2042,1014,1028
Colorado,Routt County,13,1872,1017,855
Colorado,Routt County,14,1364,707,657
Colorado,Routt County,15,720,396,324
Colorado,Routt County,16,401,219,182
Colorado,Routt County,17,215,106,109
Colorado,Routt County,18,233,71,162
Colorado,Saguache County,0,6196,3128,3068
Colorado,Saguache County,1,395,213,182
Colorado,Saguache County,2,391,186,205
Colorado,Saguache County,3,390,168,222
Colorado,Saguache County,4,324,173,151
Colorado,Saguache County,5,286,145,141
Colorado,Saguache County,6,271,133,138
Colorado,Saguache County,7,291,143,148
Colorado,Saguache County,8,327,164,163
Colorado,Saguache County,9,289,154,135
Colorado,Saguache County,10,369,192,177
Colorado,Saguache County,11,495,220,275
Colorado,Saguache County,12,543,275,268
Colorado,Saguache County,13,654,357,297
Colorado,Saguache County,14,505,271,234
Colorado,Saguache County,15,304,154,150
Colorado,Saguache County,16,173,95,78
Colorado,Saguache County,17,110,57,53
Colorado,Saguache County,18,79,28,51
Colorado,San Juan County,0,720,410,310
Colorado,San Juan County,1,15,11,4
Colorado,San Juan County,2,31,16,15
Colorado,San Juan County,3,33,21,12
Colorado,San Juan County,4,33,24,9
Colorado,San Juan County,5,22,14,8
Colorado,San Juan County,6,46,17,29
Colorado,San Juan County,7,53,30,23
Colorado,San Juan County,8,49,22,27
Colorado,San Juan County,9,55,35,20
Colorado,San Juan County,10,43,27,16
Colorado,San Juan County,11,56,32,24
Colorado,San Juan County,12,75,45,30
Colorado,San Juan County,13,62,29,33
Colorado,San Juan County,14,71,40,31
Colorado,San Juan County,15,46,30,16
Colorado,San Juan County,16,17,11,6
Colorado,San Juan County,17,8,4,4
Colorado,San Juan County,18,5,2,3
Colorado,San Miguel County,0,7840,4165,3675
Colorado,San Miguel County,1,365,197,168
Colorado,San Miguel County,2,481,256,225
Colorado,San Miguel County,3,415,201,214
Colorado,San Miguel County,4,352,173,179
Colorado,San Miguel County,5,344,166,178
Colorado,San Miguel County,6,675,348,327
Colorado,San Miguel County,7,622,334,288
Colorado,San Miguel County,8,578,294,284
Colorado,San Miguel County,9,637,336,301
Colorado,San Miguel County,10,650,362,288
Colorado,San Miguel County,11,616,343,273
Colorado,San Miguel County,12,633,331,302
Colorado,San Miguel County,13,654,360,294
Colorado,San Miguel County,14,413,236,177
Colorado,San Miguel County,15,212,128,84
Colorado,San Miguel County,16,86,42,44
Colorado,San Miguel County,17,58,27,31
Colorado,San Miguel County,18,49,31,18
Colorado,Sedgwick County,0,2348,1174,1174
Colorado,Sedgwick County,1,123,63,60
Colorado,Sedgwick County,2,137,62,75
Colorado,Sedgwick County,3,120,60,60
Colorado,Sedgwick County,4,138,74,64
Colorado,Sedgwick County,5,111,55,56
Colorado,Sedgwick County,6,129,70,59
Colorado,Sedgwick County,7,118,54,64
Colorado,Sedgwick County,8,124,64,60
Colorado,Sedgwick County,9,107,58,49
Colorado,Sedgwick County,10,118,62,56
Colorado,Sedgwick County,11,155,73,82
Colorado,Sedgwick County,12,214,122,92
Colorado,Sedgwick County,13,180,81,99
Colorado,Sedgwick County,14,165,99,66
Colorado,Sedgwick County,15,112,51,61
Colorado,Sedgwick County,16,94,46,48
Colorado,Sedgwick County,17,94,39,55
Colorado,Sedgwick County,18,109,41,68
Colorado,Summit County,0,29404,15900,13504
Colorado,Summit County,1,1363,645,718
Colorado,Summit County,2,1465,761,704
Colorado,Summit County,3,1290,651,639
Colorado,Summit County,4,1094,571,523
Colorado,Summit County,5,2085,1182,903
Colorado,Summit County,6,3198,1760,1438
Colorado,Summit County,7,2639,1490,1149
Colorado,Summit County,8,2333,1317,1016
Colorado,Summit County,9,2391,1373,1018
Colorado,Summit County,10,2093,1140,953
Colorado,Summit County,11,2053,1078,975
Colorado,Summit County,12,2207,1177,1030
Colorado,Summit County,13,2008,1033,975
Colorado,Summit County,14,1508,799,709
Colorado,Summit County,15,949,512,437
Colorado,Summit County,16,413,237,176
Colorado,Summit County,17,198,117,81
Colorado,Summit County,18,117,57,60
Colorado,Teller County,0,23389,11902,11487
Colorado,Teller County,1,894,445,449
Colorado,Teller County,2,1159,614,545
Colorado,Teller County,3,1365,757,608
Colorado,Teller County,4,1395,735,660
Colorado,Teller County,5,1078,566,512
Colorado,Teller County,6,886,492,394
Colorado,Teller County,7,1064,528,536
Colorado,Teller County,8,1034,511,523
Colorado,Teller County,9,1396,685,711
Colorado,Teller County,10,1659,811,848
Colorado,Teller County,11,2339,1147,1192
Colorado,Teller County,12,2493,1226,1267
Colorado,Teller County,13,2422,1208,1214
Colorado,Teller County,14,1983,1045,938
Colorado,Teller County,15,1150,608,542
Colorado,Teller County,16,569,303,266
Colorado,Teller County,17,303,134,169
Colorado,Teller County,18,200,87,113
Colorado,Washington County,0,4780,2460,2320
Colorado,Washington County,1,244,133,111
Colorado,Washington County,2,300,161,139
Colorado,Washington County,3,327,159,168
Colorado,Washington County,4,277,148,129
Colorado,Washington County,5,285,157,128
Colorado,Washington County,6,239,130,109
Colorado,Washington County,7,290,157,133
Colorado,Washington County,8,228,123,105
Colorado,Washington County,9,232,128,104
Colorado,Washington County,10,290,156,134
Colorado,Washington County,11,349,193,156
Colorado,Washington County,12,384,173,211
Colorado,Washington County,13,339,179,160
Colorado,Washington County,14,260,137,123
Colorado,Washington County,15,257,123,134
Colorado,Washington County,16,169,89,80
Colorado,Washington County,17,129,55,74
Colorado,Washington County,18,181,59,122
Colorado,Weld County,0,277670,139984,137686
Colorado,Weld County,1,20183,10547,9636
Colorado,Weld County,2,21803,11162,10641
Colorado,Weld County,3,21048,10666,10382
Colorado,Weld County,4,19939,10043,9896
Colorado,Weld County,5,19528,9878,9650
Colorado,Weld County,6,19938,10284,9654
Colorado,Weld County,7,19808,10216,9592
Colorado,Weld County,8,18694,9626,9068
Colorado,Weld County,9,18540,9461,9079
Colorado,Weld County,10,17326,8814,8512
Colorado,Weld County,11,18094,9146,8948
Colorado,Weld County,12,17161,8547,8614
Colorado,Weld County,13,14717,7171,7546
Colorado,Weld County,14,11280,5622,5658
Colorado,Weld County,15,7612,3641,3971
Colorado,Weld County,16,5179,2454,2725
Colorado,Weld County,17,3345,1454,1891
Colorado,Weld County,18,3475,1252,2223
Colorado,Yuma County,0,10202,5098,5104
Colorado,Yuma County,1,768,403,365
Colorado,Yuma County,2,787,353,434
Colorado,Yuma County,3,715,378,337
Colorado,Yuma County,4,672,354,318
Colorado,Yuma County,5,568,296,272
Colorado,Yuma County,6,581,294,287
Colorado,Yuma County,7,628,331,297
Colorado,Yuma County,8,527,285,242
Colorado,Yuma County,9,604,317,287
Colorado,Yuma County,10,617,327,290
Colorado,Yuma County,11,684,335,349
Colorado,Yuma County,12,670,355,315
Colorado,Yuma County,13,601,284,317
Colorado,Yuma County,14,516,234,282
Colorado,Yuma County,15,409,187,222
Colorado,Yuma County,16,319,150,169
Colorado,Yuma County,17,263,126,137
Colorado,Yuma County,18,273,89,184
Connecticut,Fairfield County,0,945438,460960,484478
Connecticut,Fairfield County,1,53666,27447,26219
Connecticut,Fairfield County,2,61698,31472,30226
Connecticut,Fairfield County,3,66428,34173,32255
Connecticut,Fairfield County,4,67461,34534,32927
Connecticut,Fairfield County,5,57247,29470,27777
Connecticut,Fairfield County,6,53418,27157,26261
Connecticut,Fairfield County,7,56772,28032,28740
Connecticut,Fairfield County,8,57910,28389,29521
Connecticut,Fairfield County,9,64759,31513,33246
Connecticut,Fairfield County,10,72781,35096,37685
Connecticut,Fairfield County,11,75954,36595,39359
Connecticut,Fairfield County,12,68308,33335,34973
Connecticut,Fairfield County,13,53244,25649,27595
Connecticut,Fairfield County,14,42283,19668,22615
Connecticut,Fairfield County,15,30868,14056,16812
Connecticut,Fairfield County,16,22252,9556,12696
Connecticut,Fairfield County,17,17939,7270,10669
Connecticut,Fairfield County,18,22450,7548,14902
Connecticut,Hartford County,0,897985,435638,462347
Connecticut,Hartford County,1,48889,24747,24142
Connecticut,Hartford County,2,52785,26781,26004
Connecticut,Hartford County,3,57067,29328,27739
Connecticut,Hartford County,4,60132,30719,29413
Connecticut,Hartford County,5,58654,30542,28112
Connecticut,Hartford County,6,58393,29731,28662
Connecticut,Hartford County,7,58322,28944,29378
Connecticut,Hartford County,8,53448,26283,27165
Connecticut,Hartford County,9,56982,27760,29222
Connecticut,Hartford County,10,63482,30968,32514
Connecticut,Hartford County,11,69359,33448,35911
Connecticut,Hartford County,12,66007,31836,34171
Connecticut,Hartford County,13,54174,25637,28537
Connecticut,Hartford County,14,43916,20197,23719
Connecticut,Hartford County,15,31158,14021,17137
Connecticut,Hartford County,16,22760,9661,13099
Connecticut,Hartford County,17,18688,7308,11380
Connecticut,Hartford County,18,23769,7727,16042
Connecticut,Litchfield County,0,184993,91138,93855
Connecticut,Litchfield County,1,7844,4081,3763
Connecticut,Litchfield County,2,9411,4868,4543
Connecticut,Litchfield County,3,11290,5843,5447
Connecticut,Litchfield County,4,11550,5987,5563
Connecticut,Litchfield County,5,9837,5096,4741
Connecticut,Litchfield County,6,8981,4626,4355
Connecticut,Litchfield County,7,9175,4674,4501
Connecticut,Litchfield County,8,9182,4432,4750
Connecticut,Litchfield County,9,11542,5644,5898
Connecticut,Litchfield County,10,14533,7137,7396
Connecticut,Litchfield County,11,16691,8098,8593
Connecticut,Litchfield County,12,16773,8254,8519
Connecticut,Litchfield County,13,14054,7006,7048
Connecticut,Litchfield County,14,11440,5635,5805
Connecticut,Litchfield County,15,8202,3875,4327
Connecticut,Litchfield County,16,5427,2477,2950
Connecticut,Litchfield County,17,4117,1712,2405
Connecticut,Litchfield County,18,4944,1693,3251
Connecticut,Middlesex County,0,164943,80476,84467
Connecticut,Middlesex County,1,7450,3764,3686
Connecticut,Middlesex County,2,8258,4186,4072
Connecticut,Middlesex County,3,9809,4997,4812
Connecticut,Middlesex County,4,10888,5603,5285
Connecticut,Middlesex County,5,9771,5108,4663
Connecticut,Middlesex County,6,9020,4596,4424
Connecticut,Middlesex County,7,9145,4494,4651
Connecticut,Middlesex County,8,8562,4209,4353
Connecticut,Middlesex County,9,10485,5057,5428
Connecticut,Middlesex County,10,12775,6231,6544
Connecticut,Middlesex County,11,14263,6961,7302
Connecticut,Middlesex County,12,13736,6814,6922
Connecticut,Middlesex County,13,11590,5582,6008
Connecticut,Middlesex County,14,9520,4624,4896
Connecticut,Middlesex County,15,6912,3173,3739
Connecticut,Middlesex County,16,4583,2047,2536
Connecticut,Middlesex County,17,3603,1505,2098
Connecticut,Middlesex County,18,4573,1525,3048
Connecticut,New Haven County,0,861277,415273,446004
Connecticut,New Haven County,1,45523,23192,22331
Connecticut,New Haven County,2,49166,25207,23959
Connecticut,New Haven County,3,52961,26835,26126
Connecticut,New Haven County,4,60893,30793,30100
Connecticut,New Haven County,5,60723,30603,30120
Connecticut,New Haven County,6,58131,28761,29370
Connecticut,New Haven County,7,54850,26856,27994
Connecticut,New Haven County,8,50047,24315,25732
Connecticut,New Haven County,9,54142,26050,28092
Connecticut,New Haven County,10,60603,29326,31277
Connecticut,New Haven County,11,65666,31890,33776
Connecticut,New Haven County,12,62600,30210,32390
Connecticut,New Haven County,13,51791,24528,27263
Connecticut,New Haven County,14,42625,19752,22873
Connecticut,New Haven County,15,30574,13705,16869
Connecticut,New Haven County,16,21187,9139,12048
Connecticut,New Haven County,17,17393,6907,10486
Connecticut,New Haven County,18,22402,7204,15198
Connecticut,New London County,0,273676,137081,136595
Connecticut,New London County,1,13952,7032,6920
Connecticut,New London County,2,14945,7545,7400
Connecticut,New London County,3,16329,8313,8016
Connecticut,New London County,4,18005,9432,8573
Connecticut,New London County,5,21033,12271,8762
Connecticut,New London County,6,18342,10005,8337
Connecticut,New London County,7,16494,8395,8099
Connecticut,New London County,8,15136,7568,7568
Connecticut,New London County,9,16562,8177,8385
Connecticut,New London County,10,19190,9259,9931
Connecticut,New London County,11,21588,10646,10942
Connecticut,New London County,12,20747,10264,10483
Connecticut,New London County,13,17430,8483,8947
Connecticut,New London County,14,14285,6940,7345
Connecticut,New London County,15,10639,5137,5502
Connecticut,New London County,16,7118,3143,3975
Connecticut,New London County,17,5455,2263,3192
Connecticut,New London County,18,6426,2208,4218
Connecticut,Tolland County,0,151367,75948,75419
Connecticut,Tolland County,1,6063,3132,2931
Connecticut,Tolland County,2,7412,3768,3644
Connecticut,Tolland County,3,8777,4530,4247
Connecticut,Tolland County,4,14998,7497,7501
Connecticut,Tolland County,5,18417,9455,8962
Connecticut,Tolland County,6,8024,4476,3548
Connecticut,Tolland County,7,7740,4026,3714
Connecticut,Tolland County,8,7311,3700,3611
Connecticut,Tolland County,9,8853,4497,4356
Connecticut,Tolland County,10,10381,5100,5281
Connecticut,Tolland County,11,11854,5979,5875
Connecticut,Tolland County,12,11404,5633,5771
Connecticut,Tolland County,13,8899,4416,4483
Connecticut,Tolland County,14,7230,3507,3723
Connecticut,Tolland County,15,5347,2627,2720
Connecticut,Tolland County,16,3431,1559,1872
Connecticut,Tolland County,17,2442,1068,1374
Connecticut,Tolland County,18,2784,978,1806
Connecticut,Windham County,0,116998,58035,58963
Connecticut,Windham County,1,6050,3135,2915
Connecticut,Windham County,2,6491,3338,3153
Connecticut,Windham County,3,7161,3701,3460
Connecticut,Windham County,4,8344,4349,3995
Connecticut,Windham County,5,8104,4133,3971
Connecticut,Windham County,6,7571,3967,3604
Connecticut,Windham County,7,6934,3469,3465
Connecticut,Windham County,8,6838,3381,3457
Connecticut,Windham County,9,7687,3881,3806
Connecticut,Windham County,10,8417,4174,4243
Connecticut,Windham County,11,9716,4790,4926
Connecticut,Windham County,12,9032,4422,4610
Connecticut,Windham County,13,7472,3649,3823
Connecticut,Windham County,14,5804,2790,3014
Connecticut,Windham County,15,4114,1960,2154
Connecticut,Windham County,16,2791,1231,1560
Connecticut,Windham County,17,2035,855,1180
Connecticut,Windham County,18,2437,810,1627
Delaware,Kent County,0,171987,82945,89042
Delaware,Kent County,1,11168,5788,5380
Delaware,Kent County,2,11210,5713,5497
Delaware,Kent County,3,11453,5840,5613
Delaware,Kent County,4,11808,5858,5950
Delaware,Kent County,5,13393,6853,6540
Delaware,Kent County,6,12164,6067,6097
Delaware,Kent County,7,10827,5194,5633
Delaware,Kent County,8,9720,4549,5171
Delaware,Kent County,9,10140,4768,5372
Delaware,Kent County,10,10985,5254,5731
Delaware,Kent County,11,11942,5716,6226
Delaware,Kent County,12,11060,5180,5880
Delaware,Kent County,13,9352,4318,5034
Delaware,Kent County,14,9103,4185,4918
Delaware,Kent County,15,6877,3128,3749
Delaware,Kent County,16,4838,2128,2710
Delaware,Kent County,17,3231,1433,1798
Delaware,Kent County,18,2716,973,1743
Delaware,New Castle County,0,552778,267542,285236
Delaware,New Castle County,1,33480,16883,16597
Delaware,New Castle County,2,33445,16820,16625
Delaware,New Castle County,3,34579,17643,16936
Delaware,New Castle County,4,37926,19063,18863
Delaware,New Castle County,5,39623,20023,19600
Delaware,New Castle County,6,41267,20379,20888
Delaware,New Castle County,7,37371,18505,18866
Delaware,New Castle County,8,33691,16545,17146
Delaware,New Castle County,9,35598,17475,18123
Delaware,New Castle County,10,38151,18223,19928
Delaware,New Castle County,11,41079,19702,21377
Delaware,New Castle County,12,38827,18648,20179
Delaware,New Castle County,13,31698,14794,16904
Delaware,New Castle County,14,25350,11771,13579
Delaware,New Castle County,15,18015,8020,9995
Delaware,New Castle County,16,12724,5539,7185
Delaware,New Castle County,17,9643,3942,5701
Delaware,New Castle County,18,10311,3567,6744
Delaware,Sussex County,0,210849,102202,108647
Delaware,Sussex County,1,11703,5995,5708
Delaware,Sussex County,2,11854,5947,5907
Delaware,Sussex County,3,11140,5715,5425
Delaware,Sussex County,4,10216,5246,4970
Delaware,Sussex County,5,10963,5651,5312
Delaware,Sussex County,6,11087,5513,5574
Delaware,Sussex County,7,10965,5495,5470
Delaware,Sussex County,8,10111,5010,5101
Delaware,Sussex County,9,11181,5457,5724
Delaware,Sussex County,10,12557,6051,6506
Delaware,Sussex County,11,14878,7161,7717
Delaware,Sussex County,12,15868,7364,8504
Delaware,Sussex County,13,17227,7879,9348
Delaware,Sussex County,14,17897,8481,9416
Delaware,Sussex County,15,13613,6568,7045
Delaware,Sussex County,16,8884,4281,4603
Delaware,Sussex County,17,5781,2654,3127
Delaware,Sussex County,18,4924,1734,3190
District of Columbia,District of Columbia,0,658893,312600,346293
District of Columbia,District of Columbia,1,42894,21872,21022
District of Columbia,District of Columbia,2,31088,15640,15448
District of Columbia,District of Columbia,3,25766,12888,12878
District of Columbia,District of Columbia,4,37589,17719,19870
District of Columbia,District of Columbia,5,58531,27233,31298
District of Columbia,District of Columbia,6,77886,35628,42258
District of Columbia,District of Columbia,7,72035,34541,37494
District of Columbia,District of Columbia,8,50796,25046,25750
District of Columbia,District of Columbia,9,41930,21032,20898
District of Columbia,District of Columbia,10,37647,18974,18673
District of Columbia,District of Columbia,11,38977,19524,19453
District of Columbia,District of Columbia,12,36637,17495,19142
District of Columbia,District of Columbia,13,32363,14730,17633
District of Columbia,District of Columbia,14,25232,11086,14146
District of Columbia,District of Columbia,15,17206,7362,9844
District of Columbia,District of Columbia,16,12126,5008,7118
District of Columbia,District of Columbia,17,8987,3334,5653
District of Columbia,District of Columbia,18,11203,3488,7715
Florida,Alachua County,0,256380,123809,132571
Florida,Alachua County,1,14297,7334,6963
Florida,Alachua County,2,12755,6557,6198
Florida,Alachua County,3,11799,5936,5863
Florida,Alachua County,4,20464,9763,10701
Florida,Alachua County,5,44153,21476,22677
Florida,Alachua County,6,21362,10689,10673
Florida,Alachua County,7,17226,8759,8467
Florida,Alachua County,8,13632,6793,6839
Florida,Alachua County,9,12831,6339,6492
Florida,Alachua County,10,12535,6056,6479
Florida,Alachua County,11,14385,6724,7661
Florida,Alachua County,12,14942,6948,7994
Florida,Alachua County,13,14041,6464,7577
Florida,Alachua County,14,11180,5282,5898
Florida,Alachua County,15,7513,3491,4022
Florida,Alachua County,16,5103,2132,2971
Florida,Alachua County,17,3793,1575,2218
Florida,Alachua County,18,4369,1491,2878
Florida,Baker County,0,27093,14106,12987
Florida,Baker County,1,1712,872,840
Florida,Baker County,2,1872,984,888
Florida,Baker County,3,1973,981,992
Florida,Baker County,4,1712,897,815
Florida,Baker County,5,1768,1002,766
Florida,Baker County,6,1928,1084,844
Florida,Baker County,7,1838,998,840
Florida,Baker County,8,1744,954,790
Florida,Baker County,9,1846,1017,829
Florida,Baker County,10,1897,1049,848
Florida,Baker County,11,1977,1034,943
Florida,Baker County,12,1779,879,900
Florida,Baker County,13,1550,764,786
Florida,Baker County,14,1215,572,643
Florida,Baker County,15,923,447,476
Florida,Baker County,16,617,284,333
Florida,Baker County,17,415,167,248
Florida,Baker County,18,327,121,206
Florida,Bay County,0,178985,89068,89917
Florida,Bay County,1,10977,5657,5320
Florida,Bay County,2,11013,5684,5329
Florida,Bay County,3,10289,5138,5151
Florida,Bay County,4,9922,5236,4686
Florida,Bay County,5,12473,6606,5867
Florida,Bay County,6,13050,6710,6340
Florida,Bay County,7,12003,6249,5754
Florida,Bay County,8,10416,5292,5124
Florida,Bay County,9,11089,5450,5639
Florida,Bay County,10,11661,5840,5821
Florida,Bay County,11,13692,6801,6891
Florida,Bay County,12,12746,6012,6734
Florida,Bay County,13,10766,5148,5618
Florida,Bay County,14,9586,4691,4895
Florida,Bay County,15,7045,3301,3744
Florida,Bay County,16,5105,2298,2807
Florida,Bay County,17,3548,1501,2047
Florida,Bay County,18,3604,1454,2150
Florida,Bradford County,0,26702,14536,12166
Florida,Bradford County,1,1552,800,752
Florida,Bradford County,2,1505,766,739
Florida,Bradford County,3,1441,753,688
Florida,Bradford County,4,1330,707,623
Florida,Bradford County,5,1773,1082,691
Florida,Bradford County,6,1910,1214,696
Florida,Bradford County,7,1884,1177,707
Florida,Bradford County,8,1621,1000,621
Florida,Bradford County,9,1676,1014,662
Florida,Bradford County,10,1730,1048,682
Florida,Bradford County,11,1979,1085,894
Florida,Bradford County,12,1933,987,946
Florida,Bradford County,13,1662,840,822
Florida,Bradford County,14,1491,706,785
Florida,Bradford County,15,1179,557,622
Florida,Bradford County,16,847,385,462
Florida,Bradford County,17,573,209,364
Florida,Bradford County,18,616,206,410
Florida,Brevard County,0,556885,271697,285188
Florida,Brevard County,1,25831,13322,12509
Florida,Brevard County,2,28497,14720,13777
Florida,Brevard County,3,30243,15457,14786
Florida,Brevard County,4,31174,16397,14777
Florida,Brevard County,5,31807,16833,14974
Florida,Brevard County,6,30340,15553,14787
Florida,Brevard County,7,29155,14298,14857
Florida,Brevard County,8,26769,13041,13728
Florida,Brevard County,9,30509,14615,15894
Florida,Brevard County,10,35603,17145,18458
Florida,Brevard County,11,46207,22285,23922
Florida,Brevard County,12,45453,21830,23623
Florida,Brevard County,13,39306,18965,20341
Florida,Brevard County,14,36905,17490,19415
Florida,Brevard County,15,30662,14298,16364
Florida,Brevard County,16,23954,11012,12942
Florida,Brevard County,17,17641,8035,9606
Florida,Brevard County,18,16829,6401,10428
Florida,Broward County,0,1869235,907924,961311
Florida,Broward County,1,109292,55634,53658
Florida,Broward County,2,110931,56420,54511
Florida,Broward County,3,112905,57355,55550
Florida,Broward County,4,111599,57542,54057
Florida,Broward County,5,116894,59154,57740
Florida,Broward County,6,124520,61800,62720
Florida,Broward County,7,126928,61761,65167
Florida,Broward County,8,120823,58609,62214
Florida,Broward County,9,130383,63285,67098
Florida,Broward County,10,136031,66200,69831
Florida,Broward County,11,144310,71208,73102
Florida,Broward County,12,130169,63452,66717
Florida,Broward County,13,107698,51084,56614
Florida,Broward County,14,89743,42346,47397
Florida,Broward County,15,66316,30273,36043
Florida,Broward County,16,47826,20821,27005
Florida,Broward County,17,36948,14962,21986
Florida,Broward County,18,45919,16018,29901
Florida,Calhoun County,0,14532,7914,6618
Florida,Calhoun County,1,796,390,406
Florida,Calhoun County,2,894,450,444
Florida,Calhoun County,3,789,407,382
Florida,Calhoun County,4,805,417,388
Florida,Calhoun County,5,845,497,348
Florida,Calhoun County,6,1041,648,393
Florida,Calhoun County,7,1000,603,397
Florida,Calhoun County,8,965,609,356
Florida,Calhoun County,9,979,606,373
Florida,Calhoun County,10,1032,623,409
Florida,Calhoun County,11,1025,566,459
Florida,Calhoun County,12,987,517,470
Florida,Calhoun County,13,865,428,437
Florida,Calhoun County,14,763,373,390
Florida,Calhoun County,15,659,308,351
Florida,Calhoun County,16,485,242,243
Florida,Calhoun County,17,318,130,188
Florida,Calhoun County,18,284,100,184
Florida,Charlotte County,0,168474,82091,86383
Florida,Charlotte County,1,5182,2648,2534
Florida,Charlotte County,2,6002,3112,2890
Florida,Charlotte County,3,6503,3287,3216
Florida,Charlotte County,4,6758,3610,3148
Florida,Charlotte County,5,6802,3651,3151
Florida,Charlotte County,6,6309,3352,2957
Florida,Charlotte County,7,6009,3051,2958
Florida,Charlotte County,8,5918,3036,2882
Florida,Charlotte County,9,7340,3654,3686
Florida,Charlotte County,10,8643,4177,4466
Florida,Charlotte County,11,11292,5270,6022
Florida,Charlotte County,12,13063,5918,7145
Florida,Charlotte County,13,15121,6871,8250
Florida,Charlotte County,14,17953,8496,9457
Florida,Charlotte County,15,16349,8032,8317
Florida,Charlotte County,16,12240,6082,6158
Florida,Charlotte County,17,8612,4312,4300
Florida,Charlotte County,18,8378,3532,4846
Florida,Citrus County,0,139377,67440,71937
Florida,Citrus County,1,5302,2688,2614
Florida,Citrus County,2,5678,2859,2819
Florida,Citrus County,3,5985,3028,2957
Florida,Citrus County,4,6270,3281,2989
Florida,Citrus County,5,5706,3020,2686
Florida,Citrus County,6,5461,2792,2669
Florida,Citrus County,7,5096,2554,2542
Florida,Citrus County,8,5029,2491,2538
Florida,Citrus County,9,6323,2976,3347
Florida,Citrus County,10,7479,3574,3905
Florida,Citrus County,11,9523,4530,4993
Florida,Citrus County,12,10598,4853,5745
Florida,Citrus County,13,11862,5360,6502
Florida,Citrus County,14,13939,6441,7498
Florida,Citrus County,15,12827,6242,6585
Florida,Citrus County,16,9868,5001,4867
Florida,Citrus County,17,6603,3261,3342
Florida,Citrus County,18,5828,2489,3339
Florida,Clay County,0,199798,98229,101569
Florida,Clay County,1,10923,5508,5415
Florida,Clay County,2,13173,6745,6428
Florida,Clay County,3,14772,7598,7174
Florida,Clay County,4,14390,7426,6964
Florida,Clay County,5,12501,6498,6003
Florida,Clay County,6,11783,6001,5782
Florida,Clay County,7,12130,5994,6136
Florida,Clay County,8,12190,5768,6422
Florida,Clay County,9,13915,6666,7249
Florida,Clay County,10,14336,7037,7299
Florida,Clay County,11,15627,7729,7898
Florida,Clay County,12,13724,6595,7129
Florida,Clay County,13,11940,5662,6278
Florida,Clay County,14,10548,5114,5434
Florida,Clay County,15,7150,3360,3790
Florida,Clay County,16,4725,2168,2557
Florida,Clay County,17,3102,1368,1734
Florida,Clay County,18,2869,992,1877
Florida,Collier County,0,348777,171721,177056
Florida,Collier County,1,16620,8527,8093
Florida,Collier County,2,17953,9235,8718
Florida,Collier County,3,18064,9234,8830
Florida,Collier County,4,17633,9264,8369
Florida,Collier County,5,17742,9408,8334
Florida,Collier County,6,17579,9359,8220
Florida,Collier County,7,17093,8708,8385
Florida,Collier County,8,16864,8448,8416
Florida,Collier County,9,18619,9150,9469
Florida,Collier County,10,20430,10177,10253
Florida,Collier County,11,22088,10666,11422
Florida,Collier County,12,22273,10325,11948
Florida,Collier County,13,23416,10671,12745
Florida,Collier County,14,27204,12476,14728
Florida,Collier County,15,26440,12540,13900
Florida,Collier County,16,20673,10140,10533
Florida,Collier County,17,14501,7184,7317
Florida,Collier County,18,13585,6209,7376
Florida,Columbia County,0,67857,35156,32701
Florida,Columbia County,1,3985,2021,1964
Florida,Columbia County,2,4238,2164,2074
Florida,Columbia County,3,4094,2147,1947
Florida,Columbia County,4,3974,2171,1803
Florida,Columbia County,5,4806,2930,1876
Florida,Columbia County,6,4407,2398,2009
Florida,Columbia County,7,4229,2273,1956
Florida,Columbia County,8,3867,2091,1776
Florida,Columbia County,9,4116,2242,1874
Florida,Columbia County,10,4201,2216,1985
Florida,Columbia County,11,4820,2516,2304
Florida,Columbia County,12,5066,2435,2631
Florida,Columbia County,13,4345,2135,2210
Florida,Columbia County,14,3992,1921,2071
Florida,Columbia County,15,2965,1407,1558
Florida,Columbia County,16,2070,963,1107
Florida,Columbia County,17,1386,624,762
Florida,Columbia County,18,1296,502,794
Florida,DeSoto County,0,35012,19705,15307
Florida,DeSoto County,1,1914,958,956
Florida,DeSoto County,2,2048,1076,972
Florida,DeSoto County,3,2020,1096,924
Florida,DeSoto County,4,2190,1294,896
Florida,DeSoto County,5,2584,1723,861
Florida,DeSoto County,6,2463,1528,935
Florida,DeSoto County,7,2328,1462,866
Florida,DeSoto County,8,1994,1288,706
Florida,DeSoto County,9,2193,1326,867
Florida,DeSoto County,10,2048,1225,823
Florida,DeSoto County,11,2241,1271,970
Florida,DeSoto County,12,2129,1120,1009
Florida,DeSoto County,13,1951,975,976
Florida,DeSoto County,14,1985,997,988
Florida,DeSoto County,15,1830,876,954
Florida,DeSoto County,16,1410,711,699
Florida,DeSoto County,17,916,431,485
Florida,DeSoto County,18,768,348,420
Florida,Dixie County,0,15907,8588,7319
Florida,Dixie County,1,883,426,457
Florida,Dixie County,2,837,449,388
Florida,Dixie County,3,833,421,412
Florida,Dixie County,4,735,372,363
Florida,Dixie County,5,841,523,318
Florida,Dixie County,6,904,540,364
Florida,Dixie County,7,885,503,382
Florida,Dixie County,8,906,566,340
Florida,Dixie County,9,880,516,364
Florida,Dixie County,10,1035,593,442
Florida,Dixie County,11,1248,680,568
Florida,Dixie County,12,1246,623,623
Florida,Dixie County,13,1174,584,590
Florida,Dixie County,14,1207,616,591
Florida,Dixie County,15,962,501,461
Florida,Dixie County,16,680,340,340
Florida,Dixie County,17,394,230,164
Florida,Dixie County,18,257,105,152
Florida,Duval County,0,897698,434734,462964
Florida,Duval County,1,60690,31179,29511
Florida,Duval County,2,58115,29884,28231
Florida,Duval County,3,54122,27507,26615
Florida,Duval County,4,53614,27017,26597
Florida,Duval County,5,66492,33801,32691
Florida,Duval County,6,75290,37323,37967
Florida,Duval County,7,67306,33094,34212
Florida,Duval County,8,56507,27522,28985
Florida,Duval County,9,57613,27928,29685
Florida,Duval County,10,57938,28014,29924
Florida,Duval County,11,64313,30844,33469
Florida,Duval County,12,60552,28572,31980
Florida,Duval County,13,50485,23543,26942
Florida,Duval County,14,40635,18770,21865
Florida,Duval County,15,27145,11903,15242
Florida,Duval County,16,18789,8022,10767
Florida,Duval County,17,13400,5245,8155
Florida,Duval County,18,14692,4566,10126
Florida,Escambia County,0,310659,155165,155494
Florida,Escambia County,1,18756,9551,9205
Florida,Escambia County,2,18522,9471,9051
Florida,Escambia County,3,17116,8836,8280
Florida,Escambia County,4,22808,12832,9976
Florida,Escambia County,5,28410,15688,12722
Florida,Escambia County,6,23785,12382,11403
Florida,Escambia County,7,19618,10077,9541
Florida,Escambia County,8,16400,8280,8120
Florida,Escambia County,9,16844,8434,8410
Florida,Escambia County,10,18073,8974,9099
Florida,Escambia County,11,21470,10422,11048
Florida,Escambia County,12,21481,10287,11194
Florida,Escambia County,13,18534,8609,9925
Florida,Escambia County,14,16139,7535,8604
Florida,Escambia County,15,11788,5307,6481
Florida,Escambia County,16,8647,3790,4857
Florida,Escambia County,17,6110,2555,3555
Florida,Escambia County,18,6158,2135,4023
Florida,Flagler County,0,102408,49168,53240
Florida,Flagler County,1,4307,2205,2102
Florida,Flagler County,2,5128,2595,2533
Florida,Flagler County,3,5635,2860,2775
Florida,Flagler County,4,5399,2859,2540
Florida,Flagler County,5,4833,2503,2330
Florida,Flagler County,6,4335,2111,2224
Florida,Flagler County,7,4754,2269,2485
Florida,Flagler County,8,4890,2372,2518
Florida,Flagler County,9,5605,2621,2984
Florida,Flagler County,10,5979,2803,3176
Florida,Flagler County,11,6800,3130,3670
Florida,Flagler County,12,7387,3297,4090
Florida,Flagler County,13,8274,3675,4599
Florida,Flagler County,14,9374,4435,4939
Florida,Flagler County,15,7731,3821,3910
Florida,Flagler County,16,5341,2686,2655
Florida,Flagler County,17,3447,1633,1814
Florida,Flagler County,18,3189,1293,1896
Florida,Franklin County,0,11815,6826,4989
Florida,Franklin County,1,509,247,262
Florida,Franklin County,2,596,314,282
Florida,Franklin County,3,525,266,259
Florida,Franklin County,4,491,268,223
Florida,Franklin County,5,711,477,234
Florida,Franklin County,6,1040,754,286
Florida,Franklin County,7,877,589,288
Florida,Franklin County,8,750,516,234
Florida,Franklin County,9,721,457,264
Florida,Franklin County,10,749,466,283
Florida,Franklin County,11,788,424,364
Florida,Franklin County,12,819,424,395
Florida,Franklin County,13,861,429,432
Florida,Franklin County,14,849,402,447
Florida,Franklin County,15,680,379,301
Florida,Franklin County,16,436,228,208
Florida,Franklin County,17,220,102,118
Florida,Franklin County,18,193,84,109
Florida,Gadsden County,0,46281,23354,22927
Florida,Gadsden County,1,2836,1447,1389
Florida,Gadsden County,2,3014,1507,1507
Florida,Gadsden County,3,2848,1417,1431
Florida,Gadsden County,4,2458,1254,1204
Florida,Gadsden County,5,2976,1638,1338
Florida,Gadsden County,6,2717,1515,1202
Florida,Gadsden County,7,2987,1560,1427
Florida,Gadsden County,8,2933,1561,1372
Florida,Gadsden County,9,2998,1566,1432
Florida,Gadsden County,10,2915,1472,1443
Florida,Gadsden County,11,3640,1939,1701
Florida,Gadsden County,12,3583,1856,1727
Florida,Gadsden County,13,3221,1510,1711
Florida,Gadsden County,14,2464,1190,1274
Florida,Gadsden County,15,1763,783,980
Florida,Gadsden County,16,1280,548,732
Florida,Gadsden County,17,860,333,527
Florida,Gadsden County,18,788,258,530
Florida,Gilchrist County,0,16997,8837,8160
Florida,Gilchrist County,1,906,471,435
Florida,Gilchrist County,2,904,448,456
Florida,Gilchrist County,3,973,510,463
Florida,Gilchrist County,4,1290,790,500
Florida,Gilchrist County,5,1445,1018,427
Florida,Gilchrist County,6,848,450,398
Florida,Gilchrist County,7,858,450,408
Florida,Gilchrist County,8,800,387,413
Florida,Gilchrist County,9,1016,468,548
Florida,Gilchrist County,10,1057,539,518
Florida,Gilchrist County,11,1206,625,581
Florida,Gilchrist County,12,1260,612,648
Florida,Gilchrist County,13,1137,560,577
Florida,Gilchrist County,14,1044,500,544
Florida,Gilchrist County,15,878,443,435
Florida,Gilchrist County,16,568,271,297
Florida,Gilchrist County,17,380,159,221
Florida,Gilchrist County,18,427,136,291
Florida,Glades County,0,13635,7683,5952
Florida,Glades County,1,539,256,283
Florida,Glades County,2,717,336,381
Florida,Glades County,3,671,328,343
Florida,Glades County,4,638,349,289
Florida,Glades County,5,691,408,283
Florida,Glades County,6,909,602,307
Florida,Glades County,7,884,512,372
Florida,Glades County,8,768,530,238
Florida,Glades County,9,864,570,294
Florida,Glades County,10,809,480,329
Florida,Glades County,11,843,524,319
Florida,Glades County,12,833,452,381
Florida,Glades County,13,855,421,434
Florida,Glades County,14,976,512,464
Florida,Glades County,15,1023,552,471
Florida,Glades County,16,805,422,383
Florida,Glades County,17,483,270,213
Florida,Glades County,18,327,159,168
Florida,Gulf County,0,15944,9606,6338
Florida,Gulf County,1,686,356,330
Florida,Gulf County,2,680,319,361
Florida,Gulf County,3,644,338,306
Florida,Gulf County,4,676,362,314
Florida,Gulf County,5,985,689,296
Florida,Gulf County,6,1263,981,282
Florida,Gulf County,7,1163,873,290
Florida,Gulf County,8,1115,783,332
Florida,Gulf County,9,1141,794,347
Florida,Gulf County,10,1258,835,423
Florida,Gulf County,11,1249,754,495
Florida,Gulf County,12,1101,593,508
Florida,Gulf County,13,1104,562,542
Florida,Gulf County,14,986,506,480
Florida,Gulf County,15,740,367,373
Florida,Gulf County,16,509,228,281
Florida,Gulf County,17,361,158,203
Florida,Gulf County,18,283,108,175
Florida,Hamilton County,0,14048,8021,6027
Florida,Hamilton County,1,755,381,374
Florida,Hamilton County,2,719,357,362
Florida,Hamilton County,3,779,412,367
Florida,Hamilton County,4,793,478,315
Florida,Hamilton County,5,1365,983,382
Florida,Hamilton County,6,1022,691,331
Florida,Hamilton County,7,827,555,272
Florida,Hamilton County,8,836,512,324
Florida,Hamilton County,9,878,515,363
Florida,Hamilton County,10,891,546,345
Florida,Hamilton County,11,960,541,419
Florida,Hamilton County,12,1065,561,504
Florida,Hamilton County,13,919,472,447
Florida,Hamilton County,14,824,394,430
Florida,Hamilton County,15,569,288,281
Florida,Hamilton County,16,359,152,207
Florida,Hamilton County,17,257,116,141
Florida,Hamilton County,18,230,67,163
Florida,Hardee County,0,27469,14696,12773
Florida,Hardee County,1,1975,1031,944
Florida,Hardee County,2,2109,1103,1006
Florida,Hardee County,3,2013,1006,1007
Florida,Hardee County,4,1997,1110,887
Florida,Hardee County,5,2116,1234,882
Florida,Hardee County,6,2121,1270,851
Florida,Hardee County,7,1631,879,752
Florida,Hardee County,8,1635,914,721
Florida,Hardee County,9,1686,935,751
Florida,Hardee County,10,1623,862,761
Florida,Hardee County,11,1682,926,756
Florida,Hardee County,12,1495,770,725
Florida,Hardee County,13,1321,680,641
Florida,Hardee County,14,1279,633,646
Florida,Hardee County,15,1008,501,507
Florida,Hardee County,16,775,396,379
Florida,Hardee County,17,477,216,261
Florida,Hardee County,18,526,230,296
Florida,Hendry County,0,38505,20017,18488
Florida,Hendry County,1,2954,1551,1403
Florida,Hendry County,2,3154,1621,1533
Florida,Hendry County,3,2963,1524,1439
Florida,Hendry County,4,2731,1470,1261
Florida,Hendry County,5,2694,1425,1269
Florida,Hendry County,6,2887,1600,1287
Florida,Hendry County,7,2633,1427,1206
Florida,Hendry County,8,2320,1240,1080
Florida,Hendry County,9,2451,1272,1179
Florida,Hendry County,10,2426,1213,1213
Florida,Hendry County,11,2402,1254,1148
Florida,Hendry County,12,2247,1134,1113
Florida,Hendry County,13,1740,881,859
Florida,Hendry County,14,1570,789,781
Florida,Hendry County,15,1242,632,610
Florida,Hendry County,16,920,454,466
Florida,Hendry County,17,596,289,307
Florida,Hendry County,18,575,241,334
Florida,Hernando County,0,175855,84301,91554
Florida,Hernando County,1,7767,3938,3829
Florida,Hernando County,2,9004,4518,4486
Florida,Hernando County,3,9700,4833,4867
Florida,Hernando County,4,9814,5120,4694
Florida,Hernando County,5,8881,4379,4502
Florida,Hernando County,6,8291,4148,4143
Florida,Hernando County,7,8151,4017,4134
Florida,Hernando County,8,8315,3959,4356
Florida,Hernando County,9,9670,4541,5129
Florida,Hernando County,10,10612,5010,5602
Florida,Hernando County,11,12181,5894,6287
Florida,Hernando County,12,12608,5866,6742
Florida,Hernando County,13,12464,5636,6828
Florida,Hernando County,14,13814,6450,7364
Florida,Hernando County,15,12456,5891,6565
Florida,Hernando County,16,9343,4494,4849
Florida,Hernando County,17,6566,3075,3491
Florida,Hernando County,18,6218,2532,3686
Florida,Highlands County,0,98236,47638,50598
Florida,Highlands County,1,4593,2269,2324
Florida,Highlands County,2,5100,2635,2465
Florida,Highlands County,3,4856,2430,2426
Florida,Highlands County,4,4662,2431,2231
Florida,Highlands County,5,4629,2412,2217
Florida,Highlands County,6,4498,2271,2227
Florida,Highlands County,7,4496,2257,2239
Florida,Highlands County,8,4096,2028,2068
Florida,Highlands County,9,4413,2156,2257
Florida,Highlands County,10,4808,2457,2351
Florida,Highlands County,11,5746,2728,3018
Florida,Highlands County,12,6367,3042,3325
Florida,Highlands County,13,6753,3022,3731
Florida,Highlands County,14,8094,3706,4388
Florida,Highlands County,15,8513,4011,4502
Florida,Highlands County,16,6998,3417,3581
Florida,Highlands County,17,4920,2324,2596
Florida,Highlands County,18,4694,2042,2652
Florida,Hillsborough County,0,1316298,641483,674815
Florida,Hillsborough County,1,84037,43322,40715
Florida,Hillsborough County,2,85372,43647,41725
Florida,Hillsborough County,3,84635,43179,41456
Florida,Hillsborough County,4,85622,44021,41601
Florida,Hillsborough County,5,92699,45650,47049
Florida,Hillsborough County,6,100614,49485,51129
Florida,Hillsborough County,7,94195,45852,48343
Florida,Hillsborough County,8,87081,42425,44656
Florida,Hillsborough County,9,92131,45241,46890
Florida,Hillsborough County,10,89734,44212,45522
Florida,Hillsborough County,11,92969,45404,47565
Florida,Hillsborough County,12,83204,40049,43155
Florida,Hillsborough County,13,71144,33297,37847
Florida,Hillsborough County,14,59575,27915,31660
Florida,Hillsborough County,15,40120,18273,21847
Florida,Hillsborough County,16,29111,12709,16402
Florida,Hillsborough County,17,21901,9087,12814
Florida,Hillsborough County,18,22154,7715,14439
Florida,Holmes County,0,19650,10500,9150
Florida,Holmes County,1,983,504,479
Florida,Holmes County,2,1170,613,557
Florida,Holmes County,3,1107,566,541
Florida,Holmes County,4,1119,619,500
Florida,Holmes County,5,1337,854,483
Florida,Holmes County,6,1248,759,489
Florida,Holmes County,7,1210,694,516
Florida,Holmes County,8,1088,643,445
Florida,Holmes County,9,1304,740,564
Florida,Holmes County,10,1342,745,597
Florida,Holmes County,11,1378,703,675
Florida,Holmes County,12,1345,677,668
Florida,Holmes County,13,1302,649,653
Florida,Holmes County,14,1132,532,600
Florida,Holmes County,15,989,465,524
Florida,Holmes County,16,752,369,383
Florida,Holmes County,17,478,217,261
Florida,Holmes County,18,366,151,215
Florida,Indian River County,0,144755,69475,75280
Florida,Indian River County,1,6326,3172,3154
Florida,Indian River County,2,6955,3484,3471
Florida,Indian River County,3,7273,3720,3553
Florida,Indian River County,4,7792,4258,3534
Florida,Indian River County,5,6855,3576,3279
Florida,Indian River County,6,6625,3351,3274
Florida,Indian River County,7,6433,3194,3239
Florida,Indian River County,8,6136,2963,3173
Florida,Indian River County,9,7208,3433,3775
Florida,Indian River County,10,8296,3979,4317
Florida,Indian River County,11,9888,4679,5209
Florida,Indian River County,12,10533,4844,5689
Florida,Indian River County,13,10951,4961,5990
Florida,Indian River County,14,11843,5473,6370
Florida,Indian River County,15,10257,4854,5403
Florida,Indian River County,16,8177,3789,4388
Florida,Indian River County,17,6461,3011,3450
Florida,Indian River County,18,6746,2734,4012
Florida,Jackson County,0,48801,26922,21879
Florida,Jackson County,1,2389,1217,1172
Florida,Jackson County,2,2556,1335,1221
Florida,Jackson County,3,2606,1365,1241
Florida,Jackson County,4,2611,1379,1232
Florida,Jackson County,5,3338,2069,1269
Florida,Jackson County,6,3129,1942,1187
Florida,Jackson County,7,3227,2022,1205
Florida,Jackson County,8,3465,2259,1206
Florida,Jackson County,9,3367,2099,1268
Florida,Jackson County,10,3283,1972,1311
Florida,Jackson County,11,3479,1926,1553
Florida,Jackson County,12,3454,1848,1606
Florida,Jackson County,13,3122,1610,1512
Florida,Jackson County,14,2716,1336,1380
Florida,Jackson County,15,2195,989,1206
Florida,Jackson County,16,1641,691,950
Florida,Jackson County,17,1094,450,644
Florida,Jackson County,18,1129,413,716
Florida,Jefferson County,0,14050,7347,6703
Florida,Jefferson County,1,689,361,328
Florida,Jefferson County,2,708,359,349
Florida,Jefferson County,3,696,351,345
Florida,Jefferson County,4,571,297,274
Florida,Jefferson County,5,746,424,322
Florida,Jefferson County,6,811,469,342
Florida,Jefferson County,7,831,519,312
Florida,Jefferson County,8,784,476,308
Florida,Jefferson County,9,947,544,403
Florida,Jefferson County,10,997,537,460
Florida,Jefferson County,11,1143,608,535
Florida,Jefferson County,12,1151,558,593
Florida,Jefferson County,13,1147,538,609
Florida,Jefferson County,14,982,483,499
Florida,Jefferson County,15,748,379,369
Florida,Jefferson County,16,453,211,242
Florida,Jefferson County,17,307,104,203
Florida,Jefferson County,18,339,129,210
Florida,Lafayette County,0,8835,5297,3538
Florida,Lafayette County,1,451,173,278
Florida,Lafayette County,2,523,266,257
Florida,Lafayette County,3,521,258,263
Florida,Lafayette County,4,498,298,200
Florida,Lafayette County,5,794,602,192
Florida,Lafayette County,6,643,479,164
Florida,Lafayette County,7,682,468,214
Florida,Lafayette County,8,635,438,197
Florida,Lafayette County,9,699,469,230
Florida,Lafayette County,10,599,391,208
Florida,Lafayette County,11,584,342,242
Florida,Lafayette County,12,492,279,213
Florida,Lafayette County,13,473,245,228
Florida,Lafayette County,14,378,188,190
Florida,Lafayette County,15,313,150,163
Florida,Lafayette County,16,252,121,131
Florida,Lafayette County,17,160,78,82
Florida,Lafayette County,18,138,52,86
Florida,Lake County,0,315690,152723,162967
Florida,Lake County,1,15900,8099,7801
Florida,Lake County,2,17456,8872,8584
Florida,Lake County,3,18179,9211,8968
Florida,Lake County,4,16919,8739,8180
Florida,Lake County,5,16140,8131,8009
Florida,Lake County,6,15985,7939,8046
Florida,Lake County,7,16238,7966,8272
Florida,Lake County,8,16183,7806,8377
Florida,Lake County,9,18489,8992,9497
Florida,Lake County,10,19403,9501,9902
Florida,Lake County,11,21134,10389,10745
Florida,Lake County,12,20786,9673,11113
Florida,Lake County,13,20685,9467,11218
Florida,Lake County,14,23766,10922,12844
Florida,Lake County,15,21286,9953,11333
Florida,Lake County,16,16159,7807,8352
Florida,Lake County,17,10908,5265,5643
Florida,Lake County,18,10074,3991,6083
Florida,Lee County,0,679513,333166,346347
Florida,Lee County,1,32981,16933,16048
Florida,Lee County,2,35677,18316,17361
Florida,Lee County,3,36376,18766,17610
Florida,Lee County,4,35789,18200,17589
Florida,Lee County,5,36231,18369,17862
Florida,Lee County,6,36787,18534,18253
Florida,Lee County,7,35838,18206,17632
Florida,Lee County,8,34611,16976,17635
Florida,Lee County,9,37602,18669,18933
Florida,Lee County,10,39406,19389,20017
Florida,Lee County,11,44494,21303,23191
Florida,Lee County,12,46373,21805,24568
Florida,Lee County,13,48683,22440,26243
Florida,Lee County,14,54611,25850,28761
Florida,Lee County,15,47237,23224,24013
Florida,Lee County,16,33258,16628,16630
Florida,Lee County,17,22157,10520,11637
Florida,Lee County,18,21402,9038,12364
Florida,Leon County,0,283988,134859,149129
Florida,Leon County,1,14875,7468,7407
Florida,Leon County,2,15050,7656,7394
Florida,Leon County,3,14999,7574,7425
Florida,Leon County,4,25610,11826,13784
Florida,Leon County,5,49261,23335,25926
Florida,Leon County,6,21621,10964,10657
Florida,Leon County,7,18475,9003,9472
Florida,Leon County,8,15023,7109,7914
Florida,Leon County,9,14890,7064,7826
Florida,Leon County,10,14487,6910,7577
Florida,Leon County,11,16343,7631,8712
Florida,Leon County,12,16074,7394,8680
Florida,Leon County,13,14984,6924,8060
Florida,Leon County,14,12036,5705,6331
Florida,Leon County,15,7542,3421,4121
Florida,Leon County,16,4962,2144,2818
Florida,Leon County,17,3556,1414,2142
Florida,Leon County,18,4200,1317,2883
Florida,Levy County,0,39613,19482,20131
Florida,Levy County,1,1998,1037,961
Florida,Levy County,2,2188,1140,1048
Florida,Levy County,3,2292,1156,1136
Florida,Levy County,4,2142,1151,991
Florida,Levy County,5,2109,1073,1036
Florida,Levy County,6,2096,1022,1074
Florida,Levy County,7,1984,942,1042
Florida,Levy County,8,1867,918,949
Florida,Levy County,9,2232,1103,1129
Florida,Levy County,10,2367,1117,1250
Florida,Levy County,11,3088,1478,1610
Florida,Levy County,12,3082,1444,1638
Florida,Levy County,13,3087,1443,1644
Florida,Levy County,14,3077,1496,1581
Florida,Levy County,15,2453,1238,1215
Florida,Levy County,16,1700,848,852
Florida,Levy County,17,1006,523,483
Florida,Levy County,18,845,353,492
Florida,Liberty County,0,8360,5213,3147
Florida,Liberty County,1,399,225,174
Florida,Liberty County,2,422,214,208
Florida,Liberty County,3,457,243,214
Florida,Liberty County,4,452,266,186
Florida,Liberty County,5,581,406,175
Florida,Liberty County,6,719,517,202
Florida,Liberty County,7,707,500,207
Florida,Liberty County,8,675,475,200
Florida,Liberty County,9,682,463,219
Florida,Liberty County,10,665,465,200
Florida,Liberty County,11,621,393,228
Florida,Liberty County,12,547,319,228
Florida,Liberty County,13,444,249,195
Florida,Liberty County,14,351,199,152
Florida,Liberty County,15,250,112,138
Florida,Liberty County,16,190,88,102
Florida,Liberty County,17,113,53,60
Florida,Liberty County,18,85,26,59
Florida,Madison County,0,18518,9772,8746
Florida,Madison County,1,1011,533,478
Florida,Madison County,2,1076,546,530
Florida,Madison County,3,937,457,480
Florida,Madison County,4,1011,579,432
Florida,Madison County,5,1290,747,543
Florida,Madison County,6,1223,722,501
Florida,Madison County,7,1199,682,517
Florida,Madison County,8,1053,611,442
Florida,Madison County,9,1165,663,502
Florida,Madison County,10,1269,706,563
Florida,Madison County,11,1320,692,628
Florida,Madison County,12,1294,635,659
Florida,Madison County,13,1357,656,701
Florida,Madison County,14,1118,591,527
Florida,Madison County,15,821,386,435
Florida,Madison County,16,595,291,304
Florida,Madison County,17,391,160,231
Florida,Madison County,18,388,115,273
Florida,Manatee County,0,351746,170102,181644
Florida,Manatee County,1,17751,9049,8702
Florida,Manatee County,2,19360,9787,9573
Florida,Manatee County,3,19425,10001,9424
Florida,Manatee County,4,18668,9688,8980
Florida,Manatee County,5,18278,9433,8845
Florida,Manatee County,6,18184,8936,9248
Florida,Manatee County,7,17888,8696,9192
Florida,Manatee County,8,17588,8722,8866
Florida,Manatee County,9,19682,9603,10079
Florida,Manatee County,10,21117,10107,11010
Florida,Manatee County,11,24220,11532,12688
Florida,Manatee County,12,24758,11513,13245
Florida,Manatee County,13,25164,11491,13673
Florida,Manatee County,14,26594,12554,14040
Florida,Manatee County,15,22193,10496,11697
Florida,Manatee County,16,16287,7697,8590
Florida,Manatee County,17,12155,5675,6480
Florida,Manatee County,18,12434,5122,7312
Florida,Marion County,0,339167,162809,176358
Florida,Marion County,1,16667,8633,8034
Florida,Marion County,2,17855,9116,8739
Florida,Marion County,3,18116,9233,8883
Florida,Marion County,4,17470,9096,8374
Florida,Marion County,5,18079,9172,8907
Florida,Marion County,6,17672,8674,8998
Florida,Marion County,7,16793,8076,8717
Florida,Marion County,8,15809,7642,8167
Florida,Marion County,9,17827,8486,9341
Florida,Marion County,10,19596,9392,10204
Florida,Marion County,11,22160,10452,11708
Florida,Marion County,12,23006,10427,12579
Florida,Marion County,13,23386,10360,13026
Florida,Marion County,14,27653,12593,15060
Florida,Marion County,15,25338,11956,13382
Florida,Marion County,16,18755,9054,9701
Florida,Marion County,17,12479,6094,6385
Florida,Marion County,18,10506,4353,6153
Florida,Martin County,0,153392,76007,77385
Florida,Martin County,1,6282,3247,3035
Florida,Martin County,2,6989,3532,3457
Florida,Martin County,3,7464,3746,3718
Florida,Martin County,4,7785,4056,3729
Florida,Martin County,5,7505,4163,3342
Florida,Martin County,6,7030,3927,3103
Florida,Martin County,7,6770,3720,3050
Florida,Martin County,8,6519,3413,3106
Florida,Martin County,9,8018,4071,3947
Florida,Martin County,10,9589,4821,4768
Florida,Martin County,11,11388,5623,5765
Florida,Martin County,12,11959,5802,6157
Florida,Martin County,13,11084,5217,5867
Florida,Martin County,14,11733,5496,6237
Florida,Martin County,15,10747,4978,5769
Florida,Martin County,16,8485,4048,4437
Florida,Martin County,17,6806,3137,3669
Florida,Martin County,18,7239,3010,4229
Florida,Monroe County,0,77136,40470,36666
Florida,Monroe County,1,3580,1846,1734
Florida,Monroe County,2,3236,1652,1584
Florida,Monroe County,3,3047,1513,1534
Florida,Monroe County,4,3089,1629,1460
Florida,Monroe County,5,4003,2157,1846
Florida,Monroe County,6,4867,2546,2321
Florida,Monroe County,7,4751,2546,2205
Florida,Monroe County,8,4425,2355,2070
Florida,Monroe County,9,4993,2617,2376
Florida,Monroe County,10,5650,2989,2661
Florida,Monroe County,11,6555,3354,3201
Florida,Monroe County,12,6707,3490,3217
Florida,Monroe County,13,6429,3334,3095
Florida,Monroe County,14,5734,3150,2584
Florida,Monroe County,15,4152,2278,1874
Florida,Monroe County,16,2612,1414,1198
Florida,Monroe County,17,1663,879,784
Florida,Monroe County,18,1643,721,922
Florida,Nassau County,0,76619,37700,38919
Florida,Nassau County,1,3876,1874,2002
Florida,Nassau County,2,4242,2209,2033
Florida,Nassau County,3,4526,2294,2232
Florida,Nassau County,4,4513,2341,2172
Florida,Nassau County,5,4111,2077,2034
Florida,Nassau County,6,4269,2230,2039
Florida,Nassau County,7,4118,2057,2061
Florida,Nassau County,8,4087,1966,2121
Florida,Nassau County,9,4831,2417,2414
Florida,Nassau County,10,5153,2498,2655
Florida,Nassau County,11,5881,2830,3051
Florida,Nassau County,12,5946,2856,3090
Florida,Nassau County,13,5748,2751,2997
Florida,Nassau County,14,5642,2735,2907
Florida,Nassau County,15,4072,1991,2081
Florida,Nassau County,16,2566,1269,1297
Florida,Nassau County,17,1615,743,872
Florida,Nassau County,18,1423,562,861
Florida,Okaloosa County,0,196512,99916,96596
Florida,Okaloosa County,1,13132,6756,6376
Florida,Okaloosa County,2,12253,6220,6033
Florida,Okaloosa County,3,11244,5762,5482
Florida,Okaloosa County,4,11202,6079,5123
Florida,Okaloosa County,5,15365,8896,6469
Florida,Okaloosa County,6,16783,9166,7617
Florida,Okaloosa County,7,14351,7559,6792
Florida,Okaloosa County,8,11448,5918,5530
Florida,Okaloosa County,9,10854,5511,5343
Florida,Okaloosa County,10,11621,5733,5888
Florida,Okaloosa County,11,14443,7269,7174
Florida,Okaloosa County,12,13338,6503,6835
Florida,Okaloosa County,13,10863,5158,5705
Florida,Okaloosa County,14,9672,4703,4969
Florida,Okaloosa County,15,7096,3338,3758
Florida,Okaloosa County,16,5665,2449,3216
Florida,Okaloosa County,17,4038,1778,2260
Florida,Okaloosa County,18,3144,1118,2026
Florida,Okeechobee County,0,39149,21074,18075
Florida,Okeechobee County,1,2438,1308,1130
Florida,Okeechobee County,2,2488,1293,1195
Florida,Okeechobee County,3,2344,1195,1149
Florida,Okeechobee County,4,2517,1467,1050
Florida,Okeechobee County,5,2522,1338,1184
Florida,Okeechobee County,6,2586,1536,1050
Florida,Okeechobee County,7,2422,1391,1031
Florida,Okeechobee County,8,2387,1368,1019
Florida,Okeechobee County,9,2414,1388,1026
Florida,Okeechobee County,10,2455,1393,1062
Florida,Okeechobee County,11,2762,1485,1277
Florida,Okeechobee County,12,2601,1331,1270
Florida,Okeechobee County,13,2218,1104,1114
Florida,Okeechobee County,14,2138,1072,1066
Florida,Okeechobee County,15,1829,892,937
Florida,Okeechobee County,16,1364,700,664
Florida,Okeechobee County,17,881,468,413
Florida,Okeechobee County,18,783,345,438
Florida,Orange County,0,1253001,615724,637277
Florida,Orange County,1,78154,39819,38335
Florida,Orange County,2,79261,40788,38473
Florida,Orange County,3,79241,40388,38853
Florida,Orange County,4,84974,42602,42372
Florida,Orange County,5,107726,53524,54202
Florida,Orange County,6,108973,55408,53565
Florida,Orange County,7,96347,48287,48060
Florida,Orange County,8,87392,43202,44190
Florida,Orange County,9,88504,43695,44809
Florida,Orange County,10,85458,42414,43044
Florida,Orange County,11,86148,42424,43724
Florida,Orange County,12,75117,35933,39184
Florida,Orange County,13,60740,28478,32262
Florida,Orange County,14,47804,22215,25589
Florida,Orange County,15,31666,14425,17241
Florida,Orange County,16,22514,9646,12868
Florida,Orange County,17,16164,6729,9435
Florida,Orange County,18,16818,5747,11071
Florida,Osceola County,0,310211,152147,158064
Florida,Osceola County,1,19843,10030,9813
Florida,Osceola County,2,20950,10616,10334
Florida,Osceola County,3,22894,11719,11175
Florida,Osceola County,4,22384,11558,10826
Florida,Osceola County,5,21918,11163,10755
Florida,Osceola County,6,21951,11206,10745
Florida,Osceola County,7,21542,10815,10727
Florida,Osceola County,8,21992,10655,11337
Florida,Osceola County,9,21958,10553,11405
Florida,Osceola County,10,21229,10389,10840
Florida,Osceola County,11,20642,9980,10662
Florida,Osceola County,12,17982,8630,9352
Florida,Osceola County,13,15416,7191,8225
Florida,Osceola County,14,13868,6532,7336
Florida,Osceola County,15,10098,4651,5447
Florida,Osceola County,16,7015,3064,3951
Florida,Osceola County,17,4328,1898,2430
Florida,Osceola County,18,4201,1497,2704
Florida,Palm Beach County,0,1397710,676097,721613
Florida,Palm Beach County,1,71357,36292,35065
Florida,Palm Beach County,2,75694,38450,37244
Florida,Palm Beach County,3,77707,39580,38127
Florida,Palm Beach County,4,78564,40276,38288
Florida,Palm Beach County,5,80844,41506,39338
Florida,Palm Beach County,6,83076,42719,40357
Florida,Palm Beach County,7,80486,40236,40250
Florida,Palm Beach County,8,77229,38244,38985
Florida,Palm Beach County,9,86108,42514,43594
Florida,Palm Beach County,10,91616,44452,47164
Florida,Palm Beach County,11,100065,48585,51480
Florida,Palm Beach County,12,93878,45015,48863
Florida,Palm Beach County,13,83466,38829,44637
Florida,Palm Beach County,14,82105,37202,44903
Florida,Palm Beach County,15,70845,31436,39409
Florida,Palm Beach County,16,57161,25491,31670
Florida,Palm Beach County,17,48150,21051,27099
Florida,Palm Beach County,18,59359,24219,35140
Florida,Pasco County,0,485331,235824,249507
Florida,Pasco County,1,24478,12451,12027
Florida,Pasco County,2,27764,14274,13490
Florida,Pasco County,3,29198,14856,14342
Florida,Pasco County,4,27983,14438,13545
Florida,Pasco County,5,25211,12738,12473
Florida,Pasco County,6,24603,12125,12478
Florida,Pasco County,7,27117,13094,14023
Florida,Pasco County,8,27723,13521,14202
Florida,Pasco County,9,31551,15579,15972
Florida,Pasco County,10,32176,15873,16303
Florida,Pasco County,11,34747,17164,17583
Florida,Pasco County,12,32759,15471,17288
Florida,Pasco County,13,31002,14327,16675
Florida,Pasco County,14,32954,15337,17617
Florida,Pasco County,15,27471,12863,14608
Florida,Pasco County,16,20506,9672,10834
Florida,Pasco County,17,14267,6522,7745
Florida,Pasco County,18,13821,5519,8302
Florida,Pinellas County,0,938098,449310,488788
Florida,Pinellas County,1,42467,21437,21030
Florida,Pinellas County,2,43574,22084,21490
Florida,Pinellas County,3,45047,22932,22115
Florida,Pinellas County,4,46155,23727,22428
Florida,Pinellas County,5,50749,25293,25456
Florida,Pinellas County,6,53932,26584,27348
Florida,Pinellas County,7,53221,26079,27142
Florida,Pinellas County,8,49221,24216,25005
Florida,Pinellas County,9,55421,26953,28468
Florida,Pinellas County,10,62621,30650,31971
Florida,Pinellas County,11,75760,36626,39134
Florida,Pinellas County,12,75467,35764,39703
Florida,Pinellas County,13,69077,32603,36474
Florida,Pinellas County,14,63788,30047,33741
Florida,Pinellas County,15,49440,22651,26789
Florida,Pinellas County,16,37434,16757,20677
Florida,Pinellas County,17,29406,12516,16890
Florida,Pinellas County,18,35318,12391,22927
Florida,Polk County,0,634638,311016,323622
Florida,Polk County,1,37247,19075,18172
Florida,Polk County,2,41005,21094,19911
Florida,Polk County,3,41669,21187,20482
Florida,Polk County,4,39914,20555,19359
Florida,Polk County,5,40457,20499,19958
Florida,Polk County,6,39174,19560,19614
Florida,Polk County,7,38608,19061,19547
Florida,Polk County,8,36063,17761,18302
Florida,Polk County,9,38403,18990,19413
Florida,Polk County,10,38470,19306,19164
Florida,Polk County,11,41427,20291,21136
Florida,Polk County,12,40046,19222,20824
Florida,Polk County,13,38334,17631,20703
Florida,Polk County,14,38450,17803,20647
Florida,Polk County,15,31806,14932,16874
Florida,Polk County,16,23534,11183,12351
Florida,Polk County,17,15550,7082,8468
Florida,Polk County,18,14481,5784,8697
Florida,Putnam County,0,72143,35549,36594
Florida,Putnam County,1,4131,2110,2021
Florida,Putnam County,2,4465,2249,2216
Florida,Putnam County,3,4379,2287,2092
Florida,Putnam County,4,4037,2091,1946
Florida,Putnam County,5,4281,2276,2005
Florida,Putnam County,6,3925,1969,1956
Florida,Putnam County,7,3773,1834,1939
Florida,Putnam County,8,3547,1826,1721
Florida,Putnam County,9,3850,1840,2010
Florida,Putnam County,10,4162,2073,2089
Florida,Putnam County,11,5467,2632,2835
Florida,Putnam County,12,5530,2626,2904
Florida,Putnam County,13,5362,2571,2791
Florida,Putnam County,14,4900,2407,2493
Florida,Putnam County,15,3959,1903,2056
Florida,Putnam County,16,2819,1336,1483
Florida,Putnam County,17,1875,880,995
Florida,Putnam County,18,1681,639,1042
Florida,Santa Rosa County,0,163422,83501,79921
Florida,Santa Rosa County,1,9237,4657,4580
Florida,Santa Rosa County,2,10207,5208,4999
Florida,Santa Rosa County,3,10715,5486,5229
Florida,Santa Rosa County,4,10339,5432,4907
Florida,Santa Rosa County,5,10263,5783,4480
Florida,Santa Rosa County,6,11393,6411,4982
Florida,Santa Rosa County,7,10828,5843,4985
Florida,Santa Rosa County,8,10029,5283,4746
Florida,Santa Rosa County,9,11005,5570,5435
Florida,Santa Rosa County,10,11529,5850,5679
Florida,Santa Rosa County,11,13175,6636,6539
Florida,Santa Rosa County,12,11295,5528,5767
Florida,Santa Rosa County,13,9632,4705,4927
Florida,Santa Rosa County,14,8353,4097,4256
Florida,Santa Rosa County,15,6293,2978,3315
Florida,Santa Rosa County,16,4419,2079,2340
Florida,Santa Rosa County,17,2631,1181,1450
Florida,Santa Rosa County,18,2079,774,1305
Florida,Sarasota County,0,396962,189630,207332
Florida,Sarasota County,1,14869,7638,7231
Florida,Sarasota County,2,15905,8252,7653
Florida,Sarasota County,3,17460,8809,8651
Florida,Sarasota County,4,17974,9267,8707
Florida,Sarasota County,5,17303,8953,8350
Florida,Sarasota County,6,16477,8321,8156
Florida,Sarasota County,7,16561,8306,8255
Florida,Sarasota County,8,16272,7991,8281
Florida,Sarasota County,9,19429,9457,9972
Florida,Sarasota County,10,22255,10661,11594
Florida,Sarasota County,11,27038,12888,14150
Florida,Sarasota County,12,29039,13316,15723
Florida,Sarasota County,13,31742,14289,17453
Florida,Sarasota County,14,35786,16450,19336
Florida,Sarasota County,15,32834,15371,17463
Florida,Sarasota County,16,25312,11992,13320
Florida,Sarasota County,17,19253,8998,10255
Florida,Sarasota County,18,21453,8671,12782
Florida,Seminole County,0,442516,213982,228534
Florida,Seminole County,1,22869,11833,11036
Florida,Seminole County,2,25872,13171,12701
Florida,Seminole County,3,27994,14082,13912
Florida,Seminole County,4,28310,14685,13625
Florida,Seminole County,5,30295,15223,15072
Florida,Seminole County,6,31979,16284,15695
Florida,Seminole County,7,30168,14789,15379
Florida,Seminole County,8,28323,13762,14561
Florida,Seminole County,9,30572,14614,15958
Florida,Seminole County,10,31702,15069,16633
Florida,Seminole County,11,34005,16226,17779
Florida,Seminole County,12,31197,14817,16380
Florida,Seminole County,13,25737,11962,13775
Florida,Seminole County,14,21874,10161,11713
Florida,Seminole County,15,14980,6818,8162
Florida,Seminole County,16,10371,4412,5959
Florida,Seminole County,17,7653,3126,4527
Florida,Seminole County,18,8615,2948,5667
Florida,Sumter County,0,114350,57975,56375
Florida,Sumter County,1,2322,1151,1171
Florida,Sumter County,2,2448,1254,1194
Florida,Sumter County,3,2317,1208,1109
Florida,Sumter County,4,2284,1210,1074
Florida,Sumter County,5,2970,1737,1233
Florida,Sumter County,6,3148,1992,1156
Florida,Sumter County,7,3624,2457,1167
Florida,Sumter County,8,3697,2513,1184
Florida,Sumter County,9,3729,2359,1370
Florida,Sumter County,10,3837,2263,1574
Florida,Sumter County,11,4688,2393,2295
Florida,Sumter County,12,6518,2715,3803
Florida,Sumter County,13,12285,5113,7172
Florida,Sumter County,14,20042,9212,10830
Florida,Sumter County,15,18704,9251,9453
Florida,Sumter County,16,11617,6045,5572
Florida,Sumter County,17,5915,3129,2786
Florida,Sumter County,18,4205,1973,2232
Florida,Suwannee County,0,44022,22994,21028
Florida,Suwannee County,1,2566,1279,1287
Florida,Suwannee County,2,2638,1363,1275
Florida,Suwannee County,3,2621,1345,1276
Florida,Suwannee County,4,2472,1276,1196
Florida,Suwannee County,5,2797,1670,1127
Florida,Suwannee County,6,3025,1939,1086
Florida,Suwannee County,7,2728,1603,1125
Florida,Suwannee County,8,2391,1344,1047
Florida,Suwannee County,9,2550,1419,1131
Florida,Suwannee County,10,2716,1451,1265
Florida,Suwannee County,11,2986,1521,1465
Florida,Suwannee County,12,3121,1485,1636
Florida,Suwannee County,13,2783,1330,1453
Florida,Suwannee County,14,2751,1319,1432
Florida,Suwannee County,15,2160,1020,1140
Florida,Suwannee County,16,1601,776,825
Florida,Suwannee County,17,1076,479,597
Florida,Suwannee County,18,1040,375,665
Florida,Taylor County,0,22582,12727,9855
Florida,Taylor County,1,1205,609,596
Florida,Taylor County,2,1246,652,594
Florida,Taylor County,3,1163,593,570
Florida,Taylor County,4,1030,544,486
Florida,Taylor County,5,1531,954,577
Florida,Taylor County,6,1798,1246,552
Florida,Taylor County,7,1455,942,513
Florida,Taylor County,8,1369,913,456
Florida,Taylor County,9,1490,935,555
Florida,Taylor County,10,1539,935,604
Florida,Taylor County,11,1618,899,719
Florida,Taylor County,12,1601,845,756
Florida,Taylor County,13,1464,758,706
Florida,Taylor County,14,1371,680,691
Florida,Taylor County,15,1049,498,551
Florida,Taylor County,16,791,367,424
Florida,Taylor County,17,466,204,262
Florida,Taylor County,18,396,153,243
Florida,Union County,0,15190,9815,5375
Florida,Union County,1,799,373,426
Florida,Union County,2,814,406,408
Florida,Union County,3,779,385,394
Florida,Union County,4,877,494,383
Florida,Union County,5,1014,715,299
Florida,Union County,6,1223,909,314
Florida,Union County,7,1182,827,355
Florida,Union County,8,1015,699,316
Florida,Union County,9,1057,726,331
Florida,Union County,10,1013,711,302
Florida,Union County,11,1261,867,394
Florida,Union County,12,1300,937,363
Florida,Union County,13,974,700,274
Florida,Union County,14,754,472,282
Florida,Union County,15,477,265,212
Florida,Union County,16,332,177,155
Florida,Union County,17,214,105,109
Florida,Union County,18,105,47,58
Florida,Volusia County,0,507531,247488,260043
Florida,Volusia County,1,23638,12114,11524
Florida,Volusia County,2,25168,12813,12355
Florida,Volusia County,3,25933,13190,12743
Florida,Volusia County,4,28858,15029,13829
Florida,Volusia County,5,31476,16325,15151
Florida,Volusia County,6,29561,15301,14260
Florida,Volusia County,7,26175,13131,13044
Florida,Volusia County,8,25282,12517,12765
Florida,Volusia County,9,28395,14084,14311
Florida,Volusia County,10,31262,15345,15917
Florida,Volusia County,11,37971,18285,19686
Florida,Volusia County,12,38617,18350,20267
Florida,Volusia County,13,37230,17546,19684
Florida,Volusia County,14,36131,17305,18826
Florida,Volusia County,15,28357,13305,15052
Florida,Volusia County,16,21141,9624,11517
Florida,Volusia County,17,15771,7000,8771
Florida,Volusia County,18,16565,6224,10341
Florida,Wakulla County,0,31432,17375,14057
Florida,Wakulla County,1,1662,829,833
Florida,Wakulla County,2,1793,945,848
Florida,Wakulla County,3,1949,1050,899
Florida,Wakulla County,4,1724,928,796
Florida,Wakulla County,5,1817,1039,778
Florida,Wakulla County,6,2249,1380,869
Florida,Wakulla County,7,2271,1407,864
Florida,Wakulla County,8,2239,1296,943
Florida,Wakulla County,9,2468,1465,1003
Florida,Wakulla County,10,2438,1491,947
Florida,Wakulla County,11,2510,1375,1135
Florida,Wakulla County,12,2301,1204,1097
Florida,Wakulla County,13,1872,953,919
Florida,Wakulla County,14,1645,851,794
Florida,Wakulla County,15,1064,529,535
Florida,Wakulla County,16,687,318,369
Florida,Wakulla County,17,416,185,231
Florida,Wakulla County,18,327,130,197
Florida,Walton County,0,61530,31294,30236
Florida,Walton County,1,3343,1661,1682
Florida,Walton County,2,3619,1876,1743
Florida,Walton County,3,3407,1689,1718
Florida,Walton County,4,3042,1655,1387
Florida,Walton County,5,3330,1842,1488
Florida,Walton County,6,3733,2013,1720
Florida,Walton County,7,3925,2140,1785
Florida,Walton County,8,3683,1955,1728
Florida,Walton County,9,3939,2093,1846
Florida,Walton County,10,4082,2120,1962
Florida,Walton County,11,4779,2342,2437
Florida,Walton County,12,4738,2321,2417
Florida,Walton County,13,4433,2146,2287
Florida,Walton County,14,4096,2037,2059
Florida,Walton County,15,3033,1493,1540
Florida,Walton County,16,2022,927,1095
Florida,Walton County,17,1234,571,663
Florida,Walton County,18,1092,413,679
Florida,Washington County,0,24451,13396,11055
Florida,Washington County,1,1198,604,594
Florida,Washington County,2,1384,676,708
Florida,Washington County,3,1381,740,641
Florida,Washington County,4,1428,803,625
Florida,Washington County,5,1654,1032,622
Florida,Washington County,6,1589,983,606
Florida,Washington County,7,1606,1040,566
Florida,Washington County,8,1531,926,605
Florida,Washington County,9,1706,1001,705
Florida,Washington County,10,1765,1022,743
Florida,Washington County,11,1800,965,835
Florida,Washington County,12,1672,866,806
Florida,Washington County,13,1507,750,757
Florida,Washington County,14,1381,654,727
Florida,Washington County,15,1184,567,617
Florida,Washington County,16,759,381,378
Florida,Washington County,17,510,244,266
Florida,Washington County,18,396,142,254
Georgia,Appling County,0,18540,9290,9250
Georgia,Appling County,1,1279,686,593
Georgia,Appling County,2,1356,670,686
Georgia,Appling County,3,1260,648,612
Georgia,Appling County,4,1228,663,565
Georgia,Appling County,5,1157,664,493
Georgia,Appling County,6,1051,509,542
Georgia,Appling County,7,1115,573,542
Georgia,Appling County,8,1125,557,568
Georgia,Appling County,9,1154,569,585
Georgia,Appling County,10,1194,610,584
Georgia,Appling County,11,1277,641,636
Georgia,Appling County,12,1323,655,668
Georgia,Appling County,13,1120,547,573
Georgia,Appling County,14,1037,513,524
Georgia,Appling County,15,734,341,393
Georgia,Appling County,16,519,223,296
Georgia,Appling County,17,301,120,181
Georgia,Appling County,18,310,101,209
Georgia,Atkinson County,0,8223,4146,4077
Georgia,Atkinson County,1,693,341,352
Georgia,Atkinson County,2,641,337,304
Georgia,Atkinson County,3,618,311,307
Georgia,Atkinson County,4,559,272,287
Georgia,Atkinson County,5,559,285,274
Georgia,Atkinson County,6,492,257,235
Georgia,Atkinson County,7,494,248,246
Georgia,Atkinson County,8,559,279,280
Georgia,Atkinson County,9,539,278,261
Georgia,Atkinson County,10,563,315,248
Georgia,Atkinson County,11,549,274,275
Georgia,Atkinson County,12,535,255,280
Georgia,Atkinson County,13,453,230,223
Georgia,Atkinson County,14,337,165,172
Georgia,Atkinson County,15,262,127,135
Georgia,Atkinson County,16,192,93,99
Georgia,Atkinson County,17,117,58,59
Georgia,Atkinson County,18,61,21,40
Georgia,Bacon County,0,11281,5548,5733
Georgia,Bacon County,1,773,374,399
Georgia,Bacon County,2,852,426,426
Georgia,Bacon County,3,809,395,414
Georgia,Bacon County,4,764,370,394
Georgia,Bacon County,5,709,372,337
Georgia,Bacon County,6,707,391,316
Georgia,Bacon County,7,661,313,348
Georgia,Bacon County,8,815,422,393
Georgia,Bacon County,9,751,375,376
Georgia,Bacon County,10,731,372,359
Georgia,Bacon County,11,677,351,326
Georgia,Bacon County,12,728,336,392
Georgia,Bacon County,13,708,349,359
Georgia,Bacon County,14,553,268,285
Georgia,Bacon County,15,401,173,228
Georgia,Bacon County,16,320,135,185
Georgia,Bacon County,17,171,59,112
Georgia,Bacon County,18,151,67,84
Georgia,Baker County,0,3255,1559,1696
Georgia,Baker County,1,166,69,97
Georgia,Baker County,2,213,100,113
Georgia,Baker County,3,190,80,110
Georgia,Baker County,4,176,82,94
Georgia,Baker County,5,185,99,86
Georgia,Baker County,6,184,93,91
Georgia,Baker County,7,185,82,103
Georgia,Baker County,8,154,85,69
Georgia,Baker County,9,205,109,96
Georgia,Baker County,10,195,98,97
Georgia,Baker County,11,270,127,143
Georgia,Baker County,12,274,141,133
Georgia,Baker County,13,278,137,141
Georgia,Baker County,14,199,96,103
Georgia,Baker County,15,132,60,72
Georgia,Baker County,16,84,42,42
Georgia,Baker County,17,85,35,50
Georgia,Baker County,18,80,24,56
Georgia,Baldwin County,0,45909,23132,22777
Georgia,Baldwin County,1,2379,1186,1193
Georgia,Baldwin County,2,2574,1347,1227
Georgia,Baldwin County,3,2501,1231,1270
Georgia,Baldwin County,4,4372,2075,2297
Georgia,Baldwin County,5,5891,2960,2931
Georgia,Baldwin County,6,2874,1473,1401
Georgia,Baldwin County,7,2628,1352,1276
Georgia,Baldwin County,8,2293,1227,1066
Georgia,Baldwin County,9,2408,1264,1144
Georgia,Baldwin County,10,2737,1480,1257
Georgia,Baldwin County,11,3150,1622,1528
Georgia,Baldwin County,12,2944,1527,1417
Georgia,Baldwin County,13,2643,1359,1284
Georgia,Baldwin County,14,2296,1125,1171
Georgia,Baldwin County,15,1620,763,857
Georgia,Baldwin County,16,1147,516,631
Georgia,Baldwin County,17,757,321,436
Georgia,Baldwin County,18,695,304,391
Georgia,Banks County,0,18295,9270,9025
Georgia,Banks County,1,965,474,491
Georgia,Banks County,2,1152,603,549
Georgia,Banks County,3,1330,725,605
Georgia,Banks County,4,1218,641,577
Georgia,Banks County,5,1107,554,553
Georgia,Banks County,6,999,492,507
Georgia,Banks County,7,991,510,481
Georgia,Banks County,8,1155,586,569
Georgia,Banks County,9,1303,664,639
Georgia,Banks County,10,1335,690,645
Georgia,Banks County,11,1412,720,692
Georgia,Banks County,12,1307,672,635
Georgia,Banks County,13,1115,554,561
Georgia,Banks County,14,1109,518,591
Georgia,Banks County,15,813,399,414
Georgia,Banks County,16,498,252,246
Georgia,Banks County,17,280,127,153
Georgia,Banks County,18,206,89,117
Georgia,Barrow County,0,73240,36136,37104
Georgia,Barrow County,1,5263,2664,2599
Georgia,Barrow County,2,5927,3014,2913
Georgia,Barrow County,3,5636,2938,2698
Georgia,Barrow County,4,4829,2581,2248
Georgia,Barrow County,5,4457,2259,2198
Georgia,Barrow County,6,5097,2510,2587
Georgia,Barrow County,7,5665,2769,2896
Georgia,Barrow County,8,5226,2678,2548
Georgia,Barrow County,9,5358,2671,2687
Georgia,Barrow County,10,4906,2392,2514
Georgia,Barrow County,11,4825,2371,2454
Georgia,Barrow County,12,4274,2067,2207
Georgia,Barrow County,13,3562,1711,1851
Georgia,Barrow County,14,3137,1487,1650
Georgia,Barrow County,15,2123,920,1203
Georgia,Barrow County,16,1313,544,769
Georgia,Barrow County,17,837,316,521
Georgia,Barrow County,18,805,244,561
Georgia,Bartow County,0,101736,50148,51588
Georgia,Bartow County,1,6495,3239,3256
Georgia,Bartow County,2,7083,3594,3489
Georgia,Bartow County,3,7581,3938,3643
Georgia,Bartow County,4,6774,3403,3371
Georgia,Bartow County,5,6594,3363,3231
Georgia,Bartow County,6,6666,3275,3391
Georgia,Bartow County,7,6402,3162,3240
Georgia,Bartow County,8,6599,3275,3324
Georgia,Bartow County,9,7243,3621,3622
Georgia,Bartow County,10,7496,3761,3735
Georgia,Bartow County,11,7481,3702,3779
Georgia,Bartow County,12,6866,3438,3428
Georgia,Bartow County,13,5427,2600,2827
Georgia,Bartow County,14,4928,2310,2618
Georgia,Bartow County,15,3381,1591,1790
Georgia,Bartow County,16,2150,921,1229
Georgia,Bartow County,17,1384,557,827
Georgia,Bartow County,18,1186,398,788
Georgia,Ben Hill County,0,17464,8297,9167
Georgia,Ben Hill County,1,1336,613,723
Georgia,Ben Hill County,2,1321,652,669
Georgia,Ben Hill County,3,1179,592,587
Georgia,Ben Hill County,4,971,497,474
Georgia,Ben Hill County,5,1087,550,537
Georgia,Ben Hill County,6,1105,521,584
Georgia,Ben Hill County,7,1088,503,585
Georgia,Ben Hill County,8,1008,503,505
Georgia,Ben Hill County,9,1071,524,547
Georgia,Ben Hill County,10,1111,550,561
Georgia,Ben Hill County,11,1165,570,595
Georgia,Ben Hill County,12,1238,597,641
Georgia,Ben Hill County,13,1094,513,581
Georgia,Ben Hill County,14,932,402,530
Georgia,Ben Hill County,15,677,297,380
Georgia,Ben Hill County,16,473,191,282
Georgia,Ben Hill County,17,312,135,177
Georgia,Ben Hill County,18,296,87,209
Georgia,Berrien County,0,18700,9220,9480
Georgia,Berrien County,1,1134,553,581
Georgia,Berrien County,2,1304,666,638
Georgia,Berrien County,3,1302,667,635
Georgia,Berrien County,4,1051,592,459
Georgia,Berrien County,5,1126,553,573
Georgia,Berrien County,6,1158,593,565
Georgia,Berrien County,7,1053,518,535
Georgia,Berrien County,8,1124,565,559
Georgia,Berrien County,9,1245,622,623
Georgia,Berrien County,10,1315,644,671
Georgia,Berrien County,11,1405,714,691
Georgia,Berrien County,12,1302,633,669
Georgia,Berrien County,13,1098,534,564
Georgia,Berrien County,14,1070,502,568
Georgia,Berrien County,15,767,376,391
Georgia,Berrien County,16,578,251,327
Georgia,Berrien County,17,368,152,216
Georgia,Berrien County,18,300,85,215
Georgia,Bibb County,0,153905,72398,81507
Georgia,Bibb County,1,11077,5621,5456
Georgia,Bibb County,2,11006,5627,5379
Georgia,Bibb County,3,10524,5383,5141
Georgia,Bibb County,4,10691,5329,5362
Georgia,Bibb County,5,11739,5529,6210
Georgia,Bibb County,6,10693,5000,5693
Georgia,Bibb County,7,9698,4476,5222
Georgia,Bibb County,8,8987,4305,4682
Georgia,Bibb County,9,9231,4343,4888
Georgia,Bibb County,10,9132,4359,4773
Georgia,Bibb County,11,10227,4773,5454
Georgia,Bibb County,12,10276,4779,5497
Georgia,Bibb County,13,9060,4214,4846
Georgia,Bibb County,14,7228,3222,4006
Georgia,Bibb County,15,5036,2131,2905
Georgia,Bibb County,16,3657,1464,2193
Georgia,Bibb County,17,2794,1020,1774
Georgia,Bibb County,18,2849,823,2026
Georgia,Bleckley County,0,12795,6110,6685
Georgia,Bleckley County,1,695,348,347
Georgia,Bleckley County,2,755,397,358
Georgia,Bleckley County,3,763,386,377
Georgia,Bleckley County,4,1311,643,668
Georgia,Bleckley County,5,1091,560,531
Georgia,Bleckley County,6,744,344,400
Georgia,Bleckley County,7,695,328,367
Georgia,Bleckley County,8,658,310,348
Georgia,Bleckley County,9,742,341,401
Georgia,Bleckley County,10,825,397,428
Georgia,Bleckley County,11,926,466,460
Georgia,Bleckley County,12,816,384,432
Georgia,Bleckley County,13,634,316,318
Georgia,Bleckley County,14,662,309,353
Georgia,Bleckley County,15,516,232,284
Georgia,Bleckley County,16,391,147,244
Georgia,Bleckley County,17,263,106,157
Georgia,Bleckley County,18,308,96,212
Georgia,Brantley County,0,18417,9090,9327
Georgia,Brantley County,1,1049,546,503
Georgia,Brantley County,2,1309,673,636
Georgia,Brantley County,3,1369,702,667
Georgia,Brantley County,4,1266,678,588
Georgia,Brantley County,5,1098,530,568
Georgia,Brantley County,6,1082,552,530
Georgia,Brantley County,7,1033,502,531
Georgia,Brantley County,8,1107,552,555
Georgia,Brantley County,9,1283,599,684
Georgia,Brantley County,10,1301,635,666
Georgia,Brantley County,11,1356,694,662
Georgia,Brantley County,12,1283,628,655
Georgia,Brantley County,13,1175,563,612
Georgia,Brantley County,14,1015,467,548
Georgia,Brantley County,15,716,341,375
Georgia,Brantley County,16,467,227,240
Georgia,Brantley County,17,300,121,179
Georgia,Brantley County,18,208,80,128
Georgia,Brooks County,0,15418,7527,7891
Georgia,Brooks County,1,1032,565,467
Georgia,Brooks County,2,947,499,448
Georgia,Brooks County,3,951,501,450
Georgia,Brooks County,4,757,380,377
Georgia,Brooks County,5,884,448,436
Georgia,Brooks County,6,958,453,505
Georgia,Brooks County,7,895,462,433
Georgia,Brooks County,8,811,416,395
Georgia,Brooks County,9,926,462,464
Georgia,Brooks County,10,985,483,502
Georgia,Brooks County,11,1229,591,638
Georgia,Brooks County,12,1139,546,593
Georgia,Brooks County,13,1037,485,552
Georgia,Brooks County,14,1010,444,566
Georgia,Brooks County,15,734,337,397
Georgia,Brooks County,16,508,205,303
Georgia,Brooks County,17,341,150,191
Georgia,Brooks County,18,274,100,174
Georgia,Bryan County,0,33906,16882,17024
Georgia,Bryan County,1,2489,1269,1220
Georgia,Bryan County,2,2801,1449,1352
Georgia,Bryan County,3,2864,1510,1354
Georgia,Bryan County,4,2494,1363,1131
Georgia,Bryan County,5,1951,1033,918
Georgia,Bryan County,6,2256,1093,1163
Georgia,Bryan County,7,2475,1196,1279
Georgia,Bryan County,8,2546,1235,1311
Georgia,Bryan County,9,2596,1258,1338
Georgia,Bryan County,10,2184,1074,1110
Georgia,Bryan County,11,2281,1138,1143
Georgia,Bryan County,12,1919,916,1003
Georgia,Bryan County,13,1600,764,836
Georgia,Bryan County,14,1323,648,675
Georgia,Bryan County,15,862,424,438
Georgia,Bryan County,16,582,265,317
Georgia,Bryan County,17,333,136,197
Georgia,Bryan County,18,350,111,239
Georgia,Bulloch County,0,72087,35577,36510
Georgia,Bulloch County,1,4019,2043,1976
Georgia,Bulloch County,2,4185,2079,2106
Georgia,Bulloch County,3,4077,2127,1950
Georgia,Bulloch County,4,8224,4149,4075
Georgia,Bulloch County,5,12767,6483,6284
Georgia,Bulloch County,6,5498,2908,2590
Georgia,Bulloch County,7,4200,2105,2095
Georgia,Bulloch County,8,3740,1794,1946
Georgia,Bulloch County,9,3663,1776,1887
Georgia,Bulloch County,10,3575,1741,1834
Georgia,Bulloch County,11,3823,1783,2040
Georgia,Bulloch County,12,3671,1754,1917
Georgia,Bulloch County,13,3184,1522,1662
Georgia,Bulloch County,14,2601,1242,1359
Georgia,Bulloch County,15,1973,911,1062
Georgia,Bulloch County,16,1295,538,757
Georgia,Bulloch County,17,878,384,494
Georgia,Bulloch County,18,714,238,476
Georgia,Burke County,0,22709,10900,11809
Georgia,Burke County,1,1583,818,765
Georgia,Burke County,2,1715,891,824
Georgia,Burke County,3,1743,902,841
Georgia,Burke County,4,1469,749,720
Georgia,Burke County,5,1559,785,774
Georgia,Burke County,6,1385,642,743
Georgia,Burke County,7,1377,640,737
Georgia,Burke County,8,1213,582,631
Georgia,Burke County,9,1342,633,709
Georgia,Burke County,10,1357,622,735
Georgia,Burke County,11,1684,791,893
Georgia,Burke County,12,1620,787,833
Georgia,Burke County,13,1452,675,777
Georgia,Burke County,14,1152,556,596
Georgia,Burke County,15,829,354,475
Georgia,Burke County,16,517,208,309
Georgia,Burke County,17,378,133,245
Georgia,Burke County,18,334,132,202
Georgia,Butts County,0,23368,12366,11002
Georgia,Butts County,1,1357,678,679
Georgia,Butts County,2,1432,690,742
Georgia,Butts County,3,1421,710,711
Georgia,Butts County,4,1437,789,648
Georgia,Butts County,5,1696,1056,640
Georgia,Butts County,6,1633,1012,621
Georgia,Butts County,7,1643,966,677
Georgia,Butts County,8,1495,883,612
Georgia,Butts County,9,1586,886,700
Georgia,Butts County,10,1670,916,754
Georgia,Butts County,11,1703,866,837
Georgia,Butts County,12,1554,778,776
Georgia,Butts County,13,1408,689,719
Georgia,Butts County,14,1220,567,653
Georgia,Butts County,15,910,438,472
Georgia,Butts County,16,527,228,299
Georgia,Butts County,17,355,128,227
Georgia,Butts County,18,321,86,235
Georgia,Calhoun County,0,6463,3879,2584
Georgia,Calhoun County,1,308,156,152
Georgia,Calhoun County,2,360,194,166
Georgia,Calhoun County,3,346,169,177
Georgia,Calhoun County,4,345,182,163
Georgia,Calhoun County,5,483,328,155
Georgia,Calhoun County,6,469,335,134
Georgia,Calhoun County,7,541,377,164
Georgia,Calhoun County,8,484,343,141
Georgia,Calhoun County,9,530,364,166
Georgia,Calhoun County,10,486,342,144
Georgia,Calhoun County,11,480,290,190
Georgia,Calhoun County,12,451,247,204
Georgia,Calhoun County,13,371,215,156
Georgia,Calhoun County,14,278,144,134
Georgia,Calhoun County,15,165,79,86
Georgia,Calhoun County,16,127,63,64
Georgia,Calhoun County,17,103,28,75
Georgia,Calhoun County,18,136,23,113
Georgia,Camden County,0,52027,26738,25289
Georgia,Camden County,1,3944,1984,1960
Georgia,Camden County,2,3752,1934,1818
Georgia,Camden County,3,3407,1719,1688
Georgia,Camden County,4,3478,1919,1559
Georgia,Camden County,5,5464,3433,2031
Georgia,Camden County,6,4653,2536,2117
Georgia,Camden County,7,3614,1874,1740
Georgia,Camden County,8,2910,1449,1461
Georgia,Camden County,9,2943,1411,1532
Georgia,Camden County,10,3117,1512,1605
Georgia,Camden County,11,3381,1623,1758
Georgia,Camden County,12,3053,1430,1623
Georgia,Camden County,13,2432,1150,1282
Georgia,Camden County,14,2275,1115,1160
Georgia,Camden County,15,1697,793,904
Georgia,Camden County,16,952,474,478
Georgia,Camden County,17,536,214,322
Georgia,Camden County,18,419,168,251
Georgia,Candler County,0,10888,5396,5492
Georgia,Candler County,1,685,353,332
Georgia,Candler County,2,827,412,415
Georgia,Candler County,3,794,404,390
Georgia,Candler County,4,743,390,353
Georgia,Candler County,5,657,325,332
Georgia,Candler County,6,707,364,343
Georgia,Candler County,7,597,329,268
Georgia,Candler County,8,599,290,309
Georgia,Candler County,9,707,334,373
Georgia,Candler County,10,619,309,310
Georgia,Candler County,11,709,334,375
Georgia,Candler County,12,695,341,354
Georgia,Candler County,13,726,387,339
Georgia,Candler County,14,663,306,357
Georgia,Candler County,15,484,248,236
Georgia,Candler County,16,313,136,177
Georgia,Candler County,17,179,76,103
Georgia,Candler County,18,184,58,126
Georgia,Carroll County,0,114093,56000,58093
Georgia,Carroll County,1,7294,3791,3503
Georgia,Carroll County,2,7805,4027,3778
Georgia,Carroll County,3,7848,3959,3889
Georgia,Carroll County,4,9478,4700,4778
Georgia,Carroll County,5,11377,5583,5794
Georgia,Carroll County,6,7404,3752,3652
Georgia,Carroll County,7,7327,3656,3671
Georgia,Carroll County,8,6854,3427,3427
Georgia,Carroll County,9,7384,3617,3767
Georgia,Carroll County,10,7204,3624,3580
Georgia,Carroll County,11,7328,3641,3687
Georgia,Carroll County,12,6729,3248,3481
Georgia,Carroll County,13,5853,2759,3094
Georgia,Carroll County,14,5042,2355,2687
Georgia,Carroll County,15,3658,1692,1966
Georgia,Carroll County,16,2573,1152,1421
Georgia,Carroll County,17,1633,629,1004
Georgia,Carroll County,18,1302,388,914
Georgia,Catoosa County,0,65621,31937,33684
Georgia,Catoosa County,1,3833,1931,1902
Georgia,Catoosa County,2,4216,2217,1999
Georgia,Catoosa County,3,4637,2441,2196
Georgia,Catoosa County,4,4316,2317,1999
Georgia,Catoosa County,5,3874,1992,1882
Georgia,Catoosa County,6,3896,1923,1973
Georgia,Catoosa County,7,3910,1927,1983
Georgia,Catoosa County,8,4184,2021,2163
Georgia,Catoosa County,9,4764,2315,2449
Georgia,Catoosa County,10,4642,2233,2409
Georgia,Catoosa County,11,4710,2304,2406
Georgia,Catoosa County,12,4320,2031,2289
Georgia,Catoosa County,13,3848,1771,2077
Georgia,Catoosa County,14,3522,1623,1899
Georgia,Catoosa County,15,2720,1222,1498
Georgia,Catoosa County,16,1970,862,1108
Georgia,Catoosa County,17,1262,480,782
Georgia,Catoosa County,18,997,327,670
Georgia,Charlton County,0,12897,7776,5121
Georgia,Charlton County,1,723,366,357
Georgia,Charlton County,2,701,371,330
Georgia,Charlton County,3,646,335,311
Georgia,Charlton County,4,660,380,280
Georgia,Charlton County,5,1007,725,282
Georgia,Charlton County,6,1131,807,324
Georgia,Charlton County,7,977,719,258
Georgia,Charlton County,8,926,634,292
Georgia,Charlton County,9,969,627,342
Georgia,Charlton County,10,952,596,356
Georgia,Charlton County,11,1013,592,421
Georgia,Charlton County,12,838,450,388
Georgia,Charlton County,13,645,344,301
Georgia,Charlton County,14,584,298,286
Georgia,Charlton County,15,460,236,224
Georgia,Charlton County,16,326,158,168
Georgia,Charlton County,17,184,88,96
Georgia,Charlton County,18,155,50,105
Georgia,Chatham County,0,283379,136651,146728
Georgia,Chatham County,1,19427,9849,9578
Georgia,Chatham County,2,17932,9230,8702
Georgia,Chatham County,3,16368,8292,8076
Georgia,Chatham County,4,18157,8851,9306
Georgia,Chatham County,5,25102,12627,12475
Georgia,Chatham County,6,25657,12971,12686
Georgia,Chatham County,7,21565,10655,10910
Georgia,Chatham County,8,17468,8509,8959
Georgia,Chatham County,9,16351,7926,8425
Georgia,Chatham County,10,16094,7773,8321
Georgia,Chatham County,11,17791,8377,9414
Georgia,Chatham County,12,17449,8050,9399
Georgia,Chatham County,13,15495,6933,8562
Georgia,Chatham County,14,13307,6129,7178
Georgia,Chatham County,15,9338,4227,5111
Georgia,Chatham County,16,6418,2794,3624
Georgia,Chatham County,17,4604,1902,2702
Georgia,Chatham County,18,4856,1556,3300
Georgia,Chattahoochee County,0,11837,7963,3874
Georgia,Chattahoochee County,1,1121,585,536
Georgia,Chattahoochee County,2,797,414,383
Georgia,Chattahoochee County,3,505,258,247
Georgia,Chattahoochee County,4,1012,814,198
Georgia,Chattahoochee County,5,3062,2565,497
Georgia,Chattahoochee County,6,1852,1345,507
Georgia,Chattahoochee County,7,1020,654,366
Georgia,Chattahoochee County,8,609,394,215
Georgia,Chattahoochee County,9,455,254,201
Georgia,Chattahoochee County,10,325,170,155
Georgia,Chattahoochee County,11,237,129,108
Georgia,Chattahoochee County,12,207,94,113
Georgia,Chattahoochee County,13,145,67,78
Georgia,Chattahoochee County,14,167,64,103
Georgia,Chattahoochee County,15,123,63,60
Georgia,Chattahoochee County,16,107,58,49
Georgia,Chattahoochee County,17,50,26,24
Georgia,Chattahoochee County,18,43,9,34
Georgia,Chattooga County,0,24939,12775,12164
Georgia,Chattooga County,1,1409,721,688
Georgia,Chattooga County,2,1617,836,781
Georgia,Chattooga County,3,1635,821,814
Georgia,Chattooga County,4,1562,829,733
Georgia,Chattooga County,5,1600,904,696
Georgia,Chattooga County,6,1548,900,648
Georgia,Chattooga County,7,1586,855,731
Georgia,Chattooga County,8,1479,835,644
Georgia,Chattooga County,9,1680,898,782
Georgia,Chattooga County,10,1685,893,792
Georgia,Chattooga County,11,1702,828,874
Georgia,Chattooga County,12,1803,931,872
Georgia,Chattooga County,13,1529,741,788
Georgia,Chattooga County,14,1372,654,718
Georgia,Chattooga County,15,1052,484,568
Georgia,Chattooga County,16,692,309,383
Georgia,Chattooga County,17,478,194,284
Georgia,Chattooga County,18,510,142,368
Georgia,Cherokee County,0,230985,113908,117077
Georgia,Cherokee County,1,14336,7323,7013
Georgia,Cherokee County,2,17114,8827,8287
Georgia,Cherokee County,3,18271,9255,9016
Georgia,Cherokee County,4,15656,7999,7657
Georgia,Cherokee County,5,13440,6846,6594
Georgia,Cherokee County,6,12920,6446,6474
Georgia,Cherokee County,7,14651,7258,7393
Georgia,Cherokee County,8,15987,7741,8246
Georgia,Cherokee County,9,18711,9249,9462
Georgia,Cherokee County,10,17968,8934,9034
Georgia,Cherokee County,11,17402,8590,8812
Georgia,Cherokee County,12,14739,7297,7442
Georgia,Cherokee County,13,12248,5694,6554
Georgia,Cherokee County,14,11179,5226,5953
Georgia,Cherokee County,15,7173,3372,3801
Georgia,Cherokee County,16,4340,1985,2355
Georgia,Cherokee County,17,2629,1122,1507
Georgia,Cherokee County,18,2221,744,1477
Georgia,Clarke County,0,120938,57666,63272
Georgia,Clarke County,1,7022,3501,3521
Georgia,Clarke County,2,6136,3137,2999
Georgia,Clarke County,3,5280,2715,2565
Georgia,Clarke County,4,11938,5252,6686
Georgia,Clarke County,5,24248,11724,12524
Georgia,Clarke County,6,11421,5520,5901
Georgia,Clarke County,7,8784,4511,4273
Georgia,Clarke County,8,7192,3598,3594
Georgia,Clarke County,9,6082,3033,3049
Georgia,Clarke County,10,5250,2557,2693
Georgia,Clarke County,11,5394,2578,2816
Georgia,Clarke County,12,5412,2496,2916
Georgia,Clarke County,13,5022,2270,2752
Georgia,Clarke County,14,4023,1773,2250
Georgia,Clarke County,15,2786,1198,1588
Georgia,Clarke County,16,1982,799,1183
Georgia,Clarke County,17,1434,542,892
Georgia,Clarke County,18,1532,462,1070
Georgia,Clay County,0,3102,1454,1648
Georgia,Clay County,1,204,115,89
Georgia,Clay County,2,191,93,98
Georgia,Clay County,3,189,89,100
Georgia,Clay County,4,144,74,70
Georgia,Clay County,5,184,101,83
Georgia,Clay County,6,164,70,94
Georgia,Clay County,7,166,72,94
Georgia,Clay County,8,142,70,72
Georgia,Clay County,9,131,57,74
Georgia,Clay County,10,158,67,91
Georgia,Clay County,11,192,86,106
Georgia,Clay County,12,247,111,136
Georgia,Clay County,13,268,129,139
Georgia,Clay County,14,255,117,138
Georgia,Clay County,15,175,82,93
Georgia,Clay County,16,137,69,68
Georgia,Clay County,17,64,28,36
Georgia,Clay County,18,91,24,67
Georgia,Clayton County,0,267542,126794,140748
Georgia,Clayton County,1,20849,10814,10035
Georgia,Clayton County,2,21965,11321,10644
Georgia,Clayton County,3,20930,10564,10366
Georgia,Clayton County,4,19081,9609,9472
Georgia,Clayton County,5,20800,10211,10589
Georgia,Clayton County,6,20300,9681,10619
Georgia,Clayton County,7,19416,8938,10478
Georgia,Clayton County,8,18232,8310,9922
Georgia,Clayton County,9,19149,8803,10346
Georgia,Clayton County,10,18331,8409,9922
Georgia,Clayton County,11,17852,8137,9715
Georgia,Clayton County,12,15918,7098,8820
Georgia,Clayton County,13,12549,5539,7010
Georgia,Clayton County,14,9021,4034,4987
Georgia,Clayton County,15,5636,2468,3168
Georgia,Clayton County,16,3412,1418,1994
Georgia,Clayton County,17,2277,854,1423
Georgia,Clayton County,18,1824,586,1238
Georgia,Clinch County,0,6831,3350,3481
Georgia,Clinch County,1,520,277,243
Georgia,Clinch County,2,503,252,251
Georgia,Clinch County,3,486,258,228
Georgia,Clinch County,4,420,198,222
Georgia,Clinch County,5,485,257,228
Georgia,Clinch County,6,441,209,232
Georgia,Clinch County,7,398,177,221
Georgia,Clinch County,8,380,190,190
Georgia,Clinch County,9,447,235,212
Georgia,Clinch County,10,418,205,213
Georgia,Clinch County,11,418,185,233
Georgia,Clinch County,12,457,234,223
Georgia,Clinch County,13,436,193,243
Georgia,Clinch County,14,393,202,191
Georgia,Clinch County,15,281,149,132
Georgia,Clinch County,16,153,62,91
Georgia,Clinch County,17,123,39,84
Georgia,Clinch County,18,72,28,44
Georgia,Cobb County,0,730981,353449,377532
Georgia,Cobb County,1,48270,24475,23795
Georgia,Cobb County,2,50505,25507,24998
Georgia,Cobb County,3,51248,25860,25388
Georgia,Cobb County,4,48928,25111,23817
Georgia,Cobb County,5,49400,25046,24354
Georgia,Cobb County,6,51614,25421,26193
Georgia,Cobb County,7,52750,25282,27468
Georgia,Cobb County,8,52317,24884,27433
Georgia,Cobb County,9,56265,26912,29353
Georgia,Cobb County,10,53865,25811,28054
Georgia,Cobb County,11,53673,25531,28142
Georgia,Cobb County,12,46909,22388,24521
Georgia,Cobb County,13,37870,17757,20113
Georgia,Cobb County,14,29978,13699,16279
Georgia,Cobb County,15,18958,8651,10307
Georgia,Cobb County,16,12332,5335,6997
Georgia,Cobb County,17,8128,3329,4799
Georgia,Cobb County,18,7971,2450,5521
Georgia,Coffee County,0,42811,21951,20860
Georgia,Coffee County,1,2853,1518,1335
Georgia,Coffee County,2,3018,1574,1444
Georgia,Coffee County,3,2974,1504,1470
Georgia,Coffee County,4,2948,1492,1456
Georgia,Coffee County,5,3448,1887,1561
Georgia,Coffee County,6,3051,1705,1346
Georgia,Coffee County,7,2929,1581,1348
Georgia,Coffee County,8,2745,1523,1222
Georgia,Coffee County,9,2917,1522,1395
Georgia,Coffee County,10,2896,1538,1358
Georgia,Coffee County,11,2914,1508,1406
Georgia,Coffee County,12,2531,1251,1280
Georgia,Coffee County,13,2303,1058,1245
Georgia,Coffee County,14,1934,946,988
Georgia,Coffee County,15,1367,588,779
Georgia,Coffee County,16,895,380,515
Georgia,Coffee County,17,578,209,369
Georgia,Coffee County,18,510,167,343
Georgia,Colquitt County,0,46102,22882,23220
Georgia,Colquitt County,1,3580,1825,1755
Georgia,Colquitt County,2,3625,1868,1757
Georgia,Colquitt County,3,3321,1752,1569
Georgia,Colquitt County,4,2999,1576,1423
Georgia,Colquitt County,5,3068,1652,1416
Georgia,Colquitt County,6,3025,1540,1485
Georgia,Colquitt County,7,3090,1519,1571
Georgia,Colquitt County,8,2857,1435,1422
Georgia,Colquitt County,9,2947,1485,1462
Georgia,Colquitt County,10,2990,1495,1495
Georgia,Colquitt County,11,2923,1423,1500
Georgia,Colquitt County,12,2705,1321,1384
Georgia,Colquitt County,13,2535,1184,1351
Georgia,Colquitt County,14,2205,1065,1140
Georgia,Colquitt County,15,1640,785,855
Georgia,Colquitt County,16,1120,473,647
Georgia,Colquitt County,17,758,282,476
Georgia,Colquitt County,18,714,202,512
Georgia,Columbia County,0,139257,68121,71136
Georgia,Columbia County,1,8808,4511,4297
Georgia,Columbia County,2,10039,5104,4935
Georgia,Columbia County,3,10766,5572,5194
Georgia,Columbia County,4,9891,5131,4760
Georgia,Columbia County,5,8736,4453,4283
Georgia,Columbia County,6,9072,4539,4533
Georgia,Columbia County,7,9655,4669,4986
Georgia,Columbia County,8,9312,4496,4816
Georgia,Columbia County,9,10061,4861,5200
Georgia,Columbia County,10,9582,4564,5018
Georgia,Columbia County,11,10138,4818,5320
Georgia,Columbia County,12,8971,4276,4695
Georgia,Columbia County,13,7811,3721,4090
Georgia,Columbia County,14,6228,3043,3185
Georgia,Columbia County,15,4031,1947,2084
Georgia,Columbia County,16,2629,1160,1469
Georgia,Columbia County,17,1820,716,1104
Georgia,Columbia County,18,1707,540,1167
Georgia,Cook County,0,17214,8326,8888
Georgia,Cook County,1,1161,600,561
Georgia,Cook County,2,1391,695,696
Georgia,Cook County,3,1294,661,633
Georgia,Cook County,4,1141,559,582
Georgia,Cook County,5,991,486,505
Georgia,Cook County,6,1130,554,576
Georgia,Cook County,7,1046,506,540
Georgia,Cook County,8,1098,519,579
Georgia,Cook County,9,1082,503,579
Georgia,Cook County,10,1165,549,616
Georgia,Cook County,11,1120,565,555
Georgia,Cook County,12,1073,511,562
Georgia,Cook County,13,984,469,515
Georgia,Cook County,14,860,426,434
Georgia,Cook County,15,655,319,336
Georgia,Cook County,16,472,198,274
Georgia,Cook County,17,303,125,178
Georgia,Cook County,18,248,81,167
Georgia,Coweta County,0,135571,66218,69353
Georgia,Coweta County,1,8394,4275,4119
Georgia,Coweta County,2,9831,4998,4833
Georgia,Coweta County,3,10402,5223,5179
Georgia,Coweta County,4,9346,4753,4593
Georgia,Coweta County,5,8204,4216,3988
Georgia,Coweta County,6,7965,3903,4062
Georgia,Coweta County,7,8639,4133,4506
Georgia,Coweta County,8,9068,4377,4691
Georgia,Coweta County,9,10246,4882,5364
Georgia,Coweta County,10,10439,5174,5265
Georgia,Coweta County,11,10116,4993,5123
Georgia,Coweta County,12,8903,4353,4550
Georgia,Coweta County,13,7200,3426,3774
Georgia,Coweta County,14,6366,2966,3400
Georgia,Coweta County,15,4415,2049,2366
Georgia,Coweta County,16,2804,1276,1528
Georgia,Coweta County,17,1748,729,1019
Georgia,Coweta County,18,1485,492,993
Georgia,Crawford County,0,12387,6269,6118
Georgia,Crawford County,1,615,343,272
Georgia,Crawford County,2,757,359,398
Georgia,Crawford County,3,780,432,348
Georgia,Crawford County,4,726,410,316
Georgia,Crawford County,5,735,385,350
Georgia,Crawford County,6,732,388,344
Georgia,Crawford County,7,645,322,323
Georgia,Crawford County,8,641,322,319
Georgia,Crawford County,9,786,398,388
Georgia,Crawford County,10,912,452,460
Georgia,Crawford County,11,1160,587,573
Georgia,Crawford County,12,967,475,492
Georgia,Crawford County,13,842,414,428
Georgia,Crawford County,14,792,365,427
Georgia,Crawford County,15,575,291,284
Georgia,Crawford County,16,390,181,209
Georgia,Crawford County,17,206,102,104
Georgia,Crawford County,18,126,43,83
Georgia,Crisp County,0,22934,10922,12012
Georgia,Crisp County,1,1561,778,783
Georgia,Crisp County,2,1599,833,766
Georgia,Crisp County,3,1589,801,788
Georgia,Crisp County,4,1495,772,723
Georgia,Crisp County,5,1505,768,737
Georgia,Crisp County,6,1377,662,715
Georgia,Crisp County,7,1393,673,720
Georgia,Crisp County,8,1277,572,705
Georgia,Crisp County,9,1315,612,703
Georgia,Crisp County,10,1398,652,746
Georgia,Crisp County,11,1586,767,819
Georgia,Crisp County,12,1615,748,867
Georgia,Crisp County,13,1555,736,819
Georgia,Crisp County,14,1277,616,661
Georgia,Crisp County,15,815,365,450
Georgia,Crisp County,16,631,253,378
Georgia,Crisp County,17,477,176,301
Georgia,Crisp County,18,469,138,331
Georgia,Dade County,0,16389,8068,8321
Georgia,Dade County,1,884,451,433
Georgia,Dade County,2,873,448,425
Georgia,Dade County,3,902,457,445
Georgia,Dade County,4,1233,621,612
Georgia,Dade County,5,1449,729,720
Georgia,Dade County,6,930,487,443
Georgia,Dade County,7,881,425,456
Georgia,Dade County,8,876,447,429
Georgia,Dade County,9,1022,518,504
Georgia,Dade County,10,1029,539,490
Georgia,Dade County,11,1162,540,622
Georgia,Dade County,12,1252,600,652
Georgia,Dade County,13,1110,534,576
Georgia,Dade County,14,935,433,502
Georgia,Dade County,15,728,364,364
Georgia,Dade County,16,520,222,298
Georgia,Dade County,17,343,160,183
Georgia,Dade County,18,260,93,167
Georgia,Dawson County,0,22957,11499,11458
Georgia,Dawson County,1,1177,625,552
Georgia,Dawson County,2,1359,721,638
Georgia,Dawson County,3,1521,758,763
Georgia,Dawson County,4,1404,745,659
Georgia,Dawson County,5,1278,650,628
Georgia,Dawson County,6,1301,643,658
Georgia,Dawson County,7,1264,644,620
Georgia,Dawson County,8,1306,694,612
Georgia,Dawson County,9,1552,777,775
Georgia,Dawson County,10,1622,811,811
Georgia,Dawson County,11,1808,870,938
Georgia,Dawson County,12,1653,803,850
Georgia,Dawson County,13,1596,754,842
Georgia,Dawson County,14,1631,811,820
Georgia,Dawson County,15,1189,568,621
Georgia,Dawson County,16,661,331,330
Georgia,Dawson County,17,418,213,205
Georgia,Dawson County,18,217,81,136
Georgia,Decatur County,0,27220,13238,13982
Georgia,Decatur County,1,1879,996,883
Georgia,Decatur County,2,1810,895,915
Georgia,Decatur County,3,1880,966,914
Georgia,Decatur County,4,1848,939,909
Georgia,Decatur County,5,1897,1008,889
Georgia,Decatur County,6,1625,832,793
Georgia,Decatur County,7,1641,773,868
Georgia,Decatur County,8,1575,792,783
Georgia,Decatur County,9,1709,819,890
Georgia,Decatur County,10,1816,891,925
Georgia,Decatur County,11,1916,959,957
Georgia,Decatur County,12,1845,882,963
Georgia,Decatur County,13,1575,740,835
Georgia,Decatur County,14,1321,618,703
Georgia,Decatur County,15,1052,474,578
Georgia,Decatur County,16,790,317,473
Georgia,Decatur County,17,535,189,346
Georgia,Decatur County,18,506,148,358
Georgia,DeKalb County,0,722161,343192,378969
Georgia,DeKalb County,1,53027,27176,25851
Georgia,DeKalb County,2,48683,24817,23866
Georgia,DeKalb County,3,44351,22458,21893
Georgia,DeKalb County,4,41967,21172,20795
Georgia,DeKalb County,5,49435,24115,25320
Georgia,DeKalb County,6,59901,28636,31265
Georgia,DeKalb County,7,60243,28738,31505
Georgia,DeKalb County,8,54319,26129,28190
Georgia,DeKalb County,9,53657,25852,27805
Georgia,DeKalb County,10,49481,23514,25967
Georgia,DeKalb County,11,49312,23096,26216
Georgia,DeKalb County,12,44536,20080,24456
Georgia,DeKalb County,13,38505,16901,21604
Georgia,DeKalb County,14,28230,12303,15927
Georgia,DeKalb County,15,17737,7715,10022
Georgia,DeKalb County,16,11675,4731,6944
Georgia,DeKalb County,17,8282,3030,5252
Georgia,DeKalb County,18,8820,2729,6091
Georgia,Dodge County,0,20976,10948,10028
Georgia,Dodge County,1,1287,657,630
Georgia,Dodge County,2,1210,587,623
Georgia,Dodge County,3,1147,599,548
Georgia,Dodge County,4,1283,741,542
Georgia,Dodge County,5,1527,883,644
Georgia,Dodge County,6,1339,772,567
Georgia,Dodge County,7,1351,754,597
Georgia,Dodge County,8,1242,700,542
Georgia,Dodge County,9,1519,798,721
Georgia,Dodge County,10,1575,864,711
Georgia,Dodge County,11,1532,822,710
Georgia,Dodge County,12,1482,761,721
Georgia,Dodge County,13,1296,621,675
Georgia,Dodge County,14,1111,563,548
Georgia,Dodge County,15,759,320,439
Georgia,Dodge County,16,614,256,358
Georgia,Dodge County,17,401,147,254
Georgia,Dodge County,18,301,103,198
Georgia,Dooly County,0,14188,7668,6520
Georgia,Dooly County,1,672,351,321
Georgia,Dooly County,2,793,390,403
Georgia,Dooly County,3,835,372,463
Georgia,Dooly County,4,814,473,341
Georgia,Dooly County,5,914,547,367
Georgia,Dooly County,6,854,575,279
Georgia,Dooly County,7,1023,596,427
Georgia,Dooly County,8,919,544,375
Georgia,Dooly County,9,994,588,406
Georgia,Dooly County,10,1043,622,421
Georgia,Dooly County,11,1012,508,504
Georgia,Dooly County,12,1120,603,517
Georgia,Dooly County,13,972,488,484
Georgia,Dooly County,14,822,391,431
Georgia,Dooly County,15,592,294,298
Georgia,Dooly County,16,361,155,206
Georgia,Dooly County,17,237,107,130
Georgia,Dooly County,18,211,64,147
Georgia,Dougherty County,0,92407,42975,49432
Georgia,Dougherty County,1,6841,3489,3352
Georgia,Dougherty County,2,6379,3311,3068
Georgia,Dougherty County,3,6237,3185,3052
Georgia,Dougherty County,4,6821,3254,3567
Georgia,Dougherty County,5,8091,3902,4189
Georgia,Dougherty County,6,6591,3111,3480
Georgia,Dougherty County,7,5974,2691,3283
Georgia,Dougherty County,8,5349,2432,2917
Georgia,Dougherty County,9,5218,2476,2742
Georgia,Dougherty County,10,5310,2418,2892
Georgia,Dougherty County,11,5767,2549,3218
Georgia,Dougherty County,12,5756,2572,3184
Georgia,Dougherty County,13,5546,2498,3048
Georgia,Dougherty County,14,4304,1941,2363
Georgia,Dougherty County,15,2871,1234,1637
Georgia,Dougherty County,16,2135,867,1268
Georgia,Dougherty County,17,1585,565,1020
Georgia,Dougherty County,18,1632,480,1152
Georgia,Douglas County,0,138776,66521,72255
Georgia,Douglas County,1,9182,4690,4492
Georgia,Douglas County,2,10416,5375,5041
Georgia,Douglas County,3,11113,5674,5439
Georgia,Douglas County,4,10222,5297,4925
Georgia,Douglas County,5,9345,4672,4673
Georgia,Douglas County,6,8110,3889,4221
Georgia,Douglas County,7,8913,4095,4818
Georgia,Douglas County,8,9643,4344,5299
Georgia,Douglas County,9,11251,5128,6123
Georgia,Douglas County,10,10626,4953,5673
Georgia,Douglas County,11,10064,4819,5245
Georgia,Douglas County,12,8673,4258,4415
Georgia,Douglas County,13,6931,3100,3831
Georgia,Douglas County,14,5541,2591,2950
Georgia,Douglas County,15,3854,1752,2102
Georgia,Douglas County,16,2308,984,1324
Georgia,Douglas County,17,1364,515,849
Georgia,Douglas County,18,1220,385,835
Georgia,Early County,0,10491,4956,5535
Georgia,Early County,1,691,359,332
Georgia,Early County,2,731,367,364
Georgia,Early County,3,770,405,365
Georgia,Early County,4,698,341,357
Georgia,Early County,5,666,325,341
Georgia,Early County,6,544,270,274
Georgia,Early County,7,530,248,282
Georgia,Early County,8,574,251,323
Georgia,Early County,9,638,295,343
Georgia,Early County,10,678,331,347
Georgia,Early County,11,711,326,385
Georgia,Early County,12,713,334,379
Georgia,Early County,13,618,308,310
Georgia,Early County,14,613,273,340
Georgia,Early County,15,511,222,289
Georgia,Early County,16,338,143,195
Georgia,Early County,17,234,89,145
Georgia,Early County,18,233,69,164
Georgia,Echols County,0,4003,1974,2029
Georgia,Echols County,1,351,182,169
Georgia,Echols County,2,316,145,171
Georgia,Echols County,3,290,145,145
Georgia,Echols County,4,240,122,118
Georgia,Echols County,5,252,120,132
Georgia,Echols County,6,308,150,158
Georgia,Echols County,7,261,127,134
Georgia,Echols County,8,279,141,138
Georgia,Echols County,9,290,152,138
Georgia,Echols County,10,250,125,125
Georgia,Echols County,11,267,138,129
Georgia,Echols County,12,232,119,113
Georgia,Echols County,13,215,103,112
Georgia,Echols County,14,149,72,77
Georgia,Echols County,15,102,43,59
Georgia,Echols County,16,95,41,54
Georgia,Echols County,17,75,32,43
Georgia,Echols County,18,31,17,14
Georgia,Effingham County,0,55423,27638,27785
Georgia,Effingham County,1,3680,1913,1767
Georgia,Effingham County,2,4136,2165,1971
Georgia,Effingham County,3,4402,2199,2203
Georgia,Effingham County,4,4047,2132,1915
Georgia,Effingham County,5,3583,1814,1769
Georgia,Effingham County,6,3414,1753,1661
Georgia,Effingham County,7,3702,1816,1886
Georgia,Effingham County,8,3789,1846,1943
Georgia,Effingham County,9,4104,2033,2071
Georgia,Effingham County,10,3941,1939,2002
Georgia,Effingham County,11,4130,2005,2125
Georgia,Effingham County,12,3662,1842,1820
Georgia,Effingham County,13,2825,1378,1447
Georgia,Effingham County,14,2326,1135,1191
Georgia,Effingham County,15,1627,775,852
Georgia,Effingham County,16,972,469,503
Georgia,Effingham County,17,599,268,331
Georgia,Effingham County,18,484,156,328
Georgia,Elbert County,0,19438,9306,10132
Georgia,Elbert County,1,1165,574,591
Georgia,Elbert County,2,1211,580,631
Georgia,Elbert County,3,1174,591,583
Georgia,Elbert County,4,1136,571,565
Georgia,Elbert County,5,1247,649,598
Georgia,Elbert County,6,1140,581,559
Georgia,Elbert County,7,1087,556,531
Georgia,Elbert County,8,1049,506,543
Georgia,Elbert County,9,1113,516,597
Georgia,Elbert County,10,1278,609,669
Georgia,Elbert County,11,1455,696,759
Georgia,Elbert County,12,1397,665,732
Georgia,Elbert County,13,1275,614,661
Georgia,Elbert County,14,1215,591,624
Georgia,Elbert County,15,894,404,490
Georgia,Elbert County,16,665,277,388
Georgia,Elbert County,17,512,195,317
Georgia,Elbert County,18,425,131,294
Georgia,Emanuel County,0,22755,11138,11617
Georgia,Emanuel County,1,1580,792,788
Georgia,Emanuel County,2,1692,853,839
Georgia,Emanuel County,3,1502,764,738
Georgia,Emanuel County,4,1449,768,681
Georgia,Emanuel County,5,1568,816,752
Georgia,Emanuel County,6,1520,784,736
Georgia,Emanuel County,7,1490,765,725
Georgia,Emanuel County,8,1364,713,651
Georgia,Emanuel County,9,1275,630,645
Georgia,Emanuel County,10,1366,646,720
Georgia,Emanuel County,11,1537,773,764
Georgia,Emanuel County,12,1465,676,789
Georgia,Emanuel County,13,1343,620,723
Georgia,Emanuel County,14,1252,579,673
Georgia,Emanuel County,15,895,410,485
Georgia,Emanuel County,16,676,260,416
Georgia,Emanuel County,17,442,196,246
Georgia,Emanuel County,18,339,93,246
Georgia,Evans County,0,10898,5269,5629
Georgia,Evans County,1,835,420,415
Georgia,Evans County,2,841,411,430
Georgia,Evans County,3,807,410,397
Georgia,Evans County,4,624,331,293
Georgia,Evans County,5,720,374,346
Georgia,Evans County,6,729,369,360
Georgia,Evans County,7,728,343,385
Georgia,Evans County,8,652,319,333
Georgia,Evans County,9,640,320,320
Georgia,Evans County,10,676,330,346
Georgia,Evans County,11,745,358,387
Georgia,Evans County,12,696,334,362
Georgia,Evans County,13,562,256,306
Georgia,Evans County,14,501,237,264
Georgia,Evans County,15,425,171,254
Georgia,Evans County,16,329,143,186
Georgia,Evans County,17,230,89,141
Georgia,Evans County,18,158,54,104
Georgia,Fannin County,0,23753,11608,12145
Georgia,Fannin County,1,1059,535,524
Georgia,Fannin County,2,1139,596,543
Georgia,Fannin County,3,1259,622,637
Georgia,Fannin County,4,1162,604,558
Georgia,Fannin County,5,1098,566,532
Georgia,Fannin County,6,1059,502,557
Georgia,Fannin County,7,1014,481,533
Georgia,Fannin County,8,1108,581,527
Georgia,Fannin County,9,1304,632,672
Georgia,Fannin County,10,1385,658,727
Georgia,Fannin County,11,1808,847,961
Georgia,Fannin County,12,2072,1025,1047
Georgia,Fannin County,13,2204,1012,1192
Georgia,Fannin County,14,2135,1058,1077
Georgia,Fannin County,15,1593,788,805
Georgia,Fannin County,16,1091,547,544
Georgia,Fannin County,17,719,326,393
Georgia,Fannin County,18,544,228,316
Georgia,Fayette County,0,109664,53089,56575
Georgia,Fayette County,1,4490,2338,2152
Georgia,Fayette County,2,6707,3410,3297
Georgia,Fayette County,3,9004,4557,4447
Georgia,Fayette County,4,9187,4774,4413
Georgia,Fayette County,5,6670,3443,3227
Georgia,Fayette County,6,4295,2202,2093
Georgia,Fayette County,7,4409,2063,2346
Georgia,Fayette County,8,5388,2544,2844
Georgia,Fayette County,9,7215,3286,3929
Georgia,Fayette County,10,8618,4008,4610
Georgia,Fayette County,11,9573,4585,4988
Georgia,Fayette County,12,8975,4372,4603
Georgia,Fayette County,13,7406,3512,3894
Georgia,Fayette County,14,6561,3204,3357
Georgia,Fayette County,15,4417,2080,2337
Georgia,Fayette County,16,2851,1316,1535
Georgia,Fayette County,17,1864,770,1094
Georgia,Fayette County,18,2034,625,1409
Georgia,Floyd County,0,96063,46576,49487
Georgia,Floyd County,1,5903,3007,2896
Georgia,Floyd County,2,6460,3313,3147
Georgia,Floyd County,3,6359,3217,3142
Georgia,Floyd County,4,7030,3323,3707
Georgia,Floyd County,5,6904,3323,3581
Georgia,Floyd County,6,6037,3128,2909
Georgia,Floyd County,7,5872,2877,2995
Georgia,Floyd County,8,5778,2962,2816
Georgia,Floyd County,9,6136,3061,3075
Georgia,Floyd County,10,6052,3013,3039
Georgia,Floyd County,11,6590,3166,3424
Georgia,Floyd County,12,6206,2991,3215
Georgia,Floyd County,13,5697,2733,2964
Georgia,Floyd County,14,4848,2299,2549
Georgia,Floyd County,15,3671,1651,2020
Georgia,Floyd County,16,2705,1135,1570
Georgia,Floyd County,17,1952,770,1182
Georgia,Floyd County,18,1863,607,1256
Georgia,Forsyth County,0,204302,101584,102718
Georgia,Forsyth County,1,12731,6528,6203
Georgia,Forsyth County,2,17184,8890,8294
Georgia,Forsyth County,3,18718,9564,9154
Georgia,Forsyth County,4,14954,7722,7232
Georgia,Forsyth County,5,9415,4911,4504
Georgia,Forsyth County,6,8472,4238,4234
Georgia,Forsyth County,7,11889,5548,6341
Georgia,Forsyth County,8,15126,7198,7928
Georgia,Forsyth County,9,18872,9568,9304
Georgia,Forsyth County,10,17885,8964,8921
Georgia,Forsyth County,11,15703,7975,7728
Georgia,Forsyth County,12,11506,5816,5690
Georgia,Forsyth County,13,9135,4378,4757
Georgia,Forsyth County,14,8415,3966,4449
Georgia,Forsyth County,15,6139,2847,3292
Georgia,Forsyth County,16,3910,1799,2111
Georgia,Forsyth County,17,2357,1025,1332
Georgia,Forsyth County,18,1891,647,1244
Georgia,Franklin County,0,22264,10866,11398
Georgia,Franklin County,1,1270,608,662
Georgia,Franklin County,2,1346,663,683
Georgia,Franklin County,3,1424,742,682
Georgia,Franklin County,4,1490,763,727
Georgia,Franklin County,5,1554,787,767
Georgia,Franklin County,6,1316,673,643
Georgia,Franklin County,7,1164,586,578
Georgia,Franklin County,8,1222,607,615
Georgia,Franklin County,9,1340,662,678
Georgia,Franklin County,10,1407,711,696
Georgia,Franklin County,11,1591,796,795
Georgia,Franklin County,12,1534,764,770
Georgia,Franklin County,13,1432,696,736
Georgia,Franklin County,14,1344,645,699
Georgia,Franklin County,15,1071,508,563
Georgia,Franklin County,16,786,337,449
Georgia,Franklin County,17,539,196,343
Georgia,Franklin County,18,434,122,312
Georgia,Fulton County,0,996319,483756,512563
Georgia,Fulton County,1,64047,32709,31338
Georgia,Fulton County,2,65017,32913,32104
Georgia,Fulton County,3,64752,32747,32005
Georgia,Fulton County,4,66556,33734,32822
Georgia,Fulton County,5,74926,37771,37155
Georgia,Fulton County,6,82431,40496,41935
Georgia,Fulton County,7,81200,39206,41994
Georgia,Fulton County,8,73243,35398,37845
Georgia,Fulton County,9,75062,36859,38203
Georgia,Fulton County,10,69902,35036,34866
Georgia,Fulton County,11,68182,33447,34735
Georgia,Fulton County,12,58784,28169,30615
Georgia,Fulton County,13,48269,22092,26177
Georgia,Fulton County,14,37853,17236,20617
Georgia,Fulton County,15,24568,10681,13887
Georgia,Fulton County,16,16740,6871,9869
Georgia,Fulton County,17,11301,4298,7003
Georgia,Fulton County,18,13486,4093,9393
Georgia,Gilmer County,0,28829,14384,14445
Georgia,Gilmer County,1,1522,739,783
Georgia,Gilmer County,2,1680,859,821
Georgia,Gilmer County,3,1662,823,839
Georgia,Gilmer County,4,1556,790,766
Georgia,Gilmer County,5,1510,810,700
Georgia,Gilmer County,6,1479,783,696
Georgia,Gilmer County,7,1476,746,730
Georgia,Gilmer County,8,1550,770,780
Georgia,Gilmer County,9,1674,847,827
Georgia,Gilmer County,10,1803,924,879
Georgia,Gilmer County,11,2086,1079,1007
Georgia,Gilmer County,12,2148,1013,1135
Georgia,Gilmer County,13,2338,1130,1208
Georgia,Gilmer County,14,2273,1142,1131
Georgia,Gilmer County,15,1751,889,862
Georgia,Gilmer County,16,1145,549,596
Georgia,Gilmer County,17,664,328,336
Georgia,Gilmer County,18,512,163,349
Georgia,Glascock County,0,3053,1494,1559
Georgia,Glascock County,1,147,76,71
Georgia,Glascock County,2,205,114,91
Georgia,Glascock County,3,225,119,106
Georgia,Glascock County,4,223,108,115
Georgia,Glascock County,5,177,92,85
Georgia,Glascock County,6,150,77,73
Georgia,Glascock County,7,150,68,82
Georgia,Glascock County,8,205,103,102
Georgia,Glascock County,9,218,108,110
Georgia,Glascock County,10,198,98,100
Georgia,Glascock County,11,223,115,108
Georgia,Glascock County,12,228,107,121
Georgia,Glascock County,13,174,82,92
Georgia,Glascock County,14,161,82,79
Georgia,Glascock County,15,139,63,76
Georgia,Glascock County,16,77,33,44
Georgia,Glascock County,17,72,27,45
Georgia,Glascock County,18,81,22,59
Georgia,Glynn County,0,82175,38877,43298
Georgia,Glynn County,1,5114,2584,2530
Georgia,Glynn County,2,5293,2626,2667
Georgia,Glynn County,3,5418,2744,2674
Georgia,Glynn County,4,4931,2591,2340
Georgia,Glynn County,5,5036,2430,2606
Georgia,Glynn County,6,4922,2296,2626
Georgia,Glynn County,7,4983,2317,2666
Georgia,Glynn County,8,4650,2178,2472
Georgia,Glynn County,9,5028,2410,2618
Georgia,Glynn County,10,5179,2455,2724
Georgia,Glynn County,11,5903,2744,3159
Georgia,Glynn County,12,5751,2663,3088
Georgia,Glynn County,13,5424,2413,3011
Georgia,Glynn County,14,5129,2364,2765
Georgia,Glynn County,15,3742,1717,2025
Georgia,Glynn County,16,2429,1104,1325
Georgia,Glynn County,17,1648,689,959
Georgia,Glynn County,18,1595,552,1043
Georgia,Gordon County,0,56047,27807,28240
Georgia,Gordon County,1,3666,1872,1794
Georgia,Gordon County,2,4025,2116,1909
Georgia,Gordon County,3,4114,2163,1951
Georgia,Gordon County,4,3873,2013,1860
Georgia,Gordon County,5,3614,1798,1816
Georgia,Gordon County,6,3455,1737,1718
Georgia,Gordon County,7,3673,1841,1832
Georgia,Gordon County,8,3518,1752,1766
Georgia,Gordon County,9,3985,1985,2000
Georgia,Gordon County,10,4064,2033,2031
Georgia,Gordon County,11,4022,2005,2017
Georgia,Gordon County,12,3474,1647,1827
Georgia,Gordon County,13,3094,1504,1590
Georgia,Gordon County,14,2628,1297,1331
Georgia,Gordon County,15,2001,922,1079
Georgia,Gordon County,16,1360,575,785
Georgia,Gordon County,17,805,329,476
Georgia,Gordon County,18,676,218,458
Georgia,Grady County,0,25359,12356,13003
Georgia,Grady County,1,1730,910,820
Georgia,Grady County,2,1902,985,917
Georgia,Grady County,3,1833,897,936
Georgia,Grady County,4,1619,832,787
Georgia,Grady County,5,1485,717,768
Georgia,Grady County,6,1598,799,799
Georgia,Grady County,7,1587,766,821
Georgia,Grady County,8,1376,687,689
Georgia,Grady County,9,1558,753,805
Georgia,Grady County,10,1619,779,840
Georgia,Grady County,11,1763,872,891
Georgia,Grady County,12,1700,826,874
Georgia,Grady County,13,1527,732,795
Georgia,Grady County,14,1376,653,723
Georgia,Grady County,15,1031,460,571
Georgia,Grady County,16,760,339,421
Georgia,Grady County,17,465,183,282
Georgia,Grady County,18,430,166,264
Georgia,Greene County,0,16490,8047,8443
Georgia,Greene County,1,888,452,436
Georgia,Greene County,2,875,459,416
Georgia,Greene County,3,901,452,449
Georgia,Greene County,4,774,409,365
Georgia,Greene County,5,846,430,416
Georgia,Greene County,6,804,403,401
Georgia,Greene County,7,836,402,434
Georgia,Greene County,8,842,409,433
Georgia,Greene County,9,795,363,432
Georgia,Greene County,10,917,479,438
Georgia,Greene County,11,1043,506,537
Georgia,Greene County,12,1253,566,687
Georgia,Greene County,13,1389,636,753
Georgia,Greene County,14,1636,797,839
Georgia,Greene County,15,1250,641,609
Georgia,Greene County,16,742,372,370
Georgia,Greene County,17,375,186,189
Georgia,Greene County,18,324,85,239
Georgia,Gwinnett County,0,877922,430015,447907
Georgia,Gwinnett County,1,60763,30705,30058
Georgia,Gwinnett County,2,69240,35397,33843
Georgia,Gwinnett County,3,72481,36865,35616
Georgia,Gwinnett County,4,64815,33220,31595
Georgia,Gwinnett County,5,57732,29826,27906
Georgia,Gwinnett County,6,56723,28443,28280
Georgia,Gwinnett County,7,61545,29904,31641
Georgia,Gwinnett County,8,63955,30523,33432
Georgia,Gwinnett County,9,70256,33809,36447
Georgia,Gwinnett County,10,67164,32550,34614
Georgia,Gwinnett County,11,64427,31353,33074
Georgia,Gwinnett County,12,53205,25715,27490
Georgia,Gwinnett County,13,40254,19041,21213
Georgia,Gwinnett County,14,29866,13788,16078
Georgia,Gwinnett County,15,19009,8620,10389
Georgia,Gwinnett County,16,11712,5017,6695
Georgia,Gwinnett County,17,7769,3011,4758
Georgia,Gwinnett County,18,7006,2228,4778
Georgia,Habersham County,0,43752,20731,23021
Georgia,Habersham County,1,2594,1301,1293
Georgia,Habersham County,2,2919,1432,1487
Georgia,Habersham County,3,2903,1484,1419
Georgia,Habersham County,4,2908,1455,1453
Georgia,Habersham County,5,2905,1424,1481
Georgia,Habersham County,6,2697,1250,1447
Georgia,Habersham County,7,2643,1205,1438
Georgia,Habersham County,8,2669,1176,1493
Georgia,Habersham County,9,2851,1328,1523
Georgia,Habersham County,10,2777,1273,1504
Georgia,Habersham County,11,2880,1402,1478
Georgia,Habersham County,12,2809,1297,1512
Georgia,Habersham County,13,2585,1209,1376
Georgia,Habersham County,14,2479,1239,1240
Georgia,Habersham County,15,1976,919,1057
Georgia,Habersham County,16,1405,635,770
Georgia,Habersham County,17,956,428,528
Georgia,Habersham County,18,796,274,522
Georgia,Hall County,0,190761,95225,95536
Georgia,Hall County,1,13132,6870,6262
Georgia,Hall County,2,14494,7440,7054
Georgia,Hall County,3,14630,7434,7196
Georgia,Hall County,4,13061,6898,6163
Georgia,Hall County,5,13156,6734,6422
Georgia,Hall County,6,12439,6474,5965
Georgia,Hall County,7,12281,6198,6083
Georgia,Hall County,8,12128,6053,6075
Georgia,Hall County,9,13145,6589,6556
Georgia,Hall County,10,12984,6565,6419
Georgia,Hall County,11,12602,6418,6184
Georgia,Hall County,12,11152,5470,5682
Georgia,Hall County,13,9567,4614,4953
Georgia,Hall County,14,8915,4158,4757
Georgia,Hall County,15,6611,3066,3545
Georgia,Hall County,16,4441,1955,2486
Georgia,Hall County,17,3142,1297,1845
Georgia,Hall County,18,2881,992,1889
Georgia,Hancock County,0,8509,4599,3910
Georgia,Hancock County,1,386,190,196
Georgia,Hancock County,2,386,195,191
Georgia,Hancock County,3,382,202,180
Georgia,Hancock County,4,428,225,203
Georgia,Hancock County,5,582,358,224
Georgia,Hancock County,6,579,400,179
Georgia,Hancock County,7,524,353,171
Georgia,Hancock County,8,463,286,177
Georgia,Hancock County,9,478,278,200
Georgia,Hancock County,10,575,333,242
Georgia,Hancock County,11,647,336,311
Georgia,Hancock County,12,691,335,356
Georgia,Hancock County,13,688,343,345
Georgia,Hancock County,14,576,276,300
Georgia,Hancock County,15,466,240,226
Georgia,Hancock County,16,270,120,150
Georgia,Hancock County,17,183,80,103
Georgia,Hancock County,18,205,49,156
Georgia,Haralson County,0,28641,13864,14777
Georgia,Haralson County,1,1677,851,826
Georgia,Haralson County,2,1914,938,976
Georgia,Haralson County,3,2086,1007,1079
Georgia,Haralson County,4,1925,968,957
Georgia,Haralson County,5,1764,906,858
Georgia,Haralson County,6,1781,903,878
Georgia,Haralson County,7,1654,766,888
Georgia,Haralson County,8,1636,795,841
Georgia,Haralson County,9,1960,967,993
Georgia,Haralson County,10,2074,1006,1068
Georgia,Haralson County,11,2076,1065,1011
Georgia,Haralson County,12,1885,940,945
Georgia,Haralson County,13,1640,758,882
Georgia,Haralson County,14,1549,743,806
Georgia,Haralson County,15,1226,559,667
Georgia,Haralson County,16,794,339,455
Georgia,Haralson County,17,545,221,324
Georgia,Haralson County,18,455,132,323
Georgia,Harris County,0,32876,16364,16512
Georgia,Harris County,1,1538,778,760
Georgia,Harris County,2,2002,1040,962
Georgia,Harris County,3,2310,1213,1097
Georgia,Harris County,4,2180,1143,1037
Georgia,Harris County,5,1862,987,875
Georgia,Harris County,6,1521,795,726
Georgia,Harris County,7,1610,788,822
Georgia,Harris County,8,1876,946,930
Georgia,Harris County,9,2354,1205,1149
Georgia,Harris County,10,2457,1156,1301
Georgia,Harris County,11,2718,1342,1376
Georgia,Harris County,12,2531,1238,1293
Georgia,Harris County,13,2442,1188,1254
Georgia,Harris County,14,2125,1055,1070
Georgia,Harris County,15,1455,720,735
Georgia,Harris County,16,844,401,443
Georgia,Harris County,17,524,217,307
Georgia,Harris County,18,527,152,375
Georgia,Hart County,0,25377,12581,12796
Georgia,Hart County,1,1395,726,669
Georgia,Hart County,2,1549,801,748
Georgia,Hart County,3,1555,811,744
Georgia,Hart County,4,1481,793,688
Georgia,Hart County,5,1535,838,697
Georgia,Hart County,6,1373,704,669
Georgia,Hart County,7,1344,672,672
Georgia,Hart County,8,1307,657,650
Georgia,Hart County,9,1524,765,759
Georgia,Hart County,10,1692,816,876
Georgia,Hart County,11,1823,900,923
Georgia,Hart County,12,1846,929,917
Georgia,Hart County,13,1714,811,903
Georgia,Hart County,14,1694,837,857
Georgia,Hart County,15,1379,622,757
Georgia,Hart County,16,996,447,549
Georgia,Hart County,17,650,281,369
Georgia,Hart County,18,520,171,349
Georgia,Heard County,0,11603,5786,5817
Georgia,Heard County,1,667,341,326
Georgia,Heard County,2,746,375,371
Georgia,Heard County,3,783,407,376
Georgia,Heard County,4,808,426,382
Georgia,Heard County,5,748,390,358
Georgia,Heard County,6,641,318,323
Georgia,Heard County,7,618,316,302
Georgia,Heard County,8,639,326,313
Georgia,Heard County,9,825,396,429
Georgia,Heard County,10,836,442,394
Georgia,Heard County,11,889,426,463
Georgia,Heard County,12,809,406,403
Georgia,Heard County,13,772,379,393
Georgia,Heard County,14,679,321,358
Georgia,Heard County,15,485,254,231
Georgia,Heard County,16,288,118,170
Georgia,Heard County,17,202,86,116
Georgia,Heard County,18,168,59,109
Georgia,Henry County,0,213869,102305,111564
Georgia,Henry County,1,12583,6379,6204
Georgia,Henry County,2,15599,8036,7563
Georgia,Henry County,3,18114,9231,8883
Georgia,Henry County,4,17533,8994,8539
Georgia,Henry County,5,14360,7186,7174
Georgia,Henry County,6,12015,5732,6283
Georgia,Henry County,7,12699,5664,7035
Georgia,Henry County,8,14357,6454,7903
Georgia,Henry County,9,17383,7849,9534
Georgia,Henry County,10,16940,8084,8856
Georgia,Henry County,11,16377,7861,8516
Georgia,Henry County,12,13146,6296,6850
Georgia,Henry County,13,10418,4786,5632
Georgia,Henry County,14,8596,3889,4707
Georgia,Henry County,15,5988,2742,3246
Georgia,Henry County,16,3673,1565,2108
Georgia,Henry County,17,2345,1002,1343
Georgia,Henry County,18,1743,555,1188
Georgia,Houston County,0,149111,72678,76433
Georgia,Houston County,1,10352,5222,5130
Georgia,Houston County,2,10784,5498,5286
Georgia,Houston County,3,10831,5568,5263
Georgia,Houston County,4,10030,5256,4774
Georgia,Houston County,5,10710,5684,5026
Georgia,Houston County,6,11144,5496,5648
Georgia,Houston County,7,10926,5238,5688
Georgia,Houston County,8,9442,4429,5013
Georgia,Houston County,9,9629,4572,5057
Georgia,Houston County,10,9760,4641,5119
Georgia,Houston County,11,11247,5506,5741
Georgia,Houston County,12,9391,4534,4857
Georgia,Houston County,13,7370,3452,3918
Georgia,Houston County,14,5968,2802,3166
Georgia,Houston County,15,4247,1884,2363
Georgia,Houston County,16,3442,1447,1995
Georgia,Houston County,17,2180,940,1240
Georgia,Houston County,18,1658,509,1149
Georgia,Irwin County,0,9104,4626,4478
Georgia,Irwin County,1,522,283,239
Georgia,Irwin County,2,593,324,269
Georgia,Irwin County,3,611,311,300
Georgia,Irwin County,4,483,246,237
Georgia,Irwin County,5,629,362,267
Georgia,Irwin County,6,547,313,234
Georgia,Irwin County,7,578,306,272
Georgia,Irwin County,8,547,285,262
Georgia,Irwin County,9,605,320,285
Georgia,Irwin County,10,612,332,280
Georgia,Irwin County,11,633,312,321
Georgia,Irwin County,12,568,280,288
Georgia,Irwin County,13,519,245,274
Georgia,Irwin County,14,512,235,277
Georgia,Irwin County,15,427,192,235
Georgia,Irwin County,16,314,149,165
Georgia,Irwin County,17,196,62,134
Georgia,Irwin County,18,208,69,139
Georgia,Jackson County,0,61870,30711,31159
Georgia,Jackson County,1,4102,2183,1919
Georgia,Jackson County,2,4469,2302,2167
Georgia,Jackson County,3,4719,2391,2328
Georgia,Jackson County,4,3936,2033,1903
Georgia,Jackson County,5,3652,1839,1813
Georgia,Jackson County,6,3555,1821,1734
Georgia,Jackson County,7,4003,1991,2012
Georgia,Jackson County,8,4206,2067,2139
Georgia,Jackson County,9,4539,2296,2243
Georgia,Jackson County,10,4540,2303,2237
Georgia,Jackson County,11,4416,2202,2214
Georgia,Jackson County,12,3959,1972,1987
Georgia,Jackson County,13,3404,1598,1806
Georgia,Jackson County,14,3117,1474,1643
Georgia,Jackson County,15,2278,1046,1232
Georgia,Jackson County,16,1434,651,783
Georgia,Jackson County,17,836,331,505
Georgia,Jackson County,18,705,211,494
Georgia,Jasper County,0,13432,6544,6888
Georgia,Jasper County,1,801,395,406
Georgia,Jasper County,2,909,478,431
Georgia,Jasper County,3,974,495,479
Georgia,Jasper County,4,826,424,402
Georgia,Jasper County,5,758,366,392
Georgia,Jasper County,6,803,402,401
Georgia,Jasper County,7,779,376,403
Georgia,Jasper County,8,747,364,383
Georgia,Jasper County,9,890,418,472
Georgia,Jasper County,10,919,473,446
Georgia,Jasper County,11,1036,496,540
Georgia,Jasper County,12,995,478,517
Georgia,Jasper County,13,908,437,471
Georgia,Jasper County,14,780,369,411
Georgia,Jasper County,15,538,253,285
Georgia,Jasper County,16,334,147,187
Georgia,Jasper County,17,242,105,137
Georgia,Jasper County,18,193,68,125
Georgia,Jeff Davis County,0,14859,7358,7501
Georgia,Jeff Davis County,1,1106,535,571
Georgia,Jeff Davis County,2,1161,607,554
Georgia,Jeff Davis County,3,1145,584,561
Georgia,Jeff Davis County,4,981,522,459
Georgia,Jeff Davis County,5,884,429,455
Georgia,Jeff Davis County,6,934,485,449
Georgia,Jeff Davis County,7,903,439,464
Georgia,Jeff Davis County,8,908,443,465
Georgia,Jeff Davis County,9,963,481,482
Georgia,Jeff Davis County,10,970,497,473
Georgia,Jeff Davis County,11,983,493,490
Georgia,Jeff Davis County,12,956,480,476
Georgia,Jeff Davis County,13,852,386,466
Georgia,Jeff Davis County,14,770,393,377
Georgia,Jeff Davis County,15,526,240,286
Georgia,Jeff Davis County,16,415,183,232
Georgia,Jeff Davis County,17,226,91,135
Georgia,Jeff Davis County,18,176,70,106
Georgia,Jefferson County,0,16272,7909,8363
Georgia,Jefferson County,1,1021,523,498
Georgia,Jefferson County,2,1067,555,512
Georgia,Jefferson County,3,1192,624,568
Georgia,Jefferson County,4,1000,516,484
Georgia,Jefferson County,5,1066,574,492
Georgia,Jefferson County,6,954,492,462
Georgia,Jefferson County,7,945,472,473
Georgia,Jefferson County,8,868,440,428
Georgia,Jefferson County,9,1008,516,492
Georgia,Jefferson County,10,1049,490,559
Georgia,Jefferson County,11,1151,556,595
Georgia,Jefferson County,12,1087,478,609
Georgia,Jefferson County,13,1096,539,557
Georgia,Jefferson County,14,904,412,492
Georgia,Jefferson County,15,723,309,414
Georgia,Jefferson County,16,479,191,288
Georgia,Jefferson County,17,315,122,193
Georgia,Jefferson County,18,347,100,247
Georgia,Jenkins County,0,9125,4853,4272
Georgia,Jenkins County,1,518,253,265
Georgia,Jenkins County,2,580,286,294
Georgia,Jenkins County,3,584,311,273
Georgia,Jenkins County,4,590,342,248
Georgia,Jenkins County,5,691,419,272
Georgia,Jenkins County,6,636,393,243
Georgia,Jenkins County,7,581,342,239
Georgia,Jenkins County,8,585,334,251
Georgia,Jenkins County,9,602,352,250
Georgia,Jenkins County,10,565,324,241
Georgia,Jenkins County,11,682,373,309
Georgia,Jenkins County,12,559,278,281
Georgia,Jenkins County,13,556,262,294
Georgia,Jenkins County,14,499,243,256
Georgia,Jenkins County,15,355,171,184
Georgia,Jenkins County,16,204,75,129
Georgia,Jenkins County,17,158,48,110
Georgia,Jenkins County,18,180,47,133
Georgia,Johnson County,0,9701,5477,4224
Georgia,Johnson County,1,433,218,215
Georgia,Johnson County,2,537,288,249
Georgia,Johnson County,3,584,287,297
Georgia,Johnson County,4,543,266,277
Georgia,Johnson County,5,594,366,228
Georgia,Johnson County,6,662,409,253
Georgia,Johnson County,7,658,436,222
Georgia,Johnson County,8,672,417,255
Georgia,Johnson County,9,710,463,247
Georgia,Johnson County,10,714,456,258
Georgia,Johnson County,11,769,473,296
Georgia,Johnson County,12,732,392,340
Georgia,Johnson County,13,586,321,265
Georgia,Johnson County,14,526,252,274
Georgia,Johnson County,15,382,199,183
Georgia,Johnson County,16,238,104,134
Georgia,Johnson County,17,181,71,110
Georgia,Johnson County,18,180,59,121
Georgia,Jones County,0,28787,13934,14853
Georgia,Jones County,1,1507,753,754
Georgia,Jones County,2,2029,1006,1023
Georgia,Jones County,3,2202,1111,1091
Georgia,Jones County,4,1978,1006,972
Georgia,Jones County,5,1735,884,851
Georgia,Jones County,6,1502,733,769
Georgia,Jones County,7,1740,842,898
Georgia,Jones County,8,1694,819,875
Georgia,Jones County,9,1995,916,1079
Georgia,Jones County,10,1974,1002,972
Georgia,Jones County,11,2200,1097,1103
Georgia,Jones County,12,2016,969,1047
Georgia,Jones County,13,1788,831,957
Georgia,Jones County,14,1557,737,820
Georgia,Jones County,15,1163,536,627
Georgia,Jones County,16,817,366,451
Georgia,Jones County,17,467,206,261
Georgia,Jones County,18,423,120,303
Georgia,Lamar County,0,18207,8681,9526
Georgia,Lamar County,1,1004,513,491
Georgia,Lamar County,2,1037,545,492
Georgia,Lamar County,3,1111,548,563
Georgia,Lamar County,4,1748,772,976
Georgia,Lamar County,5,1634,721,913
Georgia,Lamar County,6,1048,530,518
Georgia,Lamar County,7,992,464,528
Georgia,Lamar County,8,951,451,500
Georgia,Lamar County,9,1097,552,545
Georgia,Lamar County,10,1123,571,552
Georgia,Lamar County,11,1185,577,608
Georgia,Lamar County,12,1205,595,610
Georgia,Lamar County,13,1155,528,627
Georgia,Lamar County,14,1039,471,568
Georgia,Lamar County,15,742,364,378
Georgia,Lamar County,16,512,223,289
Georgia,Lamar County,17,348,160,188
Georgia,Lamar County,18,276,96,180
Georgia,Lanier County,0,10373,5224,5149
Georgia,Lanier County,1,810,381,429
Georgia,Lanier County,2,824,418,406
Georgia,Lanier County,3,667,356,311
Georgia,Lanier County,4,551,294,257
Georgia,Lanier County,5,693,372,321
Georgia,Lanier County,6,891,425,466
Georgia,Lanier County,7,836,418,418
Georgia,Lanier County,8,691,363,328
Georgia,Lanier County,9,663,343,320
Georgia,Lanier County,10,646,320,326
Georgia,Lanier County,11,689,365,324
Georgia,Lanier County,12,647,294,353
Georgia,Lanier County,13,510,259,251
Georgia,Lanier County,14,462,235,227
Georgia,Lanier County,15,310,136,174
Georgia,Lanier County,16,223,116,107
Georgia,Lanier County,17,157,73,84
Georgia,Lanier County,18,103,56,47
Georgia,Laurens County,0,47851,22767,25084
Georgia,Laurens County,1,3209,1624,1585
Georgia,Laurens County,2,3306,1663,1643
Georgia,Laurens County,3,3395,1695,1700
Georgia,Laurens County,4,3059,1562,1497
Georgia,Laurens County,5,3126,1558,1568
Georgia,Laurens County,6,2757,1301,1456
Georgia,Laurens County,7,2845,1309,1536
Georgia,Laurens County,8,2861,1350,1511
Georgia,Laurens County,9,2992,1461,1531
Georgia,Laurens County,10,3159,1498,1661
Georgia,Laurens County,11,3272,1588,1684
Georgia,Laurens County,12,3196,1561,1635
Georgia,Laurens County,13,2899,1345,1554
Georgia,Laurens County,14,2525,1127,1398
Georgia,Laurens County,15,1960,899,1061
Georgia,Laurens County,16,1381,587,794
Georgia,Laurens County,17,978,384,594
Georgia,Laurens County,18,931,255,676
Georgia,Lee County,0,29191,14655,14536
Georgia,Lee County,1,1863,952,911
Georgia,Lee County,2,2193,1121,1072
Georgia,Lee County,3,2330,1211,1119
Georgia,Lee County,4,2153,1119,1034
Georgia,Lee County,5,1725,877,848
Georgia,Lee County,6,1702,865,837
Georgia,Lee County,7,2039,998,1041
Georgia,Lee County,8,2035,1038,997
Georgia,Lee County,9,2359,1196,1163
Georgia,Lee County,10,2080,1072,1008
Georgia,Lee County,11,1985,950,1035
Georgia,Lee County,12,1981,1002,979
Georgia,Lee County,13,1613,797,816
Georgia,Lee County,14,1341,686,655
Georgia,Lee County,15,753,368,385
Georgia,Lee County,16,501,225,276
Georgia,Lee County,17,282,114,168
Georgia,Lee County,18,256,64,192
Georgia,Liberty County,0,65198,33370,31828
Georgia,Liberty County,1,7215,3729,3486
Georgia,Liberty County,2,5269,2645,2624
Georgia,Liberty County,3,4117,2086,2031
Georgia,Liberty County,4,3813,2082,1731
Georgia,Liberty County,5,8301,4908,3393
Georgia,Liberty County,6,7440,4031,3409
Georgia,Liberty County,7,5350,2739,2611
Georgia,Liberty County,8,3643,1879,1764
Georgia,Liberty County,9,3296,1632,1664
Georgia,Liberty County,10,3022,1387,1635
Georgia,Liberty County,11,3401,1534,1867
Georgia,Liberty County,12,3112,1460,1652
Georgia,Liberty County,13,2335,1091,1244
Georgia,Liberty County,14,1930,919,1011
Georgia,Liberty County,15,1366,599,767
Georgia,Liberty County,16,795,345,450
Georgia,Liberty County,17,450,176,274
Georgia,Liberty County,18,343,128,215
Georgia,Lincoln County,0,7622,3757,3865
Georgia,Lincoln County,1,353,196,157
Georgia,Lincoln County,2,411,196,215
Georgia,Lincoln County,3,419,222,197
Georgia,Lincoln County,4,409,213,196
Georgia,Lincoln County,5,438,244,194
Georgia,Lincoln County,6,434,222,212
Georgia,Lincoln County,7,344,173,171
Georgia,Lincoln County,8,350,153,197
Georgia,Lincoln County,9,438,222,216
Georgia,Lincoln County,10,477,224,253
Georgia,Lincoln County,11,642,302,340
Georgia,Lincoln County,12,678,354,324
Georgia,Lincoln County,13,653,311,342
Georgia,Lincoln County,14,561,266,295
Georgia,Lincoln County,15,410,190,220
Georgia,Lincoln County,16,316,148,168
Georgia,Lincoln County,17,163,82,81
Georgia,Lincoln County,18,126,39,87
Georgia,Long County,0,17113,8603,8510
Georgia,Long County,1,1410,713,697
Georgia,Long County,2,1397,651,746
Georgia,Long County,3,1319,693,626
Georgia,Long County,4,1230,633,597
Georgia,Long County,5,1197,624,573
Georgia,Long County,6,1529,801,728
Georgia,Long County,7,1382,713,669
Georgia,Long County,8,1287,659,628
Georgia,Long County,9,1193,621,572
Georgia,Long County,10,1033,522,511
Georgia,Long County,11,1083,543,540
Georgia,Long County,12,957,472,485
Georgia,Long County,13,777,379,398
Georgia,Long County,14,498,232,266
Georgia,Long County,15,302,141,161
Georgia,Long County,16,223,100,123
Georgia,Long County,17,143,53,90
Georgia,Long County,18,153,53,100
Georgia,Lowndes County,0,113523,55561,57962
Georgia,Lowndes County,1,8102,4147,3955
Georgia,Lowndes County,2,8249,4166,4083
Georgia,Lowndes County,3,7407,3739,3668
Georgia,Lowndes County,4,9569,4651,4918
Georgia,Lowndes County,5,15797,7860,7937
Georgia,Lowndes County,6,8839,4768,4071
Georgia,Lowndes County,7,7374,3726,3648
Georgia,Lowndes County,8,6270,3142,3128
Georgia,Lowndes County,9,6223,3036,3187
Georgia,Lowndes County,10,6013,2911,3102
Georgia,Lowndes County,11,6358,3050,3308
Georgia,Lowndes County,12,5855,2803,3052
Georgia,Lowndes County,13,4958,2304,2654
Georgia,Lowndes County,14,4270,1920,2350
Georgia,Lowndes County,15,3111,1330,1781
Georgia,Lowndes County,16,2311,1012,1299
Georgia,Lowndes County,17,1504,597,907
Georgia,Lowndes County,18,1313,399,914
Georgia,Lumpkin County,0,31176,15535,15641
Georgia,Lumpkin County,1,1556,847,709
Georgia,Lumpkin County,2,1655,850,805
Georgia,Lumpkin County,3,1663,873,790
Georgia,Lumpkin County,4,2969,1471,1498
Georgia,Lumpkin County,5,3690,1965,1725
Georgia,Lumpkin County,6,1774,870,904
Georgia,Lumpkin County,7,1673,872,801
Georgia,Lumpkin County,8,1593,766,827
Georgia,Lumpkin County,9,1738,858,880
Georgia,Lumpkin County,10,1714,868,846
Georgia,Lumpkin County,11,2127,1049,1078
Georgia,Lumpkin County,12,2188,1051,1137
Georgia,Lumpkin County,13,1950,910,1040
Georgia,Lumpkin County,14,1838,888,950
Georgia,Lumpkin County,15,1340,653,687
Georgia,Lumpkin County,16,809,367,442
Georgia,Lumpkin County,17,492,221,271
Georgia,Lumpkin County,18,407,156,251
Georgia,McDuffie County,0,21370,10033,11337
Georgia,McDuffie County,1,1316,707,609
Georgia,McDuffie County,2,1574,790,784
Georgia,McDuffie County,3,1586,768,818
Georgia,McDuffie County,4,1380,718,662
Georgia,McDuffie County,5,1373,656,717
Georgia,McDuffie County,6,1283,590,693
Georgia,McDuffie County,7,1196,562,634
Georgia,McDuffie County,8,1151,512,639
Georgia,McDuffie County,9,1310,610,700
Georgia,McDuffie County,10,1391,672,719
Georgia,McDuffie County,11,1558,749,809
Georgia,McDuffie County,12,1531,709,822
Georgia,McDuffie County,13,1318,594,724
Georgia,McDuffie County,14,1219,576,643
Georgia,McDuffie County,15,894,371,523
Georgia,McDuffie County,16,596,231,365
Georgia,McDuffie County,17,390,145,245
Georgia,McDuffie County,18,304,73,231
Georgia,McIntosh County,0,14214,6987,7227
Georgia,McIntosh County,1,769,416,353
Georgia,McIntosh County,2,719,379,340
Georgia,McIntosh County,3,754,369,385
Georgia,McIntosh County,4,739,376,363
Georgia,McIntosh County,5,853,450,403
Georgia,McIntosh County,6,690,334,356
Georgia,McIntosh County,7,626,295,331
Georgia,McIntosh County,8,680,345,335
Georgia,McIntosh County,9,860,397,463
Georgia,McIntosh County,10,912,439,473
Georgia,McIntosh County,11,1111,558,553
Georgia,McIntosh County,12,1213,589,624
Georgia,McIntosh County,13,1205,546,659
Georgia,McIntosh County,14,1051,510,541
Georgia,McIntosh County,15,879,428,451
Georgia,McIntosh County,16,579,299,280
Georgia,McIntosh County,17,278,132,146
Georgia,McIntosh County,18,296,125,171
Georgia,Macon County,0,13792,7465,6327
Georgia,Macon County,1,670,331,339
Georgia,Macon County,2,761,388,373
Georgia,Macon County,3,827,422,405
Georgia,Macon County,4,791,402,389
Georgia,Macon County,5,1109,695,414
Georgia,Macon County,6,1016,640,376
Georgia,Macon County,7,963,633,330
Georgia,Macon County,8,851,529,322
Georgia,Macon County,9,827,496,331
Georgia,Macon County,10,939,523,416
Georgia,Macon County,11,993,506,487
Georgia,Macon County,12,1067,520,547
Georgia,Macon County,13,926,448,478
Georgia,Macon County,14,760,385,375
Georgia,Macon County,15,586,262,324
Georgia,Macon County,16,320,144,176
Georgia,Macon County,17,206,82,124
Georgia,Macon County,18,180,59,121
Georgia,Madison County,0,28312,13963,14349
Georgia,Madison County,1,1520,763,757
Georgia,Madison County,2,1843,937,906
Georgia,Madison County,3,1989,1056,933
Georgia,Madison County,4,1844,957,887
Georgia,Madison County,5,1749,889,860
Georgia,Madison County,6,1610,774,836
Georgia,Madison County,7,1679,831,848
Georgia,Madison County,8,1661,780,881
Georgia,Madison County,9,1907,945,962
Georgia,Madison County,10,1942,954,988
Georgia,Madison County,11,2244,1142,1102
Georgia,Madison County,12,2096,998,1098
Georgia,Madison County,13,1824,914,910
Georgia,Madison County,14,1561,769,792
Georgia,Madison County,15,1194,585,609
Georgia,Madison County,16,813,353,460
Georgia,Madison County,17,485,195,290
Georgia,Madison County,18,351,121,230
Georgia,Marion County,0,8797,4388,4409
Georgia,Marion County,1,536,258,278
Georgia,Marion County,2,547,251,296
Georgia,Marion County,3,527,264,263
Georgia,Marion County,4,522,289,233
Georgia,Marion County,5,539,283,256
Georgia,Marion County,6,481,232,249
Georgia,Marion County,7,457,232,225
Georgia,Marion County,8,493,277,216
Georgia,Marion County,9,533,247,286
Georgia,Marion County,10,591,281,310
Georgia,Marion County,11,759,389,370
Georgia,Marion County,12,714,363,351
Georgia,Marion County,13,601,313,288
Georgia,Marion County,14,549,284,265
Georgia,Marion County,15,418,184,234
Georgia,Marion County,16,285,118,167
Georgia,Marion County,17,136,71,65
Georgia,Marion County,18,109,52,57
Georgia,Meriwether County,0,21198,10177,11021
Georgia,Meriwether County,1,1147,568,579
Georgia,Meriwether County,2,1398,687,711
Georgia,Meriwether County,3,1362,687,675
Georgia,Meriwether County,4,1360,730,630
Georgia,Meriwether County,5,1288,633,655
Georgia,Meriwether County,6,1184,583,601
Georgia,Meriwether County,7,1205,578,627
Georgia,Meriwether County,8,1120,548,572
Georgia,Meriwether County,9,1189,575,614
Georgia,Meriwether County,10,1357,660,697
Georgia,Meriwether County,11,1632,809,823
Georgia,Meriwether County,12,1558,754,804
Georgia,Meriwether County,13,1457,678,779
Georgia,Meriwether County,14,1424,665,759
Georgia,Meriwether County,15,1032,492,540
Georgia,Meriwether County,16,699,282,417
Georgia,Meriwether County,17,400,141,259
Georgia,Meriwether County,18,386,107,279
Georgia,Miller County,0,5958,2883,3075
Georgia,Miller County,1,371,181,190
Georgia,Miller County,2,402,202,200
Georgia,Miller County,3,393,201,192
Georgia,Miller County,4,355,193,162
Georgia,Miller County,5,339,176,163
Georgia,Miller County,6,334,168,166
Georgia,Miller County,7,318,136,182
Georgia,Miller County,8,310,164,146
Georgia,Miller County,9,388,202,186
Georgia,Miller County,10,382,174,208
Georgia,Miller County,11,427,210,217
Georgia,Miller County,12,393,192,201
Georgia,Miller County,13,381,185,196
Georgia,Miller County,14,320,147,173
Georgia,Miller County,15,296,139,157
Georgia,Miller County,16,216,90,126
Georgia,Miller County,17,173,69,104
Georgia,Miller County,18,160,54,106
Georgia,Mitchell County,0,22771,11904,10867
Georgia,Mitchell County,1,1374,735,639
Georgia,Mitchell County,2,1585,822,763
Georgia,Mitchell County,3,1491,782,709
Georgia,Mitchell County,4,1479,809,670
Georgia,Mitchell County,5,1517,865,652
Georgia,Mitchell County,6,1508,900,608
Georgia,Mitchell County,7,1494,850,644
Georgia,Mitchell County,8,1385,786,599
Georgia,Mitchell County,9,1590,869,721
Georgia,Mitchell County,10,1492,843,649
Georgia,Mitchell County,11,1610,859,751
Georgia,Mitchell County,12,1520,758,762
Georgia,Mitchell County,13,1332,617,715
Georgia,Mitchell County,14,1106,511,595
Georgia,Mitchell County,15,880,371,509
Georgia,Mitchell County,16,631,271,360
Georgia,Mitchell County,17,369,134,235
Georgia,Mitchell County,18,408,122,286
Georgia,Monroe County,0,27051,13643,13408
Georgia,Monroe County,1,1370,724,646
Georgia,Monroe County,2,1476,775,701
Georgia,Monroe County,3,1708,877,831
Georgia,Monroe County,4,1752,994,758
Georgia,Monroe County,5,1728,954,774
Georgia,Monroe County,6,1532,823,709
Georgia,Monroe County,7,1520,782,738
Georgia,Monroe County,8,1463,698,765
Georgia,Monroe County,9,1797,877,920
Georgia,Monroe County,10,1936,976,960
Georgia,Monroe County,11,2101,1028,1073
Georgia,Monroe County,12,2219,1073,1146
Georgia,Monroe County,13,1903,944,959
Georgia,Monroe County,14,1593,817,776
Georgia,Monroe County,15,1177,568,609
Georgia,Monroe County,16,765,384,381
Georgia,Monroe County,17,492,194,298
Georgia,Monroe County,18,519,155,364
Georgia,Montgomery County,0,8991,4645,4346
Georgia,Montgomery County,1,508,264,244
Georgia,Montgomery County,2,524,264,260
Georgia,Montgomery County,3,604,315,289
Georgia,Montgomery County,4,698,387,311
Georgia,Montgomery County,5,742,440,302
Georgia,Montgomery County,6,523,290,233
Georgia,Montgomery County,7,495,277,218
Georgia,Montgomery County,8,521,293,228
Georgia,Montgomery County,9,581,285,296
Georgia,Montgomery County,10,599,327,272
Georgia,Montgomery County,11,620,318,302
Georgia,Montgomery County,12,620,334,286
Georgia,Montgomery County,13,560,268,292
Georgia,Montgomery County,14,473,213,260
Georgia,Montgomery County,15,373,150,223
Georgia,Montgomery County,16,301,135,166
Georgia,Montgomery County,17,149,54,95
Georgia,Montgomery County,18,100,31,69
Georgia,Morgan County,0,17956,8702,9254
Georgia,Morgan County,1,926,468,458
Georgia,Morgan County,2,1192,591,601
Georgia,Morgan County,3,1249,628,621
Georgia,Morgan County,4,1177,623,554
Georgia,Morgan County,5,1026,507,519
Georgia,Morgan County,6,820,415,405
Georgia,Morgan County,7,935,431,504
Georgia,Morgan County,8,980,447,533
Georgia,Morgan County,9,1174,560,614
Georgia,Morgan County,10,1252,615,637
Georgia,Morgan County,11,1365,703,662
Georgia,Morgan County,12,1332,629,703
Georgia,Morgan County,13,1258,606,652
Georgia,Morgan County,14,1081,513,568
Georgia,Morgan County,15,844,385,459
Georgia,Morgan County,16,642,289,353
Georgia,Morgan County,17,383,174,209
Georgia,Morgan County,18,320,118,202
Georgia,Murray County,0,39410,19602,19808
Georgia,Murray County,1,2540,1348,1192
Georgia,Murray County,2,2830,1453,1377
Georgia,Murray County,3,2866,1462,1404
Georgia,Murray County,4,2667,1361,1306
Georgia,Murray County,5,2594,1339,1255
Georgia,Murray County,6,2477,1228,1249
Georgia,Murray County,7,2395,1132,1263
Georgia,Murray County,8,2499,1245,1254
Georgia,Murray County,9,2938,1422,1516
Georgia,Murray County,10,2863,1476,1387
Georgia,Murray County,11,2868,1450,1418
Georgia,Murray County,12,2522,1290,1232
Georgia,Murray County,13,2128,1010,1118
Georgia,Murray County,14,1959,951,1008
Georgia,Murray County,15,1417,675,742
Georgia,Murray County,16,953,427,526
Georgia,Murray County,17,536,204,332
Georgia,Murray County,18,358,129,229
Georgia,Muscogee County,0,200887,98808,102079
Georgia,Muscogee County,1,15201,7721,7480
Georgia,Muscogee County,2,13725,7014,6711
Georgia,Muscogee County,3,12422,6278,6144
Georgia,Muscogee County,4,13201,6986,6215
Georgia,Muscogee County,5,17490,9611,7879
Georgia,Muscogee County,6,17485,9136,8349
Georgia,Muscogee County,7,15474,8011,7463
Georgia,Muscogee County,8,12842,6450,6392
Georgia,Muscogee County,9,12198,5973,6225
Georgia,Muscogee County,10,11617,5591,6026
Georgia,Muscogee County,11,12693,6031,6662
Georgia,Muscogee County,12,12301,5833,6468
Georgia,Muscogee County,13,10080,4630,5450
Georgia,Muscogee County,14,7839,3487,4352
Georgia,Muscogee County,15,5631,2319,3312
Georgia,Muscogee County,16,4163,1638,2525
Georgia,Muscogee County,17,3348,1147,2201
Georgia,Muscogee County,18,3177,952,2225
Georgia,Newton County,0,103675,49405,54270
Georgia,Newton County,1,6936,3532,3404
Georgia,Newton County,2,7951,4046,3905
Georgia,Newton County,3,8305,4217,4088
Georgia,Newton County,4,8121,4100,4021
Georgia,Newton County,5,6894,3500,3394
Georgia,Newton County,6,6139,2952,3187
Georgia,Newton County,7,6295,2895,3400
Georgia,Newton County,8,6859,3126,3733
Georgia,Newton County,9,7747,3509,4238
Georgia,Newton County,10,7585,3602,3983
Georgia,Newton County,11,7172,3406,3766
Georgia,Newton County,12,6012,2769,3243
Georgia,Newton County,13,5272,2393,2879
Georgia,Newton County,14,4671,2142,2529
Georgia,Newton County,15,3144,1390,1754
Georgia,Newton County,16,2083,924,1159
Georgia,Newton County,17,1324,556,768
Georgia,Newton County,18,1165,346,819
Georgia,Oconee County,0,35093,17162,17931
Georgia,Oconee County,1,1846,918,928
Georgia,Oconee County,2,2604,1313,1291
Georgia,Oconee County,3,3059,1597,1462
Georgia,Oconee County,4,2784,1464,1320
Georgia,Oconee County,5,1967,1005,962
Georgia,Oconee County,6,1448,732,716
Georgia,Oconee County,7,1705,776,929
Georgia,Oconee County,8,2237,1041,1196
Georgia,Oconee County,9,2693,1275,1418
Georgia,Oconee County,10,2688,1287,1401
Georgia,Oconee County,11,2680,1287,1393
Georgia,Oconee County,12,2503,1229,1274
Georgia,Oconee County,13,2144,1030,1114
Georgia,Oconee County,14,1753,886,867
Georgia,Oconee County,15,1254,601,653
Georgia,Oconee County,16,727,336,391
Georgia,Oconee County,17,493,195,298
Georgia,Oconee County,18,508,190,318
Georgia,Oglethorpe County,0,14673,7237,7436
Georgia,Oglethorpe County,1,781,401,380
Georgia,Oglethorpe County,2,877,435,442
Georgia,Oglethorpe County,3,921,470,451
Georgia,Oglethorpe County,4,927,497,430
Georgia,Oglethorpe County,5,870,452,418
Georgia,Oglethorpe County,6,787,390,397
Georgia,Oglethorpe County,7,842,403,439
Georgia,Oglethorpe County,8,816,411,405
Georgia,Oglethorpe County,9,999,476,523
Georgia,Oglethorpe County,10,1052,520,532
Georgia,Oglethorpe County,11,1147,589,558
Georgia,Oglethorpe County,12,1108,537,571
Georgia,Oglethorpe County,13,905,452,453
Georgia,Oglethorpe County,14,913,448,465
Georgia,Oglethorpe County,15,726,336,390
Georgia,Oglethorpe County,16,458,211,247
Georgia,Oglethorpe County,17,306,132,174
Georgia,Oglethorpe County,18,238,77,161
Georgia,Paulding County,0,148987,72774,76213
Georgia,Paulding County,1,9706,5028,4678
Georgia,Paulding County,2,11706,5953,5753
Georgia,Paulding County,3,12670,6452,6218
Georgia,Paulding County,4,11117,5657,5460
Georgia,Paulding County,5,9303,4734,4569
Georgia,Paulding County,6,8911,4382,4529
Georgia,Paulding County,7,9979,4733,5246
Georgia,Paulding County,8,10868,5050,5818
Georgia,Paulding County,9,12851,6217,6634
Georgia,Paulding County,10,12025,5933,6092
Georgia,Paulding County,11,10631,5336,5295
Georgia,Paulding County,12,8569,4147,4422
Georgia,Paulding County,13,6569,3044,3525
Georgia,Paulding County,14,5508,2562,2946
Georgia,Paulding County,15,3845,1735,2110
Georgia,Paulding County,16,2329,980,1349
Georgia,Paulding County,17,1399,559,840
Georgia,Paulding County,18,1001,272,729
Georgia,Peach County,0,26922,12998,13924
Georgia,Peach County,1,1603,810,793
Georgia,Peach County,2,1681,849,832
Georgia,Peach County,3,1705,879,826
Georgia,Peach County,4,2318,1090,1228
Georgia,Peach County,5,2937,1450,1487
Georgia,Peach County,6,1672,851,821
Georgia,Peach County,7,1592,801,791
Georgia,Peach County,8,1404,690,714
Georgia,Peach County,9,1487,708,779
Georgia,Peach County,10,1664,790,874
Georgia,Peach County,11,1916,961,955
Georgia,Peach County,12,1847,897,950
Georgia,Peach County,13,1518,693,825
Georgia,Peach County,14,1323,605,718
Georgia,Peach County,15,860,408,452
Georgia,Peach County,16,670,254,416
Georgia,Peach County,17,395,155,240
Georgia,Peach County,18,330,107,223
Georgia,Pickens County,0,29997,14803,15194
Georgia,Pickens County,1,1461,756,705
Georgia,Pickens County,2,1762,907,855
Georgia,Pickens County,3,1911,978,933
Georgia,Pickens County,4,1705,878,827
Georgia,Pickens County,5,1653,858,795
Georgia,Pickens County,6,1627,781,846
Georgia,Pickens County,7,1484,719,765
Georgia,Pickens County,8,1592,755,837
Georgia,Pickens County,9,1939,996,943
Georgia,Pickens County,10,2070,1054,1016
Georgia,Pickens County,11,2153,1061,1092
Georgia,Pickens County,12,2265,1090,1175
Georgia,Pickens County,13,2284,1056,1228
Georgia,Pickens County,14,2296,1150,1146
Georgia,Pickens County,15,1689,826,863
Georgia,Pickens County,16,1040,501,539
Georgia,Pickens County,17,565,266,299
Georgia,Pickens County,18,501,171,330
Georgia,Pierce County,0,18991,9419,9572
Georgia,Pierce County,1,1244,659,585
Georgia,Pierce County,2,1339,674,665
Georgia,Pierce County,3,1414,735,679
Georgia,Pierce County,4,1235,639,596
Georgia,Pierce County,5,1111,574,537
Georgia,Pierce County,6,1063,516,547
Georgia,Pierce County,7,1166,577,589
Georgia,Pierce County,8,1211,594,617
Georgia,Pierce County,9,1313,648,665
Georgia,Pierce County,10,1272,637,635
Georgia,Pierce County,11,1330,664,666
Georgia,Pierce County,12,1207,600,607
Georgia,Pierce County,13,1130,541,589
Georgia,Pierce County,14,1060,511,549
Georgia,Pierce County,15,770,349,421
Georgia,Pierce County,16,526,253,273
Georgia,Pierce County,17,323,152,171
Georgia,Pierce County,18,277,96,181
Georgia,Pike County,0,17784,8806,8978
Georgia,Pike County,1,896,460,436
Georgia,Pike County,2,1121,596,525
Georgia,Pike County,3,1461,738,723
Georgia,Pike County,4,1372,717,655
Georgia,Pike County,5,1038,519,519
Georgia,Pike County,6,907,445,462
Georgia,Pike County,7,954,482,472
Georgia,Pike County,8,1068,490,578
Georgia,Pike County,9,1373,652,721
Georgia,Pike County,10,1372,690,682
Georgia,Pike County,11,1366,702,664
Georgia,Pike County,12,1236,603,633
Georgia,Pike County,13,1027,504,523
Georgia,Pike County,14,908,452,456
Georgia,Pike County,15,710,333,377
Georgia,Pike County,16,462,234,228
Georgia,Pike County,17,288,134,154
Georgia,Pike County,18,225,55,170
Georgia,Polk County,0,41133,20215,20918
Georgia,Polk County,1,2786,1328,1458
Georgia,Polk County,2,3147,1644,1503
Georgia,Polk County,3,3033,1527,1506
Georgia,Polk County,4,2627,1393,1234
Georgia,Polk County,5,2642,1328,1314
Georgia,Polk County,6,2860,1466,1394
Georgia,Polk County,7,2601,1370,1231
Georgia,Polk County,8,2397,1187,1210
Georgia,Polk County,9,2578,1303,1275
Georgia,Polk County,10,2608,1315,1293
Georgia,Polk County,11,2792,1370,1422
Georgia,Polk County,12,2667,1254,1413
Georgia,Polk County,13,2256,1075,1181
Georgia,Polk County,14,2109,965,1144
Georgia,Polk County,15,1628,759,869
Georgia,Polk County,16,1068,460,608
Georgia,Polk County,17,731,271,460
Georgia,Polk County,18,603,200,403
Georgia,Pulaski County,0,11483,4961,6522
Georgia,Pulaski County,1,515,266,249
Georgia,Pulaski County,2,687,343,344
Georgia,Pulaski County,3,639,347,292
Georgia,Pulaski County,4,632,322,310
Georgia,Pulaski County,5,744,296,448
Georgia,Pulaski County,6,667,235,432
Georgia,Pulaski County,7,722,240,482
Georgia,Pulaski County,8,710,281,429
Georgia,Pulaski County,9,740,277,463
Georgia,Pulaski County,10,814,318,496
Georgia,Pulaski County,11,838,350,488
Georgia,Pulaski County,12,804,366,438
Georgia,Pulaski County,13,804,369,435
Georgia,Pulaski County,14,711,352,359
Georgia,Pulaski County,15,582,242,340
Georgia,Pulaski County,16,428,195,233
Georgia,Pulaski County,17,245,97,148
Georgia,Pulaski County,18,201,65,136
Georgia,Putnam County,0,21192,10269,10923
Georgia,Putnam County,1,1250,614,636
Georgia,Putnam County,2,1301,640,661
Georgia,Putnam County,3,1230,623,607
Georgia,Putnam County,4,1118,564,554
Georgia,Putnam County,5,1082,571,511
Georgia,Putnam County,6,1188,561,627
Georgia,Putnam County,7,1147,562,585
Georgia,Putnam County,8,1037,475,562
Georgia,Putnam County,9,1199,586,613
Georgia,Putnam County,10,1293,629,664
Georgia,Putnam County,11,1504,755,749
Georgia,Putnam County,12,1562,712,850
Georgia,Putnam County,13,1730,787,943
Georgia,Putnam County,14,1642,819,823
Georgia,Putnam County,15,1280,644,636
Georgia,Putnam County,16,798,390,408
Georgia,Putnam County,17,484,215,269
Georgia,Putnam County,18,347,122,225
Georgia,Quitman County,0,2315,1144,1171
Georgia,Quitman County,1,105,61,44
Georgia,Quitman County,2,101,53,48
Georgia,Quitman County,3,125,62,63
Georgia,Quitman County,4,118,61,57
Georgia,Quitman County,5,98,54,44
Georgia,Quitman County,6,103,59,44
Georgia,Quitman County,7,95,50,45
Georgia,Quitman County,8,97,37,60
Georgia,Quitman County,9,124,67,57
Georgia,Quitman County,10,156,67,89
Georgia,Quitman County,11,146,72,74
Georgia,Quitman County,12,203,100,103
Georgia,Quitman County,13,202,98,104
Georgia,Quitman County,14,241,119,122
Georgia,Quitman County,15,155,80,75
Georgia,Quitman County,16,111,47,64
Georgia,Quitman County,17,75,35,40
Georgia,Quitman County,18,60,22,38
Georgia,Rabun County,0,16243,8028,8215
Georgia,Rabun County,1,679,377,302
Georgia,Rabun County,2,778,396,382
Georgia,Rabun County,3,846,415,431
Georgia,Rabun County,4,1031,556,475
Georgia,Rabun County,5,818,413,405
Georgia,Rabun County,6,824,437,387
Georgia,Rabun County,7,738,359,379
Georgia,Rabun County,8,789,386,403
Georgia,Rabun County,9,1012,494,518
Georgia,Rabun County,10,938,462,476
Georgia,Rabun County,11,1162,586,576
Georgia,Rabun County,12,1263,608,655
Georgia,Rabun County,13,1227,589,638
Georgia,Rabun County,14,1454,733,721
Georgia,Rabun County,15,1070,491,579
Georgia,Rabun County,16,751,355,396
Georgia,Rabun County,17,446,194,252
Georgia,Rabun County,18,417,177,240
Georgia,Randolph County,0,7313,3408,3905
Georgia,Randolph County,1,417,215,202
Georgia,Randolph County,2,458,252,206
Georgia,Randolph County,3,383,199,184
Georgia,Randolph County,4,525,256,269
Georgia,Randolph County,5,513,254,259
Georgia,Randolph County,6,383,162,221
Georgia,Randolph County,7,394,179,215
Georgia,Randolph County,8,331,158,173
Georgia,Randolph County,9,329,140,189
Georgia,Randolph County,10,400,188,212
Georgia,Randolph County,11,537,232,305
Georgia,Randolph County,12,592,302,290
Georgia,Randolph County,13,526,257,269
Georgia,Randolph County,14,476,212,264
Georgia,Randolph County,15,359,150,209
Georgia,Randolph County,16,251,105,146
Georgia,Randolph County,17,212,99,113
Georgia,Randolph County,18,227,48,179
Georgia,Richmond County,0,201368,97559,103809
Georgia,Richmond County,1,14526,7366,7160
Georgia,Richmond County,2,13454,6895,6559
Georgia,Richmond County,3,12502,6287,6215
Georgia,Richmond County,4,13348,7233,6115
Georgia,Richmond County,5,18204,9628,8576
Georgia,Richmond County,6,17672,8838,8834
Georgia,Richmond County,7,14394,7055,7339
Georgia,Richmond County,8,11636,5680,5956
Georgia,Richmond County,9,11054,5291,5763
Georgia,Richmond County,10,11459,5411,6048
Georgia,Richmond County,11,13169,6085,7084
Georgia,Richmond County,12,13417,6226,7191
Georgia,Richmond County,13,11255,5124,6131
Georgia,Richmond County,14,8703,3928,4775
Georgia,Richmond County,15,6203,2651,3552
Georgia,Richmond County,16,4246,1765,2481
Georgia,Richmond County,17,3289,1226,2063
Georgia,Richmond County,18,2837,870,1967
Georgia,Rockdale County,0,87754,41529,46225
Georgia,Rockdale County,1,5300,2666,2634
Georgia,Rockdale County,2,6294,3164,3130
Georgia,Rockdale County,3,6747,3439,3308
Georgia,Rockdale County,4,6498,3294,3204
Georgia,Rockdale County,5,5991,3019,2972
Georgia,Rockdale County,6,5083,2533,2550
Georgia,Rockdale County,7,4951,2252,2699
Georgia,Rockdale County,8,5201,2210,2991
Georgia,Rockdale County,9,6111,2780,3331
Georgia,Rockdale County,10,6289,2871,3418
Georgia,Rockdale County,11,6766,3143,3623
Georgia,Rockdale County,12,6090,2903,3187
Georgia,Rockdale County,13,5241,2369,2872
Georgia,Rockdale County,14,4233,1964,2269
Georgia,Rockdale County,15,2852,1318,1534
Georgia,Rockdale County,16,1781,754,1027
Georgia,Rockdale County,17,1222,500,722
Georgia,Rockdale County,18,1104,350,754
Georgia,Schley County,0,5163,2447,2716
Georgia,Schley County,1,265,133,132
Georgia,Schley County,2,414,192,222
Georgia,Schley County,3,471,240,231
Georgia,Schley County,4,398,186,212
Georgia,Schley County,5,306,144,162
Georgia,Schley County,6,252,115,137
Georgia,Schley County,7,261,117,144
Georgia,Schley County,8,317,144,173
Georgia,Schley County,9,359,164,195
Georgia,Schley County,10,406,208,198
Georgia,Schley County,11,377,186,191
Georgia,Schley County,12,291,134,157
Georgia,Schley County,13,287,144,143
Georgia,Schley County,14,254,116,138
Georgia,Schley County,15,228,117,111
Georgia,Schley County,16,142,64,78
Georgia,Schley County,17,71,25,46
Georgia,Schley County,18,64,18,46
Georgia,Screven County,0,14085,6880,7205
Georgia,Screven County,1,925,499,426
Georgia,Screven County,2,846,437,409
Georgia,Screven County,3,799,402,397
Georgia,Screven County,4,927,549,378
Georgia,Screven County,5,987,480,507
Georgia,Screven County,6,883,414,469
Georgia,Screven County,7,715,345,370
Georgia,Screven County,8,817,384,433
Georgia,Screven County,9,795,380,415
Georgia,Screven County,10,912,449,463
Georgia,Screven County,11,1038,494,544
Georgia,Screven County,12,1057,499,558
Georgia,Screven County,13,1014,503,511
Georgia,Screven County,14,841,402,439
Georgia,Screven County,15,589,255,334
Georgia,Screven County,16,395,175,220
Georgia,Screven County,17,257,113,144
Georgia,Screven County,18,288,100,188
Georgia,Seminole County,0,8686,4169,4517
Georgia,Seminole County,1,483,241,242
Georgia,Seminole County,2,508,275,233
Georgia,Seminole County,3,524,256,268
Georgia,Seminole County,4,574,305,269
Georgia,Seminole County,5,519,271,248
Georgia,Seminole County,6,402,191,211
Georgia,Seminole County,7,411,195,216
Georgia,Seminole County,8,451,202,249
Georgia,Seminole County,9,485,234,251
Georgia,Seminole County,10,542,264,278
Georgia,Seminole County,11,638,287,351
Georgia,Seminole County,12,663,309,354
Georgia,Seminole County,13,589,282,307
Georgia,Seminole County,14,625,322,303
Georgia,Seminole County,15,491,240,251
Georgia,Seminole County,16,334,139,195
Georgia,Seminole County,17,222,89,133
Georgia,Seminole County,18,225,67,158
Georgia,Spalding County,0,63988,30898,33090
Georgia,Spalding County,1,4248,2116,2132
Georgia,Spalding County,2,4518,2270,2248
Georgia,Spalding County,3,4337,2224,2113
Georgia,Spalding County,4,3879,2029,1850
Georgia,Spalding County,5,4290,2173,2117
Georgia,Spalding County,6,4033,1964,2069
Georgia,Spalding County,7,4034,1952,2082
Georgia,Spalding County,8,3925,1929,1996
Georgia,Spalding County,9,3964,1934,2030
Georgia,Spalding County,10,4022,1945,2077
Georgia,Spalding County,11,4345,2066,2279
Georgia,Spalding County,12,4234,2024,2210
Georgia,Spalding County,13,3828,1791,2037
Georgia,Spalding County,14,3679,1684,1995
Georgia,Spalding County,15,2716,1264,1452
Georgia,Spalding County,16,1719,761,958
Georgia,Spalding County,17,1155,467,688
Georgia,Spalding County,18,1062,305,757
Georgia,Stephens County,0,25480,12269,13211
Georgia,Stephens County,1,1490,769,721
Georgia,Stephens County,2,1601,802,799
Georgia,Stephens County,3,1627,844,783
Georgia,Stephens County,4,1687,846,841
Georgia,Stephens County,5,1881,896,985
Georgia,Stephens County,6,1431,708,723
Georgia,Stephens County,7,1414,693,721
Georgia,Stephens County,8,1329,629,700
Georgia,Stephens County,9,1486,708,778
Georgia,Stephens County,10,1565,790,775
Georgia,Stephens County,11,1774,854,920
Georgia,Stephens County,12,1819,850,969
Georgia,Stephens County,13,1715,803,912
Georgia,Stephens County,14,1585,754,831
Georgia,Stephens County,15,1250,560,690
Georgia,Stephens County,16,872,408,464
Georgia,Stephens County,17,525,207,318
Georgia,Stephens County,18,429,148,281
Georgia,Stewart County,0,5744,3509,2235
Georgia,Stewart County,1,255,152,103
Georgia,Stewart County,2,257,127,130
Georgia,Stewart County,3,215,115,100
Georgia,Stewart County,4,290,184,106
Georgia,Stewart County,5,544,397,147
Georgia,Stewart County,6,564,444,120
Georgia,Stewart County,7,543,410,133
Georgia,Stewart County,8,451,340,111
Georgia,Stewart County,9,344,224,120
Georgia,Stewart County,10,364,206,158
Georgia,Stewart County,11,350,194,156
Georgia,Stewart County,12,357,193,164
Georgia,Stewart County,13,333,154,179
Georgia,Stewart County,14,276,139,137
Georgia,Stewart County,15,216,87,129
Georgia,Stewart County,16,151,51,100
Georgia,Stewart County,17,109,56,53
Georgia,Stewart County,18,125,36,89
Georgia,Sumter County,0,31232,14812,16420
Georgia,Sumter County,1,2031,974,1057
Georgia,Sumter County,2,2158,1057,1101
Georgia,Sumter County,3,1967,1017,950
Georgia,Sumter County,4,2523,1296,1227
Georgia,Sumter County,5,3141,1483,1658
Georgia,Sumter County,6,1954,1016,938
Georgia,Sumter County,7,1889,921,968
Georgia,Sumter County,8,1623,761,862
Georgia,Sumter County,9,1676,758,918
Georgia,Sumter County,10,1913,890,1023
Georgia,Sumter County,11,1988,913,1075
Georgia,Sumter County,12,1911,902,1009
Georgia,Sumter County,13,1826,839,987
Georgia,Sumter County,14,1656,764,892
Georgia,Sumter County,15,1079,502,577
Georgia,Sumter County,16,808,328,480
Georgia,Sumter County,17,533,209,324
Georgia,Sumter County,18,556,182,374
Georgia,Talbot County,0,6390,3046,3344
Georgia,Talbot County,1,289,163,126
Georgia,Talbot County,2,318,169,149
Georgia,Talbot County,3,376,170,206
Georgia,Talbot County,4,335,165,170
Georgia,Talbot County,5,433,216,217
Georgia,Talbot County,6,296,151,145
Georgia,Talbot County,7,302,136,166
Georgia,Talbot County,8,294,152,142
Georgia,Talbot County,9,365,173,192
Georgia,Talbot County,10,433,185,248
Georgia,Talbot County,11,552,256,296
Georgia,Talbot County,12,612,284,328
Georgia,Talbot County,13,562,284,278
Georgia,Talbot County,14,440,215,225
Georgia,Talbot County,15,335,144,191
Georgia,Talbot County,16,218,96,122
Georgia,Talbot County,17,129,54,75
Georgia,Talbot County,18,101,33,68
Georgia,Taliaferro County,0,1693,828,865
Georgia,Taliaferro County,1,110,48,62
Georgia,Taliaferro County,2,85,41,44
Georgia,Taliaferro County,3,66,33,33
Georgia,Taliaferro County,4,90,51,39
Georgia,Taliaferro County,5,99,54,45
Georgia,Taliaferro County,6,94,43,51
Georgia,Taliaferro County,7,78,37,41
Georgia,Taliaferro County,8,84,57,27
Georgia,Taliaferro County,9,87,44,43
Georgia,Taliaferro County,10,114,58,56
Georgia,Taliaferro County,11,127,61,66
Georgia,Taliaferro County,12,130,65,65
Georgia,Taliaferro County,13,150,71,79
Georgia,Taliaferro County,14,127,57,70
Georgia,Taliaferro County,15,86,56,30
Georgia,Taliaferro County,16,58,25,33
Georgia,Taliaferro County,17,50,11,39
Georgia,Taliaferro County,18,58,16,42
Georgia,Tattnall County,0,25224,14559,10665
Georgia,Tattnall County,1,1497,786,711
Georgia,Tattnall County,2,1514,816,698
Georgia,Tattnall County,3,1470,744,726
Georgia,Tattnall County,4,1376,729,647
Georgia,Tattnall County,5,2053,1382,671
Georgia,Tattnall County,6,2031,1374,657
Georgia,Tattnall County,7,1956,1337,619
Georgia,Tattnall County,8,1807,1151,656
Georgia,Tattnall County,9,1873,1169,704
Georgia,Tattnall County,10,1787,1114,673
Georgia,Tattnall County,11,1831,1045,786
Georgia,Tattnall County,12,1570,847,723
Georgia,Tattnall County,13,1315,674,641
Georgia,Tattnall County,14,1110,560,550
Georgia,Tattnall County,15,810,393,417
Georgia,Tattnall County,16,577,234,343
Georgia,Tattnall County,17,369,123,246
Georgia,Tattnall County,18,278,81,197
Georgia,Taylor County,0,8442,4012,4430
Georgia,Taylor County,1,432,192,240
Georgia,Taylor County,2,479,251,228
Georgia,Taylor County,3,539,279,260
Georgia,Taylor County,4,528,272,256
Georgia,Taylor County,5,613,320,293
Georgia,Taylor County,6,459,242,217
Georgia,Taylor County,7,405,199,206
Georgia,Taylor County,8,438,203,235
Georgia,Taylor County,9,582,275,307
Georgia,Taylor County,10,558,263,295
Georgia,Taylor County,11,661,333,328
Georgia,Taylor County,12,654,285,369
Georgia,Taylor County,13,557,245,312
Georgia,Taylor County,14,509,229,280
Georgia,Taylor County,15,421,176,245
Georgia,Taylor County,16,273,125,148
Georgia,Taylor County,17,183,71,112
Georgia,Taylor County,18,151,52,99
Georgia,Telfair County,0,16518,9800,6718
Georgia,Telfair County,1,692,339,353
Georgia,Telfair County,2,816,439,377
Georgia,Telfair County,3,890,457,433
Georgia,Telfair County,4,825,441,384
Georgia,Telfair County,5,1036,683,353
Georgia,Telfair County,6,1283,891,392
Georgia,Telfair County,7,1317,962,355
Georgia,Telfair County,8,1371,996,375
Georgia,Telfair County,9,1278,886,392
Georgia,Telfair County,10,1194,777,417
Georgia,Telfair County,11,1169,684,485
Georgia,Telfair County,12,1159,669,490
Georgia,Telfair County,13,962,507,455
Georgia,Telfair County,14,783,374,409
Georgia,Telfair County,15,617,284,333
Georgia,Telfair County,16,462,188,274
Georgia,Telfair County,17,350,112,238
Georgia,Telfair County,18,314,111,203
Georgia,Terrell County,0,9132,4342,4790
Georgia,Terrell County,1,629,314,315
Georgia,Terrell County,2,614,317,297
Georgia,Terrell County,3,571,304,267
Georgia,Terrell County,4,541,280,261
Georgia,Terrell County,5,651,343,308
Georgia,Terrell County,6,548,284,264
Georgia,Terrell County,7,547,264,283
Georgia,Terrell County,8,437,213,224
Georgia,Terrell County,9,444,217,227
Georgia,Terrell County,10,567,250,317
Georgia,Terrell County,11,690,324,366
Georgia,Terrell County,12,651,303,348
Georgia,Terrell County,13,625,269,356
Georgia,Terrell County,14,546,252,294
Georgia,Terrell County,15,410,177,233
Georgia,Terrell County,16,278,110,168
Georgia,Terrell County,17,207,76,131
Georgia,Terrell County,18,176,45,131
Georgia,Thomas County,0,44959,21307,23652
Georgia,Thomas County,1,2912,1461,1451
Georgia,Thomas County,2,3045,1569,1476
Georgia,Thomas County,3,3039,1529,1510
Georgia,Thomas County,4,2771,1442,1329
Georgia,Thomas County,5,2680,1267,1413
Georgia,Thomas County,6,2708,1248,1460
Georgia,Thomas County,7,2650,1317,1333
Georgia,Thomas County,8,2586,1211,1375
Georgia,Thomas County,9,2783,1286,1497
Georgia,Thomas County,10,2908,1407,1501
Georgia,Thomas County,11,3325,1575,1750
Georgia,Thomas County,12,3135,1481,1654
Georgia,Thomas County,13,2846,1323,1523
Georgia,Thomas County,14,2434,1083,1351
Georgia,Thomas County,15,1881,829,1052
Georgia,Thomas County,16,1400,619,781
Georgia,Thomas County,17,901,366,535
Georgia,Thomas County,18,955,294,661
Georgia,Tift County,0,40704,19594,21110
Georgia,Tift County,1,2698,1345,1353
Georgia,Tift County,2,2898,1457,1441
Georgia,Tift County,3,2898,1418,1480
Georgia,Tift County,4,3385,1699,1686
Georgia,Tift County,5,3158,1602,1556
Georgia,Tift County,6,2745,1378,1367
Georgia,Tift County,7,2595,1244,1351
Georgia,Tift County,8,2464,1225,1239
Georgia,Tift County,9,2522,1224,1298
Georgia,Tift County,10,2443,1197,1246
Georgia,Tift County,11,2558,1262,1296
Georgia,Tift County,12,2502,1172,1330
Georgia,Tift County,13,2143,1009,1134
Georgia,Tift County,14,1902,862,1040
Georgia,Tift County,15,1418,617,801
Georgia,Tift County,16,1018,423,595
Georgia,Tift County,17,698,264,434
Georgia,Tift County,18,659,196,463
Georgia,Toombs County,0,27282,12938,14344
Georgia,Toombs County,1,2112,1041,1071
Georgia,Toombs County,2,2150,1128,1022
Georgia,Toombs County,3,1989,992,997
Georgia,Toombs County,4,1824,935,889
Georgia,Toombs County,5,1714,836,878
Georgia,Toombs County,6,1762,797,965
Georgia,Toombs County,7,1717,846,871
Georgia,Toombs County,8,1596,752,844
Georgia,Toombs County,9,1648,790,858
Georgia,Toombs County,10,1638,748,890
Georgia,Toombs County,11,1745,798,947
Georgia,Toombs County,12,1722,853,869
Georgia,Toombs County,13,1530,719,811
Georgia,Toombs County,14,1394,644,750
Georgia,Toombs County,15,1022,446,576
Georgia,Toombs County,16,764,309,455
Georgia,Toombs County,17,475,184,291
Georgia,Toombs County,18,480,120,360
Georgia,Towns County,0,11098,5309,5789
Georgia,Towns County,1,410,234,176
Georgia,Towns County,2,370,196,174
Georgia,Towns County,3,463,217,246
Georgia,Towns County,4,1039,488,551
Georgia,Towns County,5,709,355,354
Georgia,Towns County,6,442,217,225
Georgia,Towns County,7,370,181,189
Georgia,Towns County,8,421,193,228
Georgia,Towns County,9,527,253,274
Georgia,Towns County,10,555,288,267
Georgia,Towns County,11,654,327,327
Georgia,Towns County,12,701,322,379
Georgia,Towns County,13,859,361,498
Georgia,Towns County,14,1052,488,564
Georgia,Towns County,15,921,430,491
Georgia,Towns County,16,735,369,366
Georgia,Towns County,17,477,247,230
Georgia,Towns County,18,393,143,250
Georgia,Treutlen County,0,6778,3411,3367
Georgia,Treutlen County,1,424,219,205
Georgia,Treutlen County,2,522,257,265
Georgia,Treutlen County,3,457,216,241
Georgia,Treutlen County,4,417,237,180
Georgia,Treutlen County,5,472,269,203
Georgia,Treutlen County,6,432,225,207
Georgia,Treutlen County,7,490,247,243
Georgia,Treutlen County,8,424,235,189
Georgia,Treutlen County,9,386,195,191
Georgia,Treutlen County,10,398,220,178
Georgia,Treutlen County,11,430,210,220
Georgia,Treutlen County,12,477,229,248
Georgia,Treutlen County,13,432,230,202
Georgia,Treutlen County,14,359,168,191
Georgia,Treutlen County,15,249,105,144
Georgia,Treutlen County,16,175,65,110
Georgia,Treutlen County,17,122,43,79
Georgia,Treutlen County,18,112,41,71
Georgia,Troup County,0,69469,33493,35976
Georgia,Troup County,1,4663,2382,2281
Georgia,Troup County,2,5057,2513,2544
Georgia,Troup County,3,4916,2536,2380
Georgia,Troup County,4,4966,2571,2395
Georgia,Troup County,5,5322,2681,2641
Georgia,Troup County,6,4574,2219,2355
Georgia,Troup County,7,4438,2114,2324
Georgia,Troup County,8,4121,1975,2146
Georgia,Troup County,9,4347,2057,2290
Georgia,Troup County,10,4440,2143,2297
Georgia,Troup County,11,4679,2255,2424
Georgia,Troup County,12,4591,2217,2374
Georgia,Troup County,13,3844,1814,2030
Georgia,Troup County,14,3303,1536,1767
Georgia,Troup County,15,2253,1059,1194
Georgia,Troup County,16,1617,647,970
Georgia,Troup County,17,1128,425,703
Georgia,Troup County,18,1210,349,861
Georgia,Turner County,0,8153,4005,4148
Georgia,Turner County,1,493,248,245
Georgia,Turner County,2,632,300,332
Georgia,Turner County,3,636,298,338
Georgia,Turner County,4,578,280,298
Georgia,Turner County,5,501,305,196
Georgia,Turner County,6,508,274,234
Georgia,Turner County,7,445,248,197
Georgia,Turner County,8,435,238,197
Georgia,Turner County,9,424,202,222
Georgia,Turner County,10,506,232,274
Georgia,Turner County,11,486,239,247
Georgia,Turner County,12,517,246,271
Georgia,Turner County,13,478,246,232
Georgia,Turner County,14,498,214,284
Georgia,Turner County,15,371,138,233
Georgia,Turner County,16,261,129,132
Georgia,Turner County,17,186,90,96
Georgia,Turner County,18,198,78,120
Georgia,Twiggs County,0,8320,4070,4250
Georgia,Twiggs County,1,456,235,221
Georgia,Twiggs County,2,459,240,219
Georgia,Twiggs County,3,438,211,227
Georgia,Twiggs County,4,385,189,196
Georgia,Twiggs County,5,491,247,244
Georgia,Twiggs County,6,508,257,251
Georgia,Twiggs County,7,414,217,197
Georgia,Twiggs County,8,389,195,194
Georgia,Twiggs County,9,449,222,227
Georgia,Twiggs County,10,576,281,295
Georgia,Twiggs County,11,736,369,367
Georgia,Twiggs County,12,738,346,392
Georgia,Twiggs County,13,650,337,313
Georgia,Twiggs County,14,596,273,323
Georgia,Twiggs County,15,460,214,246
Georgia,Twiggs County,16,275,123,152
Georgia,Twiggs County,17,184,83,101
Georgia,Twiggs County,18,116,31,85
Georgia,Union County,0,21984,10636,11348
Georgia,Union County,1,733,349,384
Georgia,Union County,2,1022,540,482
Georgia,Union County,3,1192,617,575
Georgia,Union County,4,1124,565,559
Georgia,Union County,5,989,529,460
Georgia,Union County,6,835,439,396
Georgia,Union County,7,906,460,446
Georgia,Union County,8,867,408,459
Georgia,Union County,9,1104,515,589
Georgia,Union County,10,1225,585,640
Georgia,Union County,11,1528,735,793
Georgia,Union County,12,1683,786,897
Georgia,Union County,13,1901,877,1024
Georgia,Union County,14,2216,1019,1197
Georgia,Union County,15,1902,925,977
Georgia,Union County,16,1277,634,643
Georgia,Union County,17,777,388,389
Georgia,Union County,18,703,265,438
Georgia,Upson County,0,26256,12515,13741
Georgia,Upson County,1,1673,863,810
Georgia,Upson County,2,1563,786,777
Georgia,Upson County,3,1619,809,810
Georgia,Upson County,4,1576,813,763
Georgia,Upson County,5,1703,831,872
Georgia,Upson County,6,1460,729,731
Georgia,Upson County,7,1423,684,739
Georgia,Upson County,8,1508,719,789
Georgia,Upson County,9,1676,812,864
Georgia,Upson County,10,1731,822,909
Georgia,Upson County,11,2019,963,1056
Georgia,Upson County,12,1911,896,1015
Georgia,Upson County,13,1731,826,905
Georgia,Upson County,14,1574,733,841
Georgia,Upson County,15,1236,565,671
Georgia,Upson County,16,835,329,506
Georgia,Upson County,17,533,196,337
Georgia,Upson County,18,485,139,346
Georgia,Walker County,0,68218,33637,34581
Georgia,Walker County,1,3784,1923,1861
Georgia,Walker County,2,4235,2201,2034
Georgia,Walker County,3,4562,2388,2174
Georgia,Walker County,4,4382,2321,2061
Georgia,Walker County,5,3970,2061,1909
Georgia,Walker County,6,3939,1980,1959
Georgia,Walker County,7,4094,2001,2093
Georgia,Walker County,8,4414,2205,2209
Georgia,Walker County,9,4662,2366,2296
Georgia,Walker County,10,4516,2253,2263
Georgia,Walker County,11,5035,2539,2496
Georgia,Walker County,12,5006,2446,2560
Georgia,Walker County,13,4285,2020,2265
Georgia,Walker County,14,3874,1807,2067
Georgia,Walker County,15,2889,1305,1584
Georgia,Walker County,16,2068,915,1153
Georgia,Walker County,17,1324,522,802
Georgia,Walker County,18,1179,384,795
Georgia,Walton County,0,87615,42639,44976
Georgia,Walton County,1,5451,2770,2681
Georgia,Walton County,2,6345,3216,3129
Georgia,Walton County,3,6852,3520,3332
Georgia,Walton County,4,6100,3120,2980
Georgia,Walton County,5,5373,2690,2683
Georgia,Walton County,6,5129,2490,2639
Georgia,Walton County,7,5144,2434,2710
Georgia,Walton County,8,5341,2533,2808
Georgia,Walton County,9,6203,2928,3275
Georgia,Walton County,10,6541,3248,3293
Georgia,Walton County,11,6348,3185,3163
Georgia,Walton County,12,5517,2680,2837
Georgia,Walton County,13,4859,2354,2505
Georgia,Walton County,14,4482,2118,2364
Georgia,Walton County,15,3278,1526,1752
Georgia,Walton County,16,2022,907,1115
Georgia,Walton County,17,1326,524,802
Georgia,Walton County,18,1304,396,908
Georgia,Ware County,0,35515,17583,17932
Georgia,Ware County,1,2457,1250,1207
Georgia,Ware County,2,2430,1224,1206
Georgia,Ware County,3,2243,1136,1107
Georgia,Ware County,4,2092,1102,990
Georgia,Ware County,5,2455,1337,1118
Georgia,Ware County,6,2494,1325,1169
Georgia,Ware County,7,2232,1170,1062
Georgia,Ware County,8,2042,1064,978
Georgia,Ware County,9,2169,1118,1051
Georgia,Ware County,10,2211,1159,1052
Georgia,Ware County,11,2372,1133,1239
Georgia,Ware County,12,2439,1179,1260
Georgia,Ware County,13,2137,1009,1128
Georgia,Ware County,14,1889,877,1012
Georgia,Ware County,15,1321,595,726
Georgia,Ware County,16,961,381,580
Georgia,Ware County,17,789,292,497
Georgia,Ware County,18,782,232,550
Georgia,Warren County,0,5520,2589,2931
Georgia,Warren County,1,318,155,163
Georgia,Warren County,2,357,168,189
Georgia,Warren County,3,333,175,158
Georgia,Warren County,4,282,144,138
Georgia,Warren County,5,343,183,160
Georgia,Warren County,6,279,133,146
Georgia,Warren County,7,269,126,143
Georgia,Warren County,8,251,121,130
Georgia,Warren County,9,279,136,143
Georgia,Warren County,10,384,179,205
Georgia,Warren County,11,416,196,220
Georgia,Warren County,12,476,222,254
Georgia,Warren County,13,411,199,212
Georgia,Warren County,14,331,140,191
Georgia,Warren County,15,323,149,174
Georgia,Warren County,16,181,77,104
Georgia,Warren County,17,146,57,89
Georgia,Warren County,18,141,29,112
Georgia,Washington County,0,20635,10391,10244
Georgia,Washington County,1,1262,618,644
Georgia,Washington County,2,1350,669,681
Georgia,Washington County,3,1220,664,556
Georgia,Washington County,4,1243,665,578
Georgia,Washington County,5,1430,793,637
Georgia,Washington County,6,1280,724,556
Georgia,Washington County,7,1324,737,587
Georgia,Washington County,8,1192,663,529
Georgia,Washington County,9,1200,629,571
Georgia,Washington County,10,1384,712,672
Georgia,Washington County,11,1649,823,826
Georgia,Washington County,12,1465,704,761
Georgia,Washington County,13,1328,623,705
Georgia,Washington County,14,1117,554,563
Georgia,Washington County,15,825,360,465
Georgia,Washington County,16,559,233,326
Georgia,Washington County,17,377,125,252
Georgia,Washington County,18,430,95,335
Georgia,Wayne County,0,29949,15548,14401
Georgia,Wayne County,1,2051,981,1070
Georgia,Wayne County,2,2099,1062,1037
Georgia,Wayne County,3,2019,1042,977
Georgia,Wayne County,4,1762,942,820
Georgia,Wayne County,5,1901,1025,876
Georgia,Wayne County,6,2001,1098,903
Georgia,Wayne County,7,1989,1107,882
Georgia,Wayne County,8,1967,1150,817
Georgia,Wayne County,9,2010,1150,860
Georgia,Wayne County,10,1986,1056,930
Georgia,Wayne County,11,2131,1097,1034
Georgia,Wayne County,12,1914,968,946
Georgia,Wayne County,13,1703,847,856
Georgia,Wayne County,14,1563,768,795
Georgia,Wayne County,15,1115,491,624
Georgia,Wayne County,16,771,360,411
Georgia,Wayne County,17,561,255,306
Georgia,Wayne County,18,406,149,257
Georgia,Webster County,0,2649,1325,1324
Georgia,Webster County,1,94,41,53
Georgia,Webster County,2,154,69,85
Georgia,Webster County,3,193,91,102
Georgia,Webster County,4,170,96,74
Georgia,Webster County,5,156,80,76
Georgia,Webster County,6,126,74,52
Georgia,Webster County,7,118,59,59
Georgia,Webster County,8,117,51,66
Georgia,Webster County,9,185,100,85
Georgia,Webster County,10,190,103,87
Georgia,Webster County,11,205,103,102
Georgia,Webster County,12,227,101,126
Georgia,Webster County,13,192,95,97
Georgia,Webster County,14,167,94,73
Georgia,Webster County,15,125,61,64
Georgia,Webster County,16,97,57,40
Georgia,Webster County,17,55,15,40
Georgia,Webster County,18,78,35,43
Georgia,Wheeler County,0,7995,5216,2779
Georgia,Wheeler County,1,345,195,150
Georgia,Wheeler County,2,365,182,183
Georgia,Wheeler County,3,414,219,195
Georgia,Wheeler County,4,369,211,158
Georgia,Wheeler County,5,666,513,153
Georgia,Wheeler County,6,736,587,149
Georgia,Wheeler County,7,681,530,151
Georgia,Wheeler County,8,604,450,154
Georgia,Wheeler County,9,656,497,159
Georgia,Wheeler County,10,656,482,174
Georgia,Wheeler County,11,556,363,193
Georgia,Wheeler County,12,477,259,218
Georgia,Wheeler County,13,444,244,200
Georgia,Wheeler County,14,355,183,172
Georgia,Wheeler County,15,285,138,147
Georgia,Wheeler County,16,144,77,67
Georgia,Wheeler County,17,131,56,75
Georgia,Wheeler County,18,111,30,81
Georgia,White County,0,27970,13715,14255
Georgia,White County,1,1356,662,694
Georgia,White County,2,1688,910,778
Georgia,White County,3,1756,892,864
Georgia,White County,4,1945,973,972
Georgia,White County,5,1726,927,799
Georgia,White County,6,1434,716,718
Georgia,White County,7,1285,643,642
Georgia,White County,8,1526,741,785
Georgia,White County,9,1674,830,844
Georgia,White County,10,1796,855,941
Georgia,White County,11,2038,968,1070
Georgia,White County,12,1988,975,1013
Georgia,White County,13,1991,916,1075
Georgia,White County,14,2022,979,1043
Georgia,White County,15,1584,753,831
Georgia,White County,16,1018,477,541
Georgia,White County,17,661,312,349
Georgia,White County,18,482,186,296
Georgia,Whitfield County,0,103542,51506,52036
Georgia,Whitfield County,1,7334,3757,3577
Georgia,Whitfield County,2,7928,4060,3868
Georgia,Whitfield County,3,7983,4094,3889
Georgia,Whitfield County,4,7293,3746,3547
Georgia,Whitfield County,5,7436,3826,3610
Georgia,Whitfield County,6,6814,3554,3260
Georgia,Whitfield County,7,6889,3517,3372
Georgia,Whitfield County,8,6570,3257,3313
Georgia,Whitfield County,9,7098,3521,3577
Georgia,Whitfield County,10,7093,3540,3553
Georgia,Whitfield County,11,6769,3380,3389
Georgia,Whitfield County,12,6076,2992,3084
Georgia,Whitfield County,13,5120,2426,2694
Georgia,Whitfield County,14,4373,2106,2267
Georgia,Whitfield County,15,3354,1587,1767
Georgia,Whitfield County,16,2439,1069,1370
Georgia,Whitfield County,17,1557,610,947
Georgia,Whitfield County,18,1416,464,952
Georgia,Wilcox County,0,8847,5208,3639
Georgia,Wilcox County,1,455,246,209
Georgia,Wilcox County,2,479,255,224
Georgia,Wilcox County,3,445,221,224
Georgia,Wilcox County,4,443,232,211
Georgia,Wilcox County,5,639,418,221
Georgia,Wilcox County,6,691,475,216
Georgia,Wilcox County,7,661,469,192
Georgia,Wilcox County,8,596,402,194
Georgia,Wilcox County,9,640,442,198
Georgia,Wilcox County,10,636,413,223
Georgia,Wilcox County,11,625,382,243
Georgia,Wilcox County,12,585,337,248
Georgia,Wilcox County,13,537,278,259
Georgia,Wilcox County,14,456,238,218
Georgia,Wilcox County,15,333,138,195
Georgia,Wilcox County,16,253,126,127
Georgia,Wilcox County,17,194,87,107
Georgia,Wilcox County,18,179,49,130
Georgia,Wilkes County,0,9940,4755,5185
Georgia,Wilkes County,1,572,299,273
Georgia,Wilkes County,2,595,285,310
Georgia,Wilkes County,3,598,306,292
Georgia,Wilkes County,4,603,327,276
Georgia,Wilkes County,5,556,287,269
Georgia,Wilkes County,6,493,245,248
Georgia,Wilkes County,7,516,245,271
Georgia,Wilkes County,8,462,212,250
Georgia,Wilkes County,9,596,295,301
Georgia,Wilkes County,10,642,322,320
Georgia,Wilkes County,11,741,348,393
Georgia,Wilkes County,12,783,375,408
Georgia,Wilkes County,13,651,277,374
Georgia,Wilkes County,14,689,320,369
Georgia,Wilkes County,15,562,292,270
Georgia,Wilkes County,16,379,155,224
Georgia,Wilkes County,17,237,98,139
Georgia,Wilkes County,18,265,67,198
Georgia,Wilkinson County,0,9326,4489,4837
Georgia,Wilkinson County,1,585,318,267
Georgia,Wilkinson County,2,613,320,293
Georgia,Wilkinson County,3,592,287,305
Georgia,Wilkinson County,4,527,260,267
Georgia,Wilkinson County,5,549,279,270
Georgia,Wilkinson County,6,519,245,274
Georgia,Wilkinson County,7,563,274,289
Georgia,Wilkinson County,8,462,229,233
Georgia,Wilkinson County,9,539,243,296
Georgia,Wilkinson County,10,586,294,292
Georgia,Wilkinson County,11,753,371,382
Georgia,Wilkinson County,12,738,372,366
Georgia,Wilkinson County,13,632,296,336
Georgia,Wilkinson County,14,512,233,279
Georgia,Wilkinson County,15,446,193,253
Georgia,Wilkinson County,16,317,139,178
Georgia,Wilkinson County,17,210,79,131
Georgia,Wilkinson County,18,183,57,126
Georgia,Worth County,0,20940,10052,10888
Georgia,Worth County,1,1254,646,608
Georgia,Worth County,2,1366,711,655
Georgia,Worth County,3,1325,653,672
Georgia,Worth County,4,1274,620,654
Georgia,Worth County,5,1353,680,673
Georgia,Worth County,6,1355,658,697
Georgia,Worth County,7,1206,572,634
Georgia,Worth County,8,1061,500,561
Georgia,Worth County,9,1308,604,704
Georgia,Worth County,10,1345,653,692
Georgia,Worth County,11,1602,781,821
Georgia,Worth County,12,1549,756,793
Georgia,Worth County,13,1405,676,729
Georgia,Worth County,14,1210,571,639
Georgia,Worth County,15,935,410,525
Georgia,Worth County,16,614,273,341
Georgia,Worth County,17,393,160,233
Georgia,Worth County,18,385,128,257
Hawaii,Hawaii County,0,194190,97157,97033
Hawaii,Hawaii County,1,12007,6160,5847
Hawaii,Hawaii County,2,12193,6339,5854
Hawaii,Hawaii County,3,11538,5956,5582
Hawaii,Hawaii County,4,11403,5798,5605
Hawaii,Hawaii County,5,11481,5894,5587
Hawaii,Hawaii County,6,12266,6357,5909
Hawaii,Hawaii County,7,12328,6238,6090
Hawaii,Hawaii County,8,11185,5648,5537
Hawaii,Hawaii County,9,10874,5438,5436
Hawaii,Hawaii County,10,11033,5445,5588
Hawaii,Hawaii County,11,12905,6303,6602
Hawaii,Hawaii County,12,15184,7444,7740
Hawaii,Hawaii County,13,15758,7813,7945
Hawaii,Hawaii County,14,12641,6538,6103
Hawaii,Hawaii County,15,8127,4135,3992
Hawaii,Hawaii County,16,4989,2326,2663
Hawaii,Hawaii County,17,3845,1653,2192
Hawaii,Hawaii County,18,4433,1672,2761
Hawaii,Honolulu County,0,991788,503609,488179
Hawaii,Honolulu County,1,64904,32963,31941
Hawaii,Honolulu County,2,59362,30507,28855
Hawaii,Honolulu County,3,56914,29330,27584
Hawaii,Honolulu County,4,55409,28836,26573
Hawaii,Honolulu County,5,81562,47130,34432
Hawaii,Honolulu County,6,82638,46031,36607
Hawaii,Honolulu County,7,73085,38704,34381
Hawaii,Honolulu County,8,62715,32874,29841
Hawaii,Honolulu County,9,60937,31220,29717
Hawaii,Honolulu County,10,59772,30020,29752
Hawaii,Honolulu County,11,62251,31107,31144
Hawaii,Honolulu County,12,60284,29698,30586
Hawaii,Honolulu County,13,54823,26500,28323
Hawaii,Honolulu County,14,48584,23225,25359
Hawaii,Honolulu County,15,35104,16371,18733
Hawaii,Honolulu County,16,25055,10989,14066
Hawaii,Honolulu County,17,21078,8380,12698
Hawaii,Honolulu County,18,27311,9724,17587
Hawaii,Kalawao County,0,89,42,47
Hawaii,Kalawao County,1,0,0,0
Hawaii,Kalawao County,2,0,0,0
Hawaii,Kalawao County,3,0,0,0
Hawaii,Kalawao County,4,0,0,0
Hawaii,Kalawao County,5,0,0,0
Hawaii,Kalawao County,6,3,1,2
Hawaii,Kalawao County,7,8,5,3
Hawaii,Kalawao County,8,2,0,2
Hawaii,Kalawao County,9,7,4,3
Hawaii,Kalawao County,10,7,5,2
Hawaii,Kalawao County,11,9,7,2
Hawaii,Kalawao County,12,12,6,6
Hawaii,Kalawao County,13,15,10,5
Hawaii,Kalawao County,14,1,0,1
Hawaii,Kalawao County,15,2,1,1
Hawaii,Kalawao County,16,8,0,8
Hawaii,Kalawao County,17,11,0,11
Hawaii,Kalawao County,18,4,3,1
Hawaii,Kauai County,0,70475,35299,35176
Hawaii,Kauai County,1,4489,2301,2188
Hawaii,Kauai County,2,4435,2306,2129
Hawaii,Kauai County,3,4303,2228,2075
Hawaii,Kauai County,4,3918,1993,1925
Hawaii,Kauai County,5,3834,1982,1852
Hawaii,Kauai County,6,4296,2256,2040
Hawaii,Kauai County,7,4613,2379,2234
Hawaii,Kauai County,8,4223,2186,2037
Hawaii,Kauai County,9,4279,2147,2132
Hawaii,Kauai County,10,4331,2170,2161
Hawaii,Kauai County,11,4944,2460,2484
Hawaii,Kauai County,12,5247,2558,2689
Hawaii,Kauai County,13,5284,2669,2615
Hawaii,Kauai County,14,4361,2217,2144
Hawaii,Kauai County,15,2871,1399,1472
Hawaii,Kauai County,16,1802,798,1004
Hawaii,Kauai County,17,1383,554,829
Hawaii,Kauai County,18,1862,696,1166
Hawaii,Maui County,0,163019,81992,81027
Hawaii,Maui County,1,10080,5284,4796
Hawaii,Maui County,2,10293,5255,5038
Hawaii,Maui County,3,10050,5114,4936
Hawaii,Maui County,4,9361,4741,4620
Hawaii,Maui County,5,9035,4808,4227
Hawaii,Maui County,6,10616,5561,5055
Hawaii,Maui County,7,11343,5842,5501
Hawaii,Maui County,8,10855,5713,5142
Hawaii,Maui County,9,10575,5353,5222
Hawaii,Maui County,10,10884,5377,5507
Hawaii,Maui County,11,12063,5996,6067
Hawaii,Maui County,12,11986,5984,6002
Hawaii,Maui County,13,11196,5609,5587
Hawaii,Maui County,14,9019,4493,4526
Hawaii,Maui County,15,5987,2859,3128
Hawaii,Maui County,16,3730,1687,2043
Hawaii,Maui County,17,2665,1164,1501
Hawaii,Maui County,18,3281,1152,2129
Idaho,Ada County,0,426236,213508,212728
Idaho,Ada County,1,26523,13579,12944
Idaho,Ada County,2,30938,15801,15137
Idaho,Ada County,3,31688,16151,15537
Idaho,Ada County,4,28032,14395,13637
Idaho,Ada County,5,26771,13979,12792
Idaho,Ada County,6,30865,15661,15204
Idaho,Ada County,7,31631,16362,15269
Idaho,Ada County,8,29917,15342,14575
Idaho,Ada County,9,29526,15049,14477
Idaho,Ada County,10,27879,14174,13705
Idaho,Ada County,11,28531,14282,14249
Idaho,Ada County,12,26843,12961,13882
Idaho,Ada County,13,23536,11441,12095
Idaho,Ada County,14,19400,9503,9897
Idaho,Ada County,15,12927,6040,6887
Idaho,Ada County,16,8471,3847,4624
Idaho,Ada County,17,6018,2505,3513
Idaho,Ada County,18,6740,2436,4304
Idaho,Adams County,0,3861,1988,1873
Idaho,Adams County,1,161,88,73
Idaho,Adams County,2,181,89,92
Idaho,Adams County,3,187,85,102
Idaho,Adams County,4,190,100,90
Idaho,Adams County,5,153,81,72
Idaho,Adams County,6,162,86,76
Idaho,Adams County,7,155,72,83
Idaho,Adams County,8,162,83,79
Idaho,Adams County,9,181,91,90
Idaho,Adams County,10,191,92,99
Idaho,Adams County,11,309,148,161
Idaho,Adams County,12,418,204,214
Idaho,Adams County,13,448,240,208
Idaho,Adams County,14,342,186,156
Idaho,Adams County,15,288,165,123
Idaho,Adams County,16,189,110,79
Idaho,Adams County,17,96,44,52
Idaho,Adams County,18,48,24,24
Idaho,Bannock County,0,83347,41502,41845
Idaho,Bannock County,1,6100,3030,3070
Idaho,Bannock County,2,6473,3352,3121
Idaho,Bannock County,3,6155,3190,2965
Idaho,Bannock County,4,5959,3115,2844
Idaho,Bannock County,5,6458,3207,3251
Idaho,Bannock County,6,6846,3457,3389
Idaho,Bannock County,7,6105,3097,3008
Idaho,Bannock County,8,5323,2698,2625
Idaho,Bannock County,9,4483,2206,2277
Idaho,Bannock County,10,4302,2107,2195
Idaho,Bannock County,11,4708,2317,2391
Idaho,Bannock County,12,5041,2454,2587
Idaho,Bannock County,13,4741,2356,2385
Idaho,Bannock County,14,3706,1834,1872
Idaho,Bannock County,15,2504,1202,1302
Idaho,Bannock County,16,1863,833,1030
Idaho,Bannock County,17,1341,592,749
Idaho,Bannock County,18,1239,455,784
Idaho,Bear Lake County,0,5957,2961,2996
Idaho,Bear Lake County,1,437,218,219
Idaho,Bear Lake County,2,434,198,236
Idaho,Bear Lake County,3,472,247,225
Idaho,Bear Lake County,4,445,214,231
Idaho,Bear Lake County,5,287,152,135
Idaho,Bear Lake County,6,290,132,158
Idaho,Bear Lake County,7,319,187,132
Idaho,Bear Lake County,8,358,161,197
Idaho,Bear Lake County,9,285,146,139
Idaho,Bear Lake County,10,276,136,140
Idaho,Bear Lake County,11,367,178,189
Idaho,Bear Lake County,12,424,215,209
Idaho,Bear Lake County,13,397,204,193
Idaho,Bear Lake County,14,378,188,190
Idaho,Bear Lake County,15,295,154,141
Idaho,Bear Lake County,16,210,89,121
Idaho,Bear Lake County,17,152,76,76
Idaho,Bear Lake County,18,131,66,65
Idaho,Benewah County,0,9118,4604,4514
Idaho,Benewah County,1,518,239,279
Idaho,Benewah County,2,591,323,268
Idaho,Benewah County,3,565,274,291
Idaho,Benewah County,4,537,292,245
Idaho,Benewah County,5,451,235,216
Idaho,Benewah County,6,420,206,214
Idaho,Benewah County,7,432,223,209
Idaho,Benewah County,8,440,211,229
Idaho,Benewah County,9,474,243,231
Idaho,Benewah County,10,541,270,271
Idaho,Benewah County,11,677,330,347
Idaho,Benewah County,12,808,409,399
Idaho,Benewah County,13,731,368,363
Idaho,Benewah County,14,683,342,341
Idaho,Benewah County,15,532,283,249
Idaho,Benewah County,16,316,171,145
Idaho,Benewah County,17,231,119,112
Idaho,Benewah County,18,171,66,105
Idaho,Bingham County,0,45269,22747,22522
Idaho,Bingham County,1,3887,1980,1907
Idaho,Bingham County,2,4244,2210,2034
Idaho,Bingham County,3,3954,2026,1928
Idaho,Bingham County,4,3413,1814,1599
Idaho,Bingham County,5,2725,1404,1321
Idaho,Bingham County,6,2556,1230,1326
Idaho,Bingham County,7,2864,1407,1457
Idaho,Bingham County,8,2802,1429,1373
Idaho,Bingham County,9,2494,1244,1250
Idaho,Bingham County,10,2396,1186,1210
Idaho,Bingham County,11,2834,1431,1403
Idaho,Bingham County,12,2780,1384,1396
Idaho,Bingham County,13,2492,1243,1249
Idaho,Bingham County,14,1822,907,915
Idaho,Bingham County,15,1498,746,752
Idaho,Bingham County,16,1070,502,568
Idaho,Bingham County,17,785,341,444
Idaho,Bingham County,18,653,263,390
Idaho,Blaine County,0,21482,10913,10569
Idaho,Blaine County,1,1127,591,536
Idaho,Blaine County,2,1477,786,691
Idaho,Blaine County,3,1544,765,779
Idaho,Blaine County,4,1235,623,612
Idaho,Blaine County,5,1027,549,478
Idaho,Blaine County,6,1080,534,546
Idaho,Blaine County,7,1296,666,630
Idaho,Blaine County,8,1381,751,630
Idaho,Blaine County,9,1430,716,714
Idaho,Blaine County,10,1452,746,706
Idaho,Blaine County,11,1669,807,862
Idaho,Blaine County,12,1703,838,865
Idaho,Blaine County,13,1663,824,839
Idaho,Blaine County,14,1331,663,668
Idaho,Blaine County,15,953,484,469
Idaho,Blaine County,16,523,295,228
Idaho,Blaine County,17,314,163,151
Idaho,Blaine County,18,277,112,165
Idaho,Boise County,0,6824,3523,3301
Idaho,Boise County,1,218,125,93
Idaho,Boise County,2,319,172,147
Idaho,Boise County,3,421,213,208
Idaho,Boise County,4,437,225,212
Idaho,Boise County,5,244,115,129
Idaho,Boise County,6,218,122,96
Idaho,Boise County,7,244,112,132
Idaho,Boise County,8,298,156,142
Idaho,Boise County,9,384,181,203
Idaho,Boise County,10,431,211,220
Idaho,Boise County,11,632,321,311
Idaho,Boise County,12,732,354,378
Idaho,Boise County,13,795,406,389
Idaho,Boise County,14,610,337,273
Idaho,Boise County,15,449,262,187
Idaho,Boise County,16,191,117,74
Idaho,Boise County,17,108,60,48
Idaho,Boise County,18,93,34,59
Idaho,Bonner County,0,41585,20775,20810
Idaho,Bonner County,1,2033,992,1041
Idaho,Bonner County,2,2285,1192,1093
Idaho,Bonner County,3,2538,1302,1236
Idaho,Bonner County,4,2410,1227,1183
Idaho,Bonner County,5,1841,964,877
Idaho,Bonner County,6,1860,895,965
Idaho,Bonner County,7,2087,1051,1036
Idaho,Bonner County,8,2180,1091,1089
Idaho,Bonner County,9,2342,1134,1208
Idaho,Bonner County,10,2388,1199,1189
Idaho,Bonner County,11,3084,1501,1583
Idaho,Bonner County,12,3733,1811,1922
Idaho,Bonner County,13,3904,1913,1991
Idaho,Bonner County,14,3296,1754,1542
Idaho,Bonner County,15,2344,1221,1123
Idaho,Bonner County,16,1525,788,737
Idaho,Bonner County,17,881,426,455
Idaho,Bonner County,18,854,314,540
Idaho,Bonneville County,0,108623,53908,54715
Idaho,Bonneville County,1,9630,4803,4827
Idaho,Bonneville County,2,10003,5124,4879
Idaho,Bonneville County,3,9332,4727,4605
Idaho,Bonneville County,4,7629,3941,3688
Idaho,Bonneville County,5,6541,3287,3254
Idaho,Bonneville County,6,7246,3452,3794
Idaho,Bonneville County,7,8101,4121,3980
Idaho,Bonneville County,8,7000,3522,3478
Idaho,Bonneville County,9,6091,3042,3049
Idaho,Bonneville County,10,5651,2854,2797
Idaho,Bonneville County,11,6503,3291,3212
Idaho,Bonneville County,12,6226,3076,3150
Idaho,Bonneville County,13,5519,2696,2823
Idaho,Bonneville County,14,4288,2126,2162
Idaho,Bonneville County,15,3245,1474,1771
Idaho,Bonneville County,16,2244,1039,1205
Idaho,Bonneville County,17,1632,707,925
Idaho,Bonneville County,18,1742,626,1116
Idaho,Boundary County,0,10979,5558,5421
Idaho,Boundary County,1,560,309,251
Idaho,Boundary County,2,655,341,314
Idaho,Boundary County,3,792,399,393
Idaho,Boundary County,4,786,414,372
Idaho,Boundary County,5,486,269,217
Idaho,Boundary County,6,449,232,217
Idaho,Boundary County,7,573,275,298
Idaho,Boundary County,8,598,315,283
Idaho,Boundary County,9,612,299,313
Idaho,Boundary County,10,631,332,299
Idaho,Boundary County,11,774,378,396
Idaho,Boundary County,12,862,398,464
Idaho,Boundary County,13,950,463,487
Idaho,Boundary County,14,822,419,403
Idaho,Boundary County,15,587,309,278
Idaho,Boundary County,16,365,217,148
Idaho,Boundary County,17,255,120,135
Idaho,Boundary County,18,222,69,153
Idaho,Butte County,0,2622,1325,1297
Idaho,Butte County,1,128,66,62
Idaho,Butte County,2,213,105,108
Idaho,Butte County,3,191,95,96
Idaho,Butte County,4,203,110,93
Idaho,Butte County,5,125,67,58
Idaho,Butte County,6,106,54,52
Idaho,Butte County,7,135,65,70
Idaho,Butte County,8,136,63,73
Idaho,Butte County,9,127,69,58
Idaho,Butte County,10,126,64,62
Idaho,Butte County,11,188,90,98
Idaho,Butte County,12,231,117,114
Idaho,Butte County,13,200,95,105
Idaho,Butte County,14,172,104,68
Idaho,Butte County,15,126,65,61
Idaho,Butte County,16,102,52,50
Idaho,Butte County,17,65,28,37
Idaho,Butte County,18,48,16,32
Idaho,Camas County,0,1039,532,507
Idaho,Camas County,1,59,27,32
Idaho,Camas County,2,86,40,46
Idaho,Camas County,3,62,29,33
Idaho,Camas County,4,63,33,30
Idaho,Camas County,5,29,18,11
Idaho,Camas County,6,34,18,16
Idaho,Camas County,7,63,24,39
Idaho,Camas County,8,86,43,43
Idaho,Camas County,9,59,27,32
Idaho,Camas County,10,52,29,23
Idaho,Camas County,11,92,48,44
Idaho,Camas County,12,81,44,37
Idaho,Camas County,13,80,43,37
Idaho,Camas County,14,74,44,30
Idaho,Camas County,15,50,34,16
Idaho,Camas County,16,33,15,18
Idaho,Camas County,17,17,4,13
Idaho,Camas County,18,19,12,7
Idaho,Canyon County,0,203143,100279,102864
Idaho,Canyon County,1,16132,8053,8079
Idaho,Canyon County,2,17810,9107,8703
Idaho,Canyon County,3,17135,8732,8403
Idaho,Canyon County,4,15665,7986,7679
Idaho,Canyon County,5,13446,6752,6694
Idaho,Canyon County,6,13156,6334,6822
Idaho,Canyon County,7,13728,6730,6998
Idaho,Canyon County,8,13291,6575,6716
Idaho,Canyon County,9,12780,6337,6443
Idaho,Canyon County,10,11658,5915,5743
Idaho,Canyon County,11,11903,5800,6103
Idaho,Canyon County,12,10982,5358,5624
Idaho,Canyon County,13,10144,4870,5274
Idaho,Canyon County,14,8892,4275,4617
Idaho,Canyon County,15,6646,3198,3448
Idaho,Canyon County,16,4222,2016,2206
Idaho,Canyon County,17,2770,1217,1553
Idaho,Canyon County,18,2783,1024,1759
Idaho,Caribou County,0,6837,3435,3402
Idaho,Caribou County,1,507,265,242
Idaho,Caribou County,2,553,258,295
Idaho,Caribou County,3,581,309,272
Idaho,Caribou County,4,477,253,224
Idaho,Caribou County,5,340,196,144
Idaho,Caribou County,6,328,153,175
Idaho,Caribou County,7,420,196,224
Idaho,Caribou County,8,438,249,189
Idaho,Caribou County,9,356,180,176
Idaho,Caribou County,10,356,165,191
Idaho,Caribou County,11,409,210,199
Idaho,Caribou County,12,497,262,235
Idaho,Caribou County,13,427,213,214
Idaho,Caribou County,14,333,164,169
Idaho,Caribou County,15,313,155,158
Idaho,Caribou County,16,203,85,118
Idaho,Caribou County,17,153,68,85
Idaho,Caribou County,18,146,54,92
Idaho,Cassia County,0,23540,11931,11609
Idaho,Cassia County,1,1947,962,985
Idaho,Cassia County,2,2244,1141,1103
Idaho,Cassia County,3,2213,1161,1052
Idaho,Cassia County,4,1811,946,865
Idaho,Cassia County,5,1505,815,690
Idaho,Cassia County,6,1334,678,656
Idaho,Cassia County,7,1497,747,750
Idaho,Cassia County,8,1382,721,661
Idaho,Cassia County,9,1292,657,635
Idaho,Cassia County,10,1184,607,577
Idaho,Cassia County,11,1380,714,666
Idaho,Cassia County,12,1387,717,670
Idaho,Cassia County,13,1177,593,584
Idaho,Cassia County,14,963,482,481
Idaho,Cassia County,15,775,381,394
Idaho,Cassia County,16,601,283,318
Idaho,Cassia County,17,422,172,250
Idaho,Cassia County,18,426,154,272
Idaho,Clark County,0,867,457,410
Idaho,Clark County,1,51,24,27
Idaho,Clark County,2,73,39,34
Idaho,Clark County,3,76,37,39
Idaho,Clark County,4,70,33,37
Idaho,Clark County,5,46,23,23
Idaho,Clark County,6,56,39,17
Idaho,Clark County,7,59,35,24
Idaho,Clark County,8,43,17,26
Idaho,Clark County,9,53,29,24
Idaho,Clark County,10,54,27,27
Idaho,Clark County,11,55,25,30
Idaho,Clark County,12,54,38,16
Idaho,Clark County,13,49,28,21
Idaho,Clark County,14,39,17,22
Idaho,Clark County,15,28,14,14
Idaho,Clark County,16,28,14,14
Idaho,Clark County,17,22,10,12
Idaho,Clark County,18,11,8,3
Idaho,Clearwater County,0,8562,4689,3873
Idaho,Clearwater County,1,339,151,188
Idaho,Clearwater County,2,376,200,176
Idaho,Clearwater County,3,393,218,175
Idaho,Clearwater County,4,425,242,183
Idaho,Clearwater County,5,409,271,138
Idaho,Clearwater County,6,384,240,144
Idaho,Clearwater County,7,426,265,161
Idaho,Clearwater County,8,444,265,179
Idaho,Clearwater County,9,443,258,185
Idaho,Clearwater County,10,573,326,247
Idaho,Clearwater County,11,723,374,349
Idaho,Clearwater County,12,696,347,349
Idaho,Clearwater County,13,757,397,360
Idaho,Clearwater County,14,728,398,330
Idaho,Clearwater County,15,582,340,242
Idaho,Clearwater County,16,422,205,217
Idaho,Clearwater County,17,226,111,115
Idaho,Clearwater County,18,216,81,135
Idaho,Custer County,0,4140,2124,2016
Idaho,Custer County,1,180,98,82
Idaho,Custer County,2,192,97,95
Idaho,Custer County,3,209,112,97
Idaho,Custer County,4,209,105,104
Idaho,Custer County,5,176,84,92
Idaho,Custer County,6,193,95,98
Idaho,Custer County,7,186,97,89
Idaho,Custer County,8,180,90,90
Idaho,Custer County,9,239,123,116
Idaho,Custer County,10,219,110,109
Idaho,Custer County,11,351,170,181
Idaho,Custer County,12,389,201,188
Idaho,Custer County,13,430,235,195
Idaho,Custer County,14,340,192,148
Idaho,Custer County,15,277,154,123
Idaho,Custer County,16,152,75,77
Idaho,Custer County,17,114,46,68
Idaho,Custer County,18,104,40,64
Idaho,Elmore County,0,26094,13624,12470
Idaho,Elmore County,1,2095,1074,1021
Idaho,Elmore County,2,1985,1005,980
Idaho,Elmore County,3,1764,915,849
Idaho,Elmore County,4,1703,894,809
Idaho,Elmore County,5,2853,1774,1079
Idaho,Elmore County,6,2248,1235,1013
Idaho,Elmore County,7,1880,992,888
Idaho,Elmore County,8,1481,745,736
Idaho,Elmore County,9,1370,717,653
Idaho,Elmore County,10,1345,663,682
Idaho,Elmore County,11,1603,807,796
Idaho,Elmore County,12,1492,739,753
Idaho,Elmore County,13,1188,616,572
Idaho,Elmore County,14,1003,504,499
Idaho,Elmore County,15,835,387,448
Idaho,Elmore County,16,573,269,304
Idaho,Elmore County,17,361,178,183
Idaho,Elmore County,18,315,110,205
Idaho,Franklin County,0,13021,6599,6422
Idaho,Franklin County,1,1043,482,561
Idaho,Franklin County,2,1261,676,585
Idaho,Franklin County,3,1330,724,606
Idaho,Franklin County,4,1130,579,551
Idaho,Franklin County,5,702,378,324
Idaho,Franklin County,6,607,294,313
Idaho,Franklin County,7,758,379,379
Idaho,Franklin County,8,889,443,446
Idaho,Franklin County,9,740,381,359
Idaho,Franklin County,10,637,322,315
Idaho,Franklin County,11,752,366,386
Idaho,Franklin County,12,746,390,356
Idaho,Franklin County,13,654,336,318
Idaho,Franklin County,14,527,261,266
Idaho,Franklin County,15,456,208,248
Idaho,Franklin County,16,332,177,155
Idaho,Franklin County,17,222,103,119
Idaho,Franklin County,18,235,100,135
Idaho,Fremont County,0,12867,6723,6144
Idaho,Fremont County,1,886,453,433
Idaho,Fremont County,2,997,508,489
Idaho,Fremont County,3,1066,558,508
Idaho,Fremont County,4,1083,613,470
Idaho,Fremont County,5,685,369,316
Idaho,Fremont County,6,668,341,327
Idaho,Fremont County,7,747,384,363
Idaho,Fremont County,8,842,458,384
Idaho,Fremont County,9,695,347,348
Idaho,Fremont County,10,723,387,336
Idaho,Fremont County,11,816,443,373
Idaho,Fremont County,12,836,434,402
Idaho,Fremont County,13,765,404,361
Idaho,Fremont County,14,649,316,333
Idaho,Fremont County,15,560,289,271
Idaho,Fremont County,16,362,200,162
Idaho,Fremont County,17,286,134,152
Idaho,Fremont County,18,201,85,116
Idaho,Gem County,0,16866,8385,8481
Idaho,Gem County,1,958,471,487
Idaho,Gem County,2,1107,593,514
Idaho,Gem County,3,1195,617,578
Idaho,Gem County,4,1075,563,512
Idaho,Gem County,5,878,466,412
Idaho,Gem County,6,770,384,386
Idaho,Gem County,7,839,412,427
Idaho,Gem County,8,806,390,416
Idaho,Gem County,9,857,419,438
Idaho,Gem County,10,1064,502,562
Idaho,Gem County,11,1258,613,645
Idaho,Gem County,12,1288,635,653
Idaho,Gem County,13,1169,576,593
Idaho,Gem County,14,1125,553,572
Idaho,Gem County,15,956,477,479
Idaho,Gem County,16,663,342,321
Idaho,Gem County,17,432,193,239
Idaho,Gem County,18,426,179,247
Idaho,Gooding County,0,15064,7735,7329
Idaho,Gooding County,1,1033,540,493
Idaho,Gooding County,2,1253,637,616
Idaho,Gooding County,3,1232,620,612
Idaho,Gooding County,4,1131,608,523
Idaho,Gooding County,5,894,491,403
Idaho,Gooding County,6,790,405,385
Idaho,Gooding County,7,917,474,443
Idaho,Gooding County,8,934,513,421
Idaho,Gooding County,9,829,421,408
Idaho,Gooding County,10,862,443,419
Idaho,Gooding County,11,964,501,463
Idaho,Gooding County,12,946,490,456
Idaho,Gooding County,13,801,405,396
Idaho,Gooding County,14,755,372,383
Idaho,Gooding County,15,609,306,303
Idaho,Gooding County,16,463,211,252
Idaho,Gooding County,17,338,167,171
Idaho,Gooding County,18,313,131,182
Idaho,Idaho County,0,16215,8465,7750
Idaho,Idaho County,1,849,423,426
Idaho,Idaho County,2,870,461,409
Idaho,Idaho County,3,916,478,438
Idaho,Idaho County,4,956,533,423
Idaho,Idaho County,5,779,471,308
Idaho,Idaho County,6,670,362,308
Idaho,Idaho County,7,785,439,346
Idaho,Idaho County,8,732,394,338
Idaho,Idaho County,9,775,391,384
Idaho,Idaho County,10,909,473,436
Idaho,Idaho County,11,1161,548,613
Idaho,Idaho County,12,1429,715,714
Idaho,Idaho County,13,1486,773,713
Idaho,Idaho County,14,1307,691,616
Idaho,Idaho County,15,1017,544,473
Idaho,Idaho County,16,685,374,311
Idaho,Idaho County,17,469,218,251
Idaho,Idaho County,18,420,177,243
Idaho,Jefferson County,0,27021,13592,13429
Idaho,Jefferson County,1,2383,1235,1148
Idaho,Jefferson County,2,2851,1411,1440
Idaho,Jefferson County,3,2657,1325,1332
Idaho,Jefferson County,4,2179,1136,1043
Idaho,Jefferson County,5,1490,749,741
Idaho,Jefferson County,6,1552,786,766
Idaho,Jefferson County,7,1822,872,950
Idaho,Jefferson County,8,1822,963,859
Idaho,Jefferson County,9,1485,736,749
Idaho,Jefferson County,10,1374,700,674
Idaho,Jefferson County,11,1613,804,809
Idaho,Jefferson County,12,1558,804,754
Idaho,Jefferson County,13,1233,619,614
Idaho,Jefferson County,14,1046,525,521
Idaho,Jefferson County,15,746,378,368
Idaho,Jefferson County,16,524,258,266
Idaho,Jefferson County,17,366,155,211
Idaho,Jefferson County,18,320,136,184
Idaho,Jerome County,0,22818,11570,11248
Idaho,Jerome County,1,2103,1065,1038
Idaho,Jerome County,2,2110,1088,1022
Idaho,Jerome County,3,1848,904,944
Idaho,Jerome County,4,1534,806,728
Idaho,Jerome County,5,1532,810,722
Idaho,Jerome County,6,1539,783,756
Idaho,Jerome County,7,1590,844,746
Idaho,Jerome County,8,1310,667,643
Idaho,Jerome County,9,1247,628,619
Idaho,Jerome County,10,1283,648,635
Idaho,Jerome County,11,1405,749,656
Idaho,Jerome County,12,1356,674,682
Idaho,Jerome County,13,1209,613,596
Idaho,Jerome County,14,901,434,467
Idaho,Jerome County,15,719,361,358
Idaho,Jerome County,16,495,240,255
Idaho,Jerome County,17,365,166,199
Idaho,Jerome County,18,272,90,182
Idaho,Kootenai County,0,147326,72796,74530
Idaho,Kootenai County,1,8929,4644,4285
Idaho,Kootenai County,2,9605,4975,4630
Idaho,Kootenai County,3,10109,5166,4943
Idaho,Kootenai County,4,9449,4913,4536
Idaho,Kootenai County,5,8917,4641,4276
Idaho,Kootenai County,6,9027,4377,4650
Idaho,Kootenai County,7,9190,4569,4621
Idaho,Kootenai County,8,8720,4367,4353
Idaho,Kootenai County,9,8857,4489,4368
Idaho,Kootenai County,10,9157,4438,4719
Idaho,Kootenai County,11,10155,4884,5271
Idaho,Kootenai County,12,10228,4944,5284
Idaho,Kootenai County,13,9900,4649,5251
Idaho,Kootenai County,14,8745,4211,4534
Idaho,Kootenai County,15,6314,3069,3245
Idaho,Kootenai County,16,4307,2114,2193
Idaho,Kootenai County,17,2900,1335,1565
Idaho,Kootenai County,18,2817,1011,1806
Idaho,Latah County,0,38411,19797,18614
Idaho,Latah County,1,2233,1161,1072
Idaho,Latah County,2,1923,963,960
Idaho,Latah County,3,1826,952,874
Idaho,Latah County,4,3793,1950,1843
Idaho,Latah County,5,7143,3951,3192
Idaho,Latah County,6,2988,1619,1369
Idaho,Latah County,7,2378,1231,1147
Idaho,Latah County,8,1867,987,880
Idaho,Latah County,9,1840,933,907
Idaho,Latah County,10,1753,903,850
Idaho,Latah County,11,2015,980,1035
Idaho,Latah County,12,2116,1011,1105
Idaho,Latah County,13,1999,1009,990
Idaho,Latah County,14,1546,796,750
Idaho,Latah County,15,1128,541,587
Idaho,Latah County,16,735,380,355
Idaho,Latah County,17,546,233,313
Idaho,Latah County,18,582,197,385
Idaho,Lemhi County,0,7726,3918,3808
Idaho,Lemhi County,1,311,158,153
Idaho,Lemhi County,2,413,207,206
Idaho,Lemhi County,3,412,208,204
Idaho,Lemhi County,4,393,226,167
Idaho,Lemhi County,5,304,168,136
Idaho,Lemhi County,6,309,154,155
Idaho,Lemhi County,7,399,194,205
Idaho,Lemhi County,8,341,176,165
Idaho,Lemhi County,9,336,165,171
Idaho,Lemhi County,10,402,193,209
Idaho,Lemhi County,11,577,285,292
Idaho,Lemhi County,12,697,332,365
Idaho,Lemhi County,13,721,360,361
Idaho,Lemhi County,14,694,369,325
Idaho,Lemhi County,15,574,309,265
Idaho,Lemhi County,16,370,194,176
Idaho,Lemhi County,17,218,113,105
Idaho,Lemhi County,18,255,107,148
Idaho,Lewis County,0,3838,1926,1912
Idaho,Lewis County,1,202,101,101
Idaho,Lewis County,2,277,145,132
Idaho,Lewis County,3,261,122,139
Idaho,Lewis County,4,217,119,98
Idaho,Lewis County,5,147,79,68
Idaho,Lewis County,6,166,84,82
Idaho,Lewis County,7,210,98,112
Idaho,Lewis County,8,155,84,71
Idaho,Lewis County,9,160,77,83
Idaho,Lewis County,10,190,85,105
Idaho,Lewis County,11,303,162,141
Idaho,Lewis County,12,344,169,175
Idaho,Lewis County,13,280,153,127
Idaho,Lewis County,14,268,132,136
Idaho,Lewis County,15,248,112,136
Idaho,Lewis County,16,184,96,88
Idaho,Lewis County,17,112,60,52
Idaho,Lewis County,18,114,48,66
Idaho,Lincoln County,0,5316,2739,2577
Idaho,Lincoln County,1,371,188,183
Idaho,Lincoln County,2,495,264,231
Idaho,Lincoln County,3,499,261,238
Idaho,Lincoln County,4,424,213,211
Idaho,Lincoln County,5,322,182,140
Idaho,Lincoln County,6,274,124,150
Idaho,Lincoln County,7,372,189,183
Idaho,Lincoln County,8,354,199,155
Idaho,Lincoln County,9,317,155,162
Idaho,Lincoln County,10,311,171,140
Idaho,Lincoln County,11,301,150,151
Idaho,Lincoln County,12,335,164,171
Idaho,Lincoln County,13,289,159,130
Idaho,Lincoln County,14,222,118,104
Idaho,Lincoln County,15,150,72,78
Idaho,Lincoln County,16,106,48,58
Idaho,Lincoln County,17,83,39,44
Idaho,Lincoln County,18,91,43,48
Idaho,Madison County,0,38038,19123,18915
Idaho,Madison County,1,3800,2040,1760
Idaho,Madison County,2,2541,1338,1203
Idaho,Madison County,3,2455,1247,1208
Idaho,Madison County,4,4602,1621,2981
Idaho,Madison County,5,8559,4600,3959
Idaho,Madison County,6,4260,2420,1840
Idaho,Madison County,7,1905,1040,865
Idaho,Madison County,8,1527,776,751
Idaho,Madison County,9,1349,655,694
Idaho,Madison County,10,1152,566,586
Idaho,Madison County,11,1273,621,652
Idaho,Madison County,12,1295,619,676
Idaho,Madison County,13,1036,533,503
Idaho,Madison County,14,740,352,388
Idaho,Madison County,15,564,270,294
Idaho,Madison County,16,457,210,247
Idaho,Madison County,17,281,128,153
Idaho,Madison County,18,242,87,155
Idaho,Minidoka County,0,20323,10279,10044
Idaho,Minidoka County,1,1661,842,819
Idaho,Minidoka County,2,1715,892,823
Idaho,Minidoka County,3,1545,804,741
Idaho,Minidoka County,4,1473,768,705
Idaho,Minidoka County,5,1269,670,599
Idaho,Minidoka County,6,1178,606,572
Idaho,Minidoka County,7,1175,585,590
Idaho,Minidoka County,8,1232,643,589
Idaho,Minidoka County,9,1048,526,522
Idaho,Minidoka County,10,1099,553,546
Idaho,Minidoka County,11,1288,636,652
Idaho,Minidoka County,12,1357,683,674
Idaho,Minidoka County,13,1134,579,555
Idaho,Minidoka County,14,976,497,479
Idaho,Minidoka County,15,780,377,403
Idaho,Minidoka County,16,564,268,296
Idaho,Minidoka County,17,381,171,210
Idaho,Minidoka County,18,448,179,269
Idaho,Nez Perce County,0,40007,19795,20212
Idaho,Nez Perce County,1,2483,1313,1170
Idaho,Nez Perce County,2,2275,1221,1054
Idaho,Nez Perce County,3,2420,1268,1152
Idaho,Nez Perce County,4,2388,1241,1147
Idaho,Nez Perce County,5,2789,1387,1402
Idaho,Nez Perce County,6,2671,1327,1344
Idaho,Nez Perce County,7,2349,1172,1177
Idaho,Nez Perce County,8,2164,1088,1076
Idaho,Nez Perce County,9,2250,1150,1100
Idaho,Nez Perce County,10,2414,1132,1282
Idaho,Nez Perce County,11,2760,1348,1412
Idaho,Nez Perce County,12,2883,1450,1433
Idaho,Nez Perce County,13,2584,1253,1331
Idaho,Nez Perce County,14,2243,1082,1161
Idaho,Nez Perce County,15,1765,825,940
Idaho,Nez Perce County,16,1348,626,722
Idaho,Nez Perce County,17,1029,447,582
Idaho,Nez Perce County,18,1192,465,727
Idaho,Oneida County,0,4184,2074,2110
Idaho,Oneida County,1,279,118,161
Idaho,Oneida County,2,340,170,170
Idaho,Oneida County,3,357,183,174
Idaho,Oneida County,4,300,162,138
Idaho,Oneida County,5,182,102,80
Idaho,Oneida County,6,157,69,88
Idaho,Oneida County,7,234,108,126
Idaho,Oneida County,8,231,116,115
Idaho,Oneida County,9,221,114,107
Idaho,Oneida County,10,208,99,109
Idaho,Oneida County,11,263,126,137
Idaho,Oneida County,12,321,170,151
Idaho,Oneida County,13,285,152,133
Idaho,Oneida County,14,240,122,118
Idaho,Oneida County,15,173,84,89
Idaho,Oneida County,16,148,78,70
Idaho,Oneida County,17,114,50,64
Idaho,Oneida County,18,131,51,80
Idaho,Owyhee County,0,11353,5776,5577
Idaho,Owyhee County,1,721,341,380
Idaho,Owyhee County,2,873,455,418
Idaho,Owyhee County,3,912,462,450
Idaho,Owyhee County,4,839,445,394
Idaho,Owyhee County,5,687,355,332
Idaho,Owyhee County,6,545,302,243
Idaho,Owyhee County,7,633,315,318
Idaho,Owyhee County,8,687,345,342
Idaho,Owyhee County,9,669,337,332
Idaho,Owyhee County,10,651,333,318
Idaho,Owyhee County,11,783,401,382
Idaho,Owyhee County,12,786,417,369
Idaho,Owyhee County,13,714,371,343
Idaho,Owyhee County,14,631,318,313
Idaho,Owyhee County,15,484,227,257
Idaho,Owyhee County,16,340,168,172
Idaho,Owyhee County,17,211,119,92
Idaho,Owyhee County,18,187,65,122
Idaho,Payette County,0,22836,11314,11522
Idaho,Payette County,1,1583,799,784
Idaho,Payette County,2,1750,885,865
Idaho,Payette County,3,1788,944,844
Idaho,Payette County,4,1622,854,768
Idaho,Payette County,5,1358,718,640
Idaho,Payette County,6,1241,631,610
Idaho,Payette County,7,1245,586,659
Idaho,Payette County,8,1321,646,675
Idaho,Payette County,9,1292,625,667
Idaho,Payette County,10,1379,682,697
Idaho,Payette County,11,1625,776,849
Idaho,Payette County,12,1443,704,739
Idaho,Payette County,13,1316,637,679
Idaho,Payette County,14,1217,575,642
Idaho,Payette County,15,1016,493,523
Idaho,Payette County,16,777,382,395
Idaho,Payette County,17,459,207,252
Idaho,Payette County,18,404,170,234
Idaho,Power County,0,7617,3877,3740
Idaho,Power County,1,753,364,389
Idaho,Power County,2,651,338,313
Idaho,Power County,3,569,309,260
Idaho,Power County,4,536,270,266
Idaho,Power County,5,473,249,224
Idaho,Power County,6,457,241,216
Idaho,Power County,7,418,199,219
Idaho,Power County,8,418,215,203
Idaho,Power County,9,372,192,180
Idaho,Power County,10,432,221,211
Idaho,Power County,11,485,249,236
Idaho,Power County,12,527,274,253
Idaho,Power County,13,469,252,217
Idaho,Power County,14,350,167,183
Idaho,Power County,15,280,138,142
Idaho,Power County,16,188,92,96
Idaho,Power County,17,136,66,70
Idaho,Power County,18,103,41,62
Idaho,Shoshone County,0,12390,6254,6136
Idaho,Shoshone County,1,640,342,298
Idaho,Shoshone County,2,637,333,304
Idaho,Shoshone County,3,716,363,353
Idaho,Shoshone County,4,700,364,336
Idaho,Shoshone County,5,623,329,294
Idaho,Shoshone County,6,613,315,298
Idaho,Shoshone County,7,607,313,294
Idaho,Shoshone County,8,617,309,308
Idaho,Shoshone County,9,696,348,348
Idaho,Shoshone County,10,776,394,382
Idaho,Shoshone County,11,968,515,453
Idaho,Shoshone County,12,1075,499,576
Idaho,Shoshone County,13,1030,542,488
Idaho,Shoshone County,14,938,478,460
Idaho,Shoshone County,15,649,337,312
Idaho,Shoshone County,16,505,230,275
Idaho,Shoshone County,17,331,144,187
Idaho,Shoshone County,18,269,99,170
Idaho,Teton County,0,10341,5356,4985
Idaho,Teton County,1,811,366,445
Idaho,Teton County,2,855,426,429
Idaho,Teton County,3,782,416,366
Idaho,Teton County,4,633,331,302
Idaho,Teton County,5,464,268,196
Idaho,Teton County,6,549,299,250
Idaho,Teton County,7,817,397,420
Idaho,Teton County,8,972,520,452
Idaho,Teton County,9,911,477,434
Idaho,Teton County,10,764,400,364
Idaho,Teton County,11,682,371,311
Idaho,Teton County,12,645,338,307
Idaho,Teton County,13,571,299,272
Idaho,Teton County,14,387,200,187
Idaho,Teton County,15,204,111,93
Idaho,Teton County,16,119,64,55
Idaho,Teton County,17,99,47,52
Idaho,Teton County,18,76,26,50
Idaho,Twin Falls County,0,80914,39920,40994
Idaho,Twin Falls County,1,6237,3183,3054
Idaho,Twin Falls County,2,6665,3402,3263
Idaho,Twin Falls County,3,6073,3082,2991
Idaho,Twin Falls County,4,5364,2741,2623
Idaho,Twin Falls County,5,5318,2600,2718
Idaho,Twin Falls County,6,5434,2642,2792
Idaho,Twin Falls County,7,5667,2836,2831
Idaho,Twin Falls County,8,5194,2647,2547
Idaho,Twin Falls County,9,4504,2296,2208
Idaho,Twin Falls County,10,4272,2153,2119
Idaho,Twin Falls County,11,4972,2501,2471
Idaho,Twin Falls County,12,4915,2349,2566
Idaho,Twin Falls County,13,4347,2086,2261
Idaho,Twin Falls County,14,3711,1777,1934
Idaho,Twin Falls County,15,2880,1387,1493
Idaho,Twin Falls County,16,2235,996,1239
Idaho,Twin Falls County,17,1535,656,879
Idaho,Twin Falls County,18,1591,586,1005
Idaho,Valley County,0,9826,5103,4723
Idaho,Valley County,1,427,232,195
Idaho,Valley County,2,521,285,236
Idaho,Valley County,3,517,263,254
Idaho,Valley County,4,477,255,222
Idaho,Valley County,5,380,197,183
Idaho,Valley County,6,426,234,192
Idaho,Valley County,7,528,260,268
Idaho,Valley County,8,573,305,268
Idaho,Valley County,9,602,327,275
Idaho,Valley County,10,563,265,298
Idaho,Valley County,11,699,339,360
Idaho,Valley County,12,936,460,476
Idaho,Valley County,13,1054,536,518
Idaho,Valley County,14,853,496,357
Idaho,Valley County,15,575,301,274
Idaho,Valley County,16,360,191,169
Idaho,Valley County,17,181,97,84
Idaho,Valley County,18,154,60,94
Idaho,Washington County,0,10021,4997,5024
Idaho,Washington County,1,504,288,216
Idaho,Washington County,2,636,310,326
Idaho,Washington County,3,729,358,371
Idaho,Washington County,4,726,375,351
Idaho,Washington County,5,517,278,239
Idaho,Washington County,6,406,210,196
Idaho,Washington County,7,458,221,237
Idaho,Washington County,8,510,257,253
Idaho,Washington County,9,560,286,274
Idaho,Washington County,10,562,274,288
Idaho,Washington County,11,689,341,348
Idaho,Washington County,12,712,331,381
Idaho,Washington County,13,738,365,373
Idaho,Washington County,14,719,356,363
Idaho,Washington County,15,580,296,284
Idaho,Washington County,16,416,223,193
Idaho,Washington County,17,291,128,163
Idaho,Washington County,18,268,100,168
Illinois,Adams County,0,66988,32743,34245
Illinois,Adams County,1,4146,2153,1993
Illinois,Adams County,2,4248,2170,2078
Illinois,Adams County,3,4170,2145,2025
Illinois,Adams County,4,4097,2115,1982
Illinois,Adams County,5,4272,2114,2158
Illinois,Adams County,6,3985,1982,2003
Illinois,Adams County,7,4130,2034,2096
Illinois,Adams County,8,3628,1844,1784
Illinois,Adams County,9,3744,1868,1876
Illinois,Adams County,10,4097,2027,2070
Illinois,Adams County,11,4937,2451,2486
Illinois,Adams County,12,4775,2374,2401
Illinois,Adams County,13,4221,2063,2158
Illinois,Adams County,14,3597,1684,1913
Illinois,Adams County,15,2810,1278,1532
Illinois,Adams County,16,2172,951,1221
Illinois,Adams County,17,1826,767,1059
Illinois,Adams County,18,2133,723,1410
Illinois,Alexander County,0,7492,3769,3723
Illinois,Alexander County,1,476,225,251
Illinois,Alexander County,2,519,256,263
Illinois,Alexander County,3,485,248,237
Illinois,Alexander County,4,375,201,174
Illinois,Alexander County,5,485,257,228
Illinois,Alexander County,6,417,224,193
Illinois,Alexander County,7,427,235,192
Illinois,Alexander County,8,434,241,193
Illinois,Alexander County,9,400,187,213
Illinois,Alexander County,10,468,266,202
Illinois,Alexander County,11,558,283,275
Illinois,Alexander County,12,552,281,271
Illinois,Alexander County,13,535,260,275
Illinois,Alexander County,14,411,197,214
Illinois,Alexander County,15,343,157,186
Illinois,Alexander County,16,253,111,142
Illinois,Alexander County,17,181,79,102
Illinois,Alexander County,18,173,61,112
Illinois,Bond County,0,17269,9094,8175
Illinois,Bond County,1,783,416,367
Illinois,Bond County,2,937,477,460
Illinois,Bond County,3,1014,517,497
Illinois,Bond County,4,1119,586,533
Illinois,Bond County,5,1170,652,518
Illinois,Bond County,6,1124,632,492
Illinois,Bond County,7,1140,720,420
Illinois,Bond County,8,1226,688,538
Illinois,Bond County,9,1089,641,448
Illinois,Bond County,10,1132,625,507
Illinois,Bond County,11,1323,680,643
Illinois,Bond County,12,1218,611,607
Illinois,Bond County,13,1147,563,584
Illinois,Bond County,14,875,448,427
Illinois,Bond County,15,656,313,343
Illinois,Bond County,16,484,210,274
Illinois,Bond County,17,406,180,226
Illinois,Bond County,18,426,135,291
Illinois,Boone County,0,53869,26826,27043
Illinois,Boone County,1,3075,1528,1547
Illinois,Boone County,2,3888,1977,1911
Illinois,Boone County,3,4459,2247,2212
Illinois,Boone County,4,4171,2124,2047
Illinois,Boone County,5,3376,1803,1573
Illinois,Boone County,6,2645,1358,1287
Illinois,Boone County,7,2986,1442,1544
Illinois,Boone County,8,3327,1643,1684
Illinois,Boone County,9,3954,1951,2003
Illinois,Boone County,10,4033,2019,2014
Illinois,Boone County,11,3964,2047,1917
Illinois,Boone County,12,3486,1738,1748
Illinois,Boone County,13,2963,1473,1490
Illinois,Boone County,14,2537,1221,1316
Illinois,Boone County,15,2030,980,1050
Illinois,Boone County,16,1339,629,710
Illinois,Boone County,17,832,369,463
Illinois,Boone County,18,804,277,527
Illinois,Brown County,0,6832,4398,2434
Illinois,Brown County,1,259,127,132
Illinois,Brown County,2,308,150,158
Illinois,Brown County,3,302,163,139
Illinois,Brown County,4,306,180,126
Illinois,Brown County,5,689,536,153
Illinois,Brown County,6,651,519,132
Illinois,Brown County,7,611,463,148
Illinois,Brown County,8,567,433,134
Illinois,Brown County,9,528,376,152
Illinois,Brown County,10,463,321,142
Illinois,Brown County,11,509,329,180
Illinois,Brown County,12,419,250,169
Illinois,Brown County,13,331,160,171
Illinois,Brown County,14,256,119,137
Illinois,Brown County,15,212,97,115
Illinois,Brown County,16,172,79,93
Illinois,Brown County,17,121,57,64
Illinois,Brown County,18,128,39,89
Illinois,Bureau County,0,33840,16572,17268
Illinois,Bureau County,1,1704,879,825
Illinois,Bureau County,2,2050,1037,1013
Illinois,Bureau County,3,2281,1144,1137
Illinois,Bureau County,4,2101,1051,1050
Illinois,Bureau County,5,1881,958,923
Illinois,Bureau County,6,1657,825,832
Illinois,Bureau County,7,1890,980,910
Illinois,Bureau County,8,1896,953,943
Illinois,Bureau County,9,1951,950,1001
Illinois,Bureau County,10,2198,1118,1080
Illinois,Bureau County,11,2495,1237,1258
Illinois,Bureau County,12,2602,1268,1334
Illinois,Bureau County,13,2383,1178,1205
Illinois,Bureau County,14,1951,961,990
Illinois,Bureau County,15,1523,706,817
Illinois,Bureau County,16,1226,571,655
Illinois,Bureau County,17,885,366,519
Illinois,Bureau County,18,1166,390,776
Illinois,Calhoun County,0,4956,2483,2473
Illinois,Calhoun County,1,258,125,133
Illinois,Calhoun County,2,272,148,124
Illinois,Calhoun County,3,286,150,136
Illinois,Calhoun County,4,292,142,150
Illinois,Calhoun County,5,254,137,117
Illinois,Calhoun County,6,236,132,104
Illinois,Calhoun County,7,238,118,120
Illinois,Calhoun County,8,256,131,125
Illinois,Calhoun County,9,283,142,141
Illinois,Calhoun County,10,350,170,180
Illinois,Calhoun County,11,378,199,179
Illinois,Calhoun County,12,386,211,175
Illinois,Calhoun County,13,336,173,163
Illinois,Calhoun County,14,318,137,181
Illinois,Calhoun County,15,298,146,152
Illinois,Calhoun County,16,212,98,114
Illinois,Calhoun County,17,149,65,84
Illinois,Calhoun County,18,154,59,95
Illinois,Carroll County,0,14715,7351,7364
Illinois,Carroll County,1,664,332,332
Illinois,Carroll County,2,714,371,343
Illinois,Carroll County,3,865,469,396
Illinois,Carroll County,4,857,434,423
Illinois,Carroll County,5,800,414,386
Illinois,Carroll County,6,677,369,308
Illinois,Carroll County,7,776,378,398
Illinois,Carroll County,8,728,388,340
Illinois,Carroll County,9,839,431,408
Illinois,Carroll County,10,839,399,440
Illinois,Carroll County,11,1130,581,549
Illinois,Carroll County,12,1150,561,589
Illinois,Carroll County,13,1206,602,604
Illinois,Carroll County,14,1079,544,535
Illinois,Carroll County,15,870,424,446
Illinois,Carroll County,16,572,276,296
Illinois,Carroll County,17,439,199,240
Illinois,Carroll County,18,510,179,331
Illinois,Cass County,0,13156,6676,6480
Illinois,Cass County,1,845,466,379
Illinois,Cass County,2,942,482,460
Illinois,Cass County,3,893,468,425
Illinois,Cass County,4,859,451,408
Illinois,Cass County,5,756,392,364
Illinois,Cass County,6,743,417,326
Illinois,Cass County,7,840,461,379
Illinois,Cass County,8,769,377,392
Illinois,Cass County,9,825,438,387
Illinois,Cass County,10,880,438,442
Illinois,Cass County,11,956,503,453
Illinois,Cass County,12,920,454,466
Illinois,Cass County,13,771,397,374
Illinois,Cass County,14,624,296,328
Illinois,Cass County,15,497,237,260
Illinois,Cass County,16,416,179,237
Illinois,Cass County,17,302,123,179
Illinois,Cass County,18,318,97,221
Illinois,Champaign County,0,207133,103367,103766
Illinois,Champaign County,1,11485,5831,5654
Illinois,Champaign County,2,11091,5548,5543
Illinois,Champaign County,3,10518,5285,5233
Illinois,Champaign County,4,20446,10582,9864
Illinois,Champaign County,5,34121,18220,15901
Illinois,Champaign County,6,16789,8705,8084
Illinois,Champaign County,7,14253,7207,7046
Illinois,Champaign County,8,11410,5756,5654
Illinois,Champaign County,9,10778,5341,5437
Illinois,Champaign County,10,9956,4882,5074
Illinois,Champaign County,11,11398,5465,5933
Illinois,Champaign County,12,11622,5544,6078
Illinois,Champaign County,13,10348,4976,5372
Illinois,Champaign County,14,7558,3602,3956
Illinois,Champaign County,15,5065,2287,2778
Illinois,Champaign County,16,3824,1713,2111
Illinois,Champaign County,17,3006,1249,1757
Illinois,Champaign County,18,3465,1174,2291
Illinois,Christian County,0,33892,17248,16644
Illinois,Christian County,1,1858,969,889
Illinois,Christian County,2,2029,1020,1009
Illinois,Christian County,3,1999,1029,970
Illinois,Christian County,4,1983,1064,919
Illinois,Christian County,5,2069,1149,920
Illinois,Christian County,6,2035,1092,943
Illinois,Christian County,7,2060,1121,939
Illinois,Christian County,8,1939,1050,889
Illinois,Christian County,9,2110,1122,988
Illinois,Christian County,10,2226,1189,1037
Illinois,Christian County,11,2581,1340,1241
Illinois,Christian County,12,2522,1310,1212
Illinois,Christian County,13,2184,1086,1098
Illinois,Christian County,14,1803,827,976
Illinois,Christian County,15,1489,677,812
Illinois,Christian County,16,1131,527,604
Illinois,Christian County,17,879,346,533
Illinois,Christian County,18,995,330,665
Illinois,Clark County,0,16180,7953,8227
Illinois,Clark County,1,946,477,469
Illinois,Clark County,2,1032,532,500
Illinois,Clark County,3,1044,539,505
Illinois,Clark County,4,1019,502,517
Illinois,Clark County,5,907,458,449
Illinois,Clark County,6,906,471,435
Illinois,Clark County,7,929,458,471
Illinois,Clark County,8,866,427,439
Illinois,Clark County,9,1000,520,480
Illinois,Clark County,10,1058,532,526
Illinois,Clark County,11,1239,616,623
Illinois,Clark County,12,1152,608,544
Illinois,Clark County,13,1062,538,524
Illinois,Clark County,14,846,385,461
Illinois,Clark County,15,766,353,413
Illinois,Clark County,16,535,255,280
Illinois,Clark County,17,404,140,264
Illinois,Clark County,18,469,142,327
Illinois,Clay County,0,13520,6666,6854
Illinois,Clay County,1,885,464,421
Illinois,Clay County,2,844,432,412
Illinois,Clay County,3,864,440,424
Illinois,Clay County,4,758,383,375
Illinois,Clay County,5,827,417,410
Illinois,Clay County,6,680,351,329
Illinois,Clay County,7,782,381,401
Illinois,Clay County,8,756,371,385
Illinois,Clay County,9,783,419,364
Illinois,Clay County,10,803,398,405
Illinois,Clay County,11,1063,540,523
Illinois,Clay County,12,999,512,487
Illinois,Clay County,13,928,455,473
Illinois,Clay County,14,790,389,401
Illinois,Clay County,15,581,258,323
Illinois,Clay County,16,441,195,246
Illinois,Clay County,17,357,131,226
Illinois,Clay County,18,379,130,249
Illinois,Clinton County,0,37857,19603,18254
Illinois,Clinton County,1,2084,1100,984
Illinois,Clinton County,2,2246,1172,1074
Illinois,Clinton County,3,2332,1188,1144
Illinois,Clinton County,4,2266,1192,1074
Illinois,Clinton County,5,2361,1273,1088
Illinois,Clinton County,6,2457,1417,1040
Illinois,Clinton County,7,2592,1463,1129
Illinois,Clinton County,8,2377,1328,1049
Illinois,Clinton County,9,2360,1282,1078
Illinois,Clinton County,10,2670,1412,1258
Illinois,Clinton County,11,3020,1563,1457
Illinois,Clinton County,12,2754,1409,1345
Illinois,Clinton County,13,2278,1154,1124
Illinois,Clinton County,14,1772,848,924
Illinois,Clinton County,15,1430,653,777
Illinois,Clinton County,16,1078,484,594
Illinois,Clinton County,17,870,352,518
Illinois,Clinton County,18,910,313,597
Illinois,Coles County,0,53320,25735,27585
Illinois,Coles County,1,2588,1333,1255
Illinois,Coles County,2,2671,1358,1313
Illinois,Coles County,3,2692,1426,1266
Illinois,Coles County,4,4722,2183,2539
Illinois,Coles County,5,7815,3687,4128
Illinois,Coles County,6,3904,1980,1924
Illinois,Coles County,7,3012,1540,1472
Illinois,Coles County,8,2744,1363,1381
Illinois,Coles County,9,2672,1361,1311
Illinois,Coles County,10,2678,1318,1360
Illinois,Coles County,11,3278,1549,1729
Illinois,Coles County,12,3497,1715,1782
Illinois,Coles County,13,3040,1458,1582
Illinois,Coles County,14,2395,1163,1232
Illinois,Coles County,15,1814,810,1004
Illinois,Coles County,16,1466,643,823
Illinois,Coles County,17,1075,449,626
Illinois,Coles County,18,1257,399,858
Illinois,Cook County,0,5246456,2542626,2703830
Illinois,Cook County,1,338574,172244,166330
Illinois,Cook County,2,326837,165762,161075
Illinois,Cook County,3,324081,164417,159664
Illinois,Cook County,4,326887,165424,161463
Illinois,Cook County,5,365788,181615,184173
Illinois,Cook County,6,434762,214718,220044
Illinois,Cook County,7,419667,207976,211691
Illinois,Cook County,8,363285,181065,182220
Illinois,Cook County,9,350495,172892,177603
Illinois,Cook County,10,337247,166423,170824
Illinois,Cook County,11,351929,170745,181184
Illinois,Cook County,12,341591,162800,178791
Illinois,Cook County,13,285928,133525,152403
Illinois,Cook County,14,221014,101270,119744
Illinois,Cook County,15,157316,68353,88963
Illinois,Cook County,16,115777,47913,67864
Illinois,Cook County,17,86143,33584,52559
Illinois,Cook County,18,99135,31900,67235
Illinois,Crawford County,0,19393,10008,9385
Illinois,Crawford County,1,1051,503,548
Illinois,Crawford County,2,1020,494,526
Illinois,Crawford County,3,1059,530,529
Illinois,Crawford County,4,1086,567,519
Illinois,Crawford County,5,1236,707,529
Illinois,Crawford County,6,1295,745,550
Illinois,Crawford County,7,1199,710,489
Illinois,Crawford County,8,1203,696,507
Illinois,Crawford County,9,1220,685,535
Illinois,Crawford County,10,1292,716,576
Illinois,Crawford County,11,1476,780,696
Illinois,Crawford County,12,1457,750,707
Illinois,Crawford County,13,1253,636,617
Illinois,Crawford County,14,1082,509,573
Illinois,Crawford County,15,796,346,450
Illinois,Crawford County,16,676,289,387
Illinois,Crawford County,17,470,191,279
Illinois,Crawford County,18,522,154,368
Illinois,Cumberland County,0,10833,5432,5401
Illinois,Cumberland County,1,588,329,259
Illinois,Cumberland County,2,725,389,336
Illinois,Cumberland County,3,715,353,362
Illinois,Cumberland County,4,673,332,341
Illinois,Cumberland County,5,594,301,293
Illinois,Cumberland County,6,578,308,270
Illinois,Cumberland County,7,649,318,331
Illinois,Cumberland County,8,618,315,303
Illinois,Cumberland County,9,656,335,321
Illinois,Cumberland County,10,706,370,336
Illinois,Cumberland County,11,803,393,410
Illinois,Cumberland County,12,862,434,428
Illinois,Cumberland County,13,755,387,368
Illinois,Cumberland County,14,601,298,303
Illinois,Cumberland County,15,435,211,224
Illinois,Cumberland County,16,344,153,191
Illinois,Cumberland County,17,235,107,128
Illinois,Cumberland County,18,296,99,197
Illinois,DeKalb County,0,105462,52174,53288
Illinois,DeKalb County,1,6068,3076,2992
Illinois,DeKalb County,2,6403,3222,3181
Illinois,DeKalb County,3,6577,3378,3199
Illinois,DeKalb County,4,9698,4846,4852
Illinois,DeKalb County,5,16260,8035,8225
Illinois,DeKalb County,6,7459,3830,3629
Illinois,DeKalb County,7,6709,3386,3323
Illinois,DeKalb County,8,5740,2927,2813
Illinois,DeKalb County,9,5799,2919,2880
Illinois,DeKalb County,10,5788,2850,2938
Illinois,DeKalb County,11,6340,3106,3234
Illinois,DeKalb County,12,5919,2962,2957
Illinois,DeKalb County,13,4955,2437,2518
Illinois,DeKalb County,14,3794,1834,1960
Illinois,DeKalb County,15,2800,1329,1471
Illinois,DeKalb County,16,1999,859,1140
Illinois,DeKalb County,17,1492,640,852
Illinois,DeKalb County,18,1662,538,1124
Illinois,De Witt County,0,16284,8130,8154
Illinois,De Witt County,1,888,471,417
Illinois,De Witt County,2,923,508,415
Illinois,De Witt County,3,1078,535,543
Illinois,De Witt County,4,950,495,455
Illinois,De Witt County,5,889,465,424
Illinois,De Witt County,6,829,425,404
Illinois,De Witt County,7,1002,506,496
Illinois,De Witt County,8,963,497,466
Illinois,De Witt County,9,1044,539,505
Illinois,De Witt County,10,1113,567,546
Illinois,De Witt County,11,1256,633,623
Illinois,De Witt County,12,1345,692,653
Illinois,De Witt County,13,1058,509,549
Illinois,De Witt County,14,910,436,474
Illinois,De Witt County,15,773,350,423
Illinois,De Witt County,16,552,234,318
Illinois,De Witt County,17,327,139,188
Illinois,De Witt County,18,384,129,255
Illinois,Douglas County,0,19889,9874,10015
Illinois,Douglas County,1,1329,705,624
Illinois,Douglas County,2,1407,706,701
Illinois,Douglas County,3,1501,786,715
Illinois,Douglas County,4,1265,651,614
Illinois,Douglas County,5,1137,564,573
Illinois,Douglas County,6,1243,636,607
Illinois,Douglas County,7,1207,588,619
Illinois,Douglas County,8,1233,626,607
Illinois,Douglas County,9,1098,539,559
Illinois,Douglas County,10,1188,623,565
Illinois,Douglas County,11,1380,699,681
Illinois,Douglas County,12,1466,738,728
Illinois,Douglas County,13,1193,597,596
Illinois,Douglas County,14,968,485,483
Illinois,Douglas County,15,688,323,365
Illinois,Douglas County,16,637,265,372
Illinois,Douglas County,17,468,188,280
Illinois,Douglas County,18,481,155,326
Illinois,DuPage County,0,932708,457388,475320
Illinois,DuPage County,1,54817,28239,26578
Illinois,DuPage County,2,59931,30571,29360
Illinois,DuPage County,3,64117,32540,31577
Illinois,DuPage County,4,63896,32822,31074
Illinois,DuPage County,5,58192,29657,28535
Illinois,DuPage County,6,57165,29319,27846
Illinois,DuPage County,7,61069,30637,30432
Illinois,DuPage County,8,59400,29583,29817
Illinois,DuPage County,9,62203,30404,31799
Illinois,DuPage County,10,66497,32487,34010
Illinois,DuPage County,11,73621,35424,38197
Illinois,DuPage County,12,69470,33631,35839
Illinois,DuPage County,13,56800,27463,29337
Illinois,DuPage County,14,43405,20671,22734
Illinois,DuPage County,15,29564,13687,15877
Illinois,DuPage County,16,19938,8760,11178
Illinois,DuPage County,17,14699,5773,8926
Illinois,DuPage County,18,17924,5720,12204
Illinois,Edgar County,0,17841,8648,9193
Illinois,Edgar County,1,888,434,454
Illinois,Edgar County,2,1063,524,539
Illinois,Edgar County,3,1109,556,553
Illinois,Edgar County,4,1057,534,523
Illinois,Edgar County,5,951,472,479
Illinois,Edgar County,6,950,469,481
Illinois,Edgar County,7,1028,496,532
Illinois,Edgar County,8,992,501,491
Illinois,Edgar County,9,1124,588,536
Illinois,Edgar County,10,1021,518,503
Illinois,Edgar County,11,1360,676,684
Illinois,Edgar County,12,1406,692,714
Illinois,Edgar County,13,1261,645,616
Illinois,Edgar County,14,1080,510,570
Illinois,Edgar County,15,883,418,465
Illinois,Edgar County,16,643,265,378
Illinois,Edgar County,17,460,187,273
Illinois,Edgar County,18,565,163,402
Illinois,Edwards County,0,6617,3238,3379
Illinois,Edwards County,1,377,181,196
Illinois,Edwards County,2,410,215,195
Illinois,Edwards County,3,475,239,236
Illinois,Edwards County,4,397,209,188
Illinois,Edwards County,5,372,189,183
Illinois,Edwards County,6,294,150,144
Illinois,Edwards County,7,369,191,178
Illinois,Edwards County,8,372,176,196
Illinois,Edwards County,9,424,221,203
Illinois,Edwards County,10,429,217,212
Illinois,Edwards County,11,469,238,231
Illinois,Edwards County,12,515,260,255
Illinois,Edwards County,13,446,215,231
Illinois,Edwards County,14,387,192,195
Illinois,Edwards County,15,285,135,150
Illinois,Edwards County,16,235,89,146
Illinois,Edwards County,17,171,65,106
Illinois,Edwards County,18,190,56,134
Illinois,Effingham County,0,34320,17080,17240
Illinois,Effingham County,1,2228,1099,1129
Illinois,Effingham County,2,2247,1181,1066
Illinois,Effingham County,3,2205,1122,1083
Illinois,Effingham County,4,2202,1194,1008
Illinois,Effingham County,5,2236,1147,1089
Illinois,Effingham County,6,2092,1073,1019
Illinois,Effingham County,7,2133,1118,1015
Illinois,Effingham County,8,1898,976,922
Illinois,Effingham County,9,1860,963,897
Illinois,Effingham County,10,2158,1070,1088
Illinois,Effingham County,11,2650,1343,1307
Illinois,Effingham County,12,2522,1247,1275
Illinois,Effingham County,13,2113,1067,1046
Illinois,Effingham County,14,1692,809,883
Illinois,Effingham County,15,1386,616,770
Illinois,Effingham County,16,1053,462,591
Illinois,Effingham County,17,787,317,470
Illinois,Effingham County,18,858,276,582
Illinois,Fayette County,0,21870,11616,10254
Illinois,Fayette County,1,1137,589,548
Illinois,Fayette County,2,1347,694,653
Illinois,Fayette County,3,1375,694,681
Illinois,Fayette County,4,1380,752,628
Illinois,Fayette County,5,1445,862,583
Illinois,Fayette County,6,1420,829,591
Illinois,Fayette County,7,1379,764,615
Illinois,Fayette County,8,1377,837,540
Illinois,Fayette County,9,1378,756,622
Illinois,Fayette County,10,1439,816,623
Illinois,Fayette County,11,1639,872,767
Illinois,Fayette County,12,1525,797,728
Illinois,Fayette County,13,1299,652,647
Illinois,Fayette County,14,1111,553,558
Illinois,Fayette County,15,865,383,482
Illinois,Fayette County,16,684,330,354
Illinois,Fayette County,17,532,231,301
Illinois,Fayette County,18,538,205,333
Illinois,Ford County,0,13688,6773,6915
Illinois,Ford County,1,738,413,325
Illinois,Ford County,2,850,437,413
Illinois,Ford County,3,959,476,483
Illinois,Ford County,4,870,470,400
Illinois,Ford County,5,761,410,351
Illinois,Ford County,6,676,363,313
Illinois,Ford County,7,732,379,353
Illinois,Ford County,8,798,396,402
Illinois,Ford County,9,792,407,385
Illinois,Ford County,10,845,410,435
Illinois,Ford County,11,1020,510,510
Illinois,Ford County,12,1124,567,557
Illinois,Ford County,13,816,412,404
Illinois,Ford County,14,708,351,357
Illinois,Ford County,15,600,267,333
Illinois,Ford County,16,489,212,277
Illinois,Ford County,17,405,161,244
Illinois,Ford County,18,505,132,373
Illinois,Franklin County,0,39411,19358,20053
Illinois,Franklin County,1,2292,1195,1097
Illinois,Franklin County,2,2345,1239,1106
Illinois,Franklin County,3,2537,1288,1249
Illinois,Franklin County,4,2342,1209,1133
Illinois,Franklin County,5,2244,1158,1086
Illinois,Franklin County,6,2183,1095,1088
Illinois,Franklin County,7,2211,1070,1141
Illinois,Franklin County,8,2315,1130,1185
Illinois,Franklin County,9,2484,1262,1222
Illinois,Franklin County,10,2545,1292,1253
Illinois,Franklin County,11,2811,1379,1432
Illinois,Franklin County,12,2824,1411,1413
Illinois,Franklin County,13,2606,1256,1350
Illinois,Franklin County,14,2367,1126,1241
Illinois,Franklin County,15,1977,907,1070
Illinois,Franklin County,16,1440,672,768
Illinois,Franklin County,17,944,387,557
Illinois,Franklin County,18,944,282,662
Illinois,Fulton County,0,36007,18790,17217
Illinois,Fulton County,1,1819,934,885
Illinois,Fulton County,2,1935,987,948
Illinois,Fulton County,3,2167,1128,1039
Illinois,Fulton County,4,2109,1130,979
Illinois,Fulton County,5,2141,1264,877
Illinois,Fulton County,6,2151,1235,916
Illinois,Fulton County,7,2261,1325,936
Illinois,Fulton County,8,2289,1279,1010
Illinois,Fulton County,9,2349,1352,997
Illinois,Fulton County,10,2390,1306,1084
Illinois,Fulton County,11,2594,1368,1226
Illinois,Fulton County,12,2546,1253,1293
Illinois,Fulton County,13,2446,1212,1234
Illinois,Fulton County,14,2005,976,1029
Illinois,Fulton County,15,1611,757,854
Illinois,Fulton County,16,1211,553,658
Illinois,Fulton County,17,937,387,550
Illinois,Fulton County,18,1046,344,702
Illinois,Gallatin County,0,5291,2566,2725
Illinois,Gallatin County,1,241,119,122
Illinois,Gallatin County,2,313,156,157
Illinois,Gallatin County,3,329,166,163
Illinois,Gallatin County,4,272,135,137
Illinois,Gallatin County,5,282,144,138
Illinois,Gallatin County,6,247,125,122
Illinois,Gallatin County,7,315,157,158
Illinois,Gallatin County,8,307,152,155
Illinois,Gallatin County,9,337,165,172
Illinois,Gallatin County,10,322,156,166
Illinois,Gallatin County,11,389,197,192
Illinois,Gallatin County,12,367,181,186
Illinois,Gallatin County,13,365,157,208
Illinois,Gallatin County,14,393,193,200
Illinois,Gallatin County,15,321,161,160
Illinois,Gallatin County,16,232,101,131
Illinois,Gallatin County,17,153,67,86
Illinois,Gallatin County,18,106,34,72
Illinois,Greene County,0,13434,6756,6678
Illinois,Greene County,1,775,376,399
Illinois,Greene County,2,775,386,389
Illinois,Greene County,3,852,417,435
Illinois,Greene County,4,837,444,393
Illinois,Greene County,5,754,383,371
Illinois,Greene County,6,706,376,330
Illinois,Greene County,7,783,445,338
Illinois,Greene County,8,811,416,395
Illinois,Greene County,9,818,423,395
Illinois,Greene County,10,888,458,430
Illinois,Greene County,11,1039,526,513
Illinois,Greene County,12,1032,541,491
Illinois,Greene County,13,899,455,444
Illinois,Greene County,14,722,347,375
Illinois,Greene County,15,602,270,332
Illinois,Greene County,16,453,204,249
Illinois,Greene County,17,349,158,191
Illinois,Greene County,18,339,131,208
Illinois,Grundy County,0,50425,25141,25284
Illinois,Grundy County,1,3201,1645,1556
Illinois,Grundy County,2,3674,1924,1750
Illinois,Grundy County,3,3945,2040,1905
Illinois,Grundy County,4,3425,1750,1675
Illinois,Grundy County,5,2997,1513,1484
Illinois,Grundy County,6,2851,1408,1443
Illinois,Grundy County,7,3491,1741,1750
Illinois,Grundy County,8,3487,1749,1738
Illinois,Grundy County,9,3498,1747,1751
Illinois,Grundy County,10,3532,1777,1755
Illinois,Grundy County,11,3717,1858,1859
Illinois,Grundy County,12,3385,1689,1696
Illinois,Grundy County,13,2742,1389,1353
Illinois,Grundy County,14,2197,1067,1130
Illinois,Grundy County,15,1674,794,880
Illinois,Grundy County,16,1081,516,565
Illinois,Grundy County,17,741,268,473
Illinois,Grundy County,18,787,266,521
Illinois,Hamilton County,0,8296,4063,4233
Illinois,Hamilton County,1,459,232,227
Illinois,Hamilton County,2,525,262,263
Illinois,Hamilton County,3,561,293,268
Illinois,Hamilton County,4,477,254,223
Illinois,Hamilton County,5,443,224,219
Illinois,Hamilton County,6,389,178,211
Illinois,Hamilton County,7,507,245,262
Illinois,Hamilton County,8,462,239,223
Illinois,Hamilton County,9,480,237,243
Illinois,Hamilton County,10,511,255,256
Illinois,Hamilton County,11,585,297,288
Illinois,Hamilton County,12,657,323,334
Illinois,Hamilton County,13,562,282,280
Illinois,Hamilton County,14,479,240,239
Illinois,Hamilton County,15,411,193,218
Illinois,Hamilton County,16,317,144,173
Illinois,Hamilton County,17,201,88,113
Illinois,Hamilton County,18,270,77,193
Illinois,Hancock County,0,18564,9176,9388
Illinois,Hancock County,1,930,501,429
Illinois,Hancock County,2,1094,566,528
Illinois,Hancock County,3,1105,552,553
Illinois,Hancock County,4,1024,534,490
Illinois,Hancock County,5,952,497,455
Illinois,Hancock County,6,857,427,430
Illinois,Hancock County,7,981,497,484
Illinois,Hancock County,8,978,500,478
Illinois,Hancock County,9,995,514,481
Illinois,Hancock County,10,1137,572,565
Illinois,Hancock County,11,1412,707,705
Illinois,Hancock County,12,1491,745,746
Illinois,Hancock County,13,1313,642,671
Illinois,Hancock County,14,1292,634,658
Illinois,Hancock County,15,1017,454,563
Illinois,Hancock County,16,797,381,416
Illinois,Hancock County,17,565,242,323
Illinois,Hancock County,18,624,211,413
Illinois,Hardin County,0,4129,2091,2038
Illinois,Hardin County,1,192,102,90
Illinois,Hardin County,2,216,113,103
Illinois,Hardin County,3,248,136,112
Illinois,Hardin County,4,241,114,127
Illinois,Hardin County,5,189,103,86
Illinois,Hardin County,6,161,83,78
Illinois,Hardin County,7,189,88,101
Illinois,Hardin County,8,226,120,106
Illinois,Hardin County,9,251,136,115
Illinois,Hardin County,10,282,145,137
Illinois,Hardin County,11,318,154,164
Illinois,Hardin County,12,313,153,160
Illinois,Hardin County,13,343,157,186
Illinois,Hardin County,14,331,171,160
Illinois,Hardin County,15,253,139,114
Illinois,Hardin County,16,173,78,95
Illinois,Hardin County,17,109,45,64
Illinois,Hardin County,18,94,54,40
Illinois,Henderson County,0,6916,3386,3530
Illinois,Henderson County,1,243,116,127
Illinois,Henderson County,2,360,178,182
Illinois,Henderson County,3,384,191,193
Illinois,Henderson County,4,415,202,213
Illinois,Henderson County,5,350,176,174
Illinois,Henderson County,6,309,156,153
Illinois,Henderson County,7,354,178,176
Illinois,Henderson County,8,312,163,149
Illinois,Henderson County,9,351,160,191
Illinois,Henderson County,10,437,202,235
Illinois,Henderson County,11,580,296,284
Illinois,Henderson County,12,651,330,321
Illinois,Henderson County,13,537,290,247
Illinois,Henderson County,14,479,229,250
Illinois,Henderson County,15,431,217,214
Illinois,Henderson County,16,306,143,163
Illinois,Henderson County,17,201,89,112
Illinois,Henderson County,18,216,70,146
Illinois,Henry County,0,49635,24741,24894
Illinois,Henry County,1,2677,1353,1324
Illinois,Henry County,2,3153,1668,1485
Illinois,Henry County,3,3324,1744,1580
Illinois,Henry County,4,3230,1786,1444
Illinois,Henry County,5,2783,1451,1332
Illinois,Henry County,6,2439,1223,1216
Illinois,Henry County,7,2817,1426,1391
Illinois,Henry County,8,2945,1488,1457
Illinois,Henry County,9,2986,1473,1513
Illinois,Henry County,10,3119,1547,1572
Illinois,Henry County,11,3725,1854,1871
Illinois,Henry County,12,3785,1885,1900
Illinois,Henry County,13,3458,1731,1727
Illinois,Henry County,14,2830,1390,1440
Illinois,Henry County,15,2236,1070,1166
Illinois,Henry County,16,1619,711,908
Illinois,Henry County,17,1219,514,705
Illinois,Henry County,18,1290,427,863
Illinois,Iroquois County,0,28879,14117,14762
Illinois,Iroquois County,1,1577,795,782
Illinois,Iroquois County,2,1712,862,850
Illinois,Iroquois County,3,1904,960,944
Illinois,Iroquois County,4,1883,1028,855
Illinois,Iroquois County,5,1547,796,751
Illinois,Iroquois County,6,1398,717,681
Illinois,Iroquois County,7,1620,770,850
Illinois,Iroquois County,8,1573,794,779
Illinois,Iroquois County,9,1604,809,795
Illinois,Iroquois County,10,1778,861,917
Illinois,Iroquois County,11,2175,1079,1096
Illinois,Iroquois County,12,2290,1112,1178
Illinois,Iroquois County,13,1921,954,967
Illinois,Iroquois County,14,1710,830,880
Illinois,Iroquois County,15,1393,618,775
Illinois,Iroquois County,16,1065,521,544
Illinois,Iroquois County,17,756,294,462
Illinois,Iroquois County,18,973,317,656
Illinois,Jackson County,0,59677,29969,29708
Illinois,Jackson County,1,2986,1503,1483
Illinois,Jackson County,2,2889,1430,1459
Illinois,Jackson County,3,2937,1511,1426
Illinois,Jackson County,4,5238,2775,2463
Illinois,Jackson County,5,10982,5706,5276
Illinois,Jackson County,6,4877,2631,2246
Illinois,Jackson County,7,3558,1886,1672
Illinois,Jackson County,8,2949,1494,1455
Illinois,Jackson County,9,2866,1451,1415
Illinois,Jackson County,10,2861,1434,1427
Illinois,Jackson County,11,3270,1571,1699
Illinois,Jackson County,12,3320,1617,1703
Illinois,Jackson County,13,3190,1555,1635
Illinois,Jackson County,14,2582,1265,1317
Illinois,Jackson County,15,1726,789,937
Illinois,Jackson County,16,1252,550,702
Illinois,Jackson County,17,1011,422,589
Illinois,Jackson County,18,1183,379,804
Illinois,Jasper County,0,9623,4811,4812
Illinois,Jasper County,1,591,280,311
Illinois,Jasper County,2,603,320,283
Illinois,Jasper County,3,639,320,319
Illinois,Jasper County,4,574,294,280
Illinois,Jasper County,5,490,244,246
Illinois,Jasper County,6,525,265,260
Illinois,Jasper County,7,572,307,265
Illinois,Jasper County,8,533,285,248
Illinois,Jasper County,9,525,258,267
Illinois,Jasper County,10,626,290,336
Illinois,Jasper County,11,817,459,358
Illinois,Jasper County,12,742,360,382
Illinois,Jasper County,13,638,326,312
Illinois,Jasper County,14,522,261,261
Illinois,Jasper County,15,389,186,203
Illinois,Jasper County,16,307,145,162
Illinois,Jasper County,17,256,123,133
Illinois,Jasper County,18,274,88,186
Illinois,Jefferson County,0,38534,19817,18717
Illinois,Jefferson County,1,2422,1198,1224
Illinois,Jefferson County,2,2341,1171,1170
Illinois,Jefferson County,3,2303,1214,1089
Illinois,Jefferson County,4,2157,1164,993
Illinois,Jefferson County,5,2446,1341,1105
Illinois,Jefferson County,6,2325,1307,1018
Illinois,Jefferson County,7,2511,1372,1139
Illinois,Jefferson County,8,2307,1293,1014
Illinois,Jefferson County,9,2418,1305,1113
Illinois,Jefferson County,10,2524,1390,1134
Illinois,Jefferson County,11,2673,1372,1301
Illinois,Jefferson County,12,2731,1365,1366
Illinois,Jefferson County,13,2604,1282,1322
Illinois,Jefferson County,14,2152,1084,1068
Illinois,Jefferson County,15,1665,788,877
Illinois,Jefferson County,16,1188,529,659
Illinois,Jefferson County,17,806,336,470
Illinois,Jefferson County,18,961,306,655
Illinois,Jersey County,0,22571,11002,11569
Illinois,Jersey County,1,1119,568,551
Illinois,Jersey County,2,1337,669,668
Illinois,Jersey County,3,1443,744,699
Illinois,Jersey County,4,1607,795,812
Illinois,Jersey County,5,1527,749,778
Illinois,Jersey County,6,1233,592,641
Illinois,Jersey County,7,1243,632,611
Illinois,Jersey County,8,1247,605,642
Illinois,Jersey County,9,1322,654,668
Illinois,Jersey County,10,1501,739,762
Illinois,Jersey County,11,1854,903,951
Illinois,Jersey County,12,1726,846,880
Illinois,Jersey County,13,1435,723,712
Illinois,Jersey County,14,1179,554,625
Illinois,Jersey County,15,975,463,512
Illinois,Jersey County,16,745,347,398
Illinois,Jersey County,17,525,226,299
Illinois,Jersey County,18,553,193,360
Illinois,Jo Daviess County,0,22254,11179,11075
Illinois,Jo Daviess County,1,963,496,467
Illinois,Jo Daviess County,2,1222,645,577
Illinois,Jo Daviess County,3,1302,689,613
Illinois,Jo Daviess County,4,1226,667,559
Illinois,Jo Daviess County,5,1054,548,506
Illinois,Jo Daviess County,6,980,520,460
Illinois,Jo Daviess County,7,1089,533,556
Illinois,Jo Daviess County,8,1064,553,511
Illinois,Jo Daviess County,9,1246,641,605
Illinois,Jo Daviess County,10,1313,652,661
Illinois,Jo Daviess County,11,1663,840,823
Illinois,Jo Daviess County,12,1812,857,955
Illinois,Jo Daviess County,13,1851,914,937
Illinois,Jo Daviess County,14,1806,914,892
Illinois,Jo Daviess County,15,1336,648,688
Illinois,Jo Daviess County,16,1019,498,521
Illinois,Jo Daviess County,17,619,290,329
Illinois,Jo Daviess County,18,689,274,415
Illinois,Johnson County,0,12601,7022,5579
Illinois,Johnson County,1,602,300,302
Illinois,Johnson County,2,622,306,316
Illinois,Johnson County,3,708,380,328
Illinois,Johnson County,4,679,386,293
Illinois,Johnson County,5,871,576,295
Illinois,Johnson County,6,794,526,268
Illinois,Johnson County,7,790,503,287
Illinois,Johnson County,8,753,473,280
Illinois,Johnson County,9,809,492,317
Illinois,Johnson County,10,895,498,397
Illinois,Johnson County,11,917,517,400
Illinois,Johnson County,12,921,465,456
Illinois,Johnson County,13,814,415,399
Illinois,Johnson County,14,829,415,414
Illinois,Johnson County,15,652,340,312
Illinois,Johnson County,16,446,225,221
Illinois,Johnson County,17,277,119,158
Illinois,Johnson County,18,222,86,136
Illinois,Kane County,0,527306,262354,264952
Illinois,Kane County,1,35285,17934,17351
Illinois,Kane County,2,40224,20483,19741
Illinois,Kane County,3,42142,21573,20569
Illinois,Kane County,4,38851,20089,18762
Illinois,Kane County,5,33222,16988,16234
Illinois,Kane County,6,30070,15329,14741
Illinois,Kane County,7,34361,17354,17007
Illinois,Kane County,8,35790,17880,17910
Illinois,Kane County,9,38203,19045,19158
Illinois,Kane County,10,37535,18928,18607
Illinois,Kane County,11,38265,19044,19221
Illinois,Kane County,12,33533,16698,16835
Illinois,Kane County,13,27922,13519,14403
Illinois,Kane County,14,21814,10421,11393
Illinois,Kane County,15,15218,6988,8230
Illinois,Kane County,16,10186,4602,5584
Illinois,Kane County,17,7086,2919,4167
Illinois,Kane County,18,7599,2560,5039
Illinois,Kankakee County,0,111375,54718,56657
Illinois,Kankakee County,1,6721,3388,3333
Illinois,Kankakee County,2,7550,3890,3660
Illinois,Kankakee County,3,7824,4045,3779
Illinois,Kankakee County,4,8081,4048,4033
Illinois,Kankakee County,5,8311,4144,4167
Illinois,Kankakee County,6,6510,3234,3276
Illinois,Kankakee County,7,6833,3388,3445
Illinois,Kankakee County,8,6612,3273,3339
Illinois,Kankakee County,9,6886,3456,3430
Illinois,Kankakee County,10,7056,3458,3598
Illinois,Kankakee County,11,8021,3952,4069
Illinois,Kankakee County,12,7602,3782,3820
Illinois,Kankakee County,13,6718,3298,3420
Illinois,Kankakee County,14,5334,2515,2819
Illinois,Kankakee County,15,3938,1856,2082
Illinois,Kankakee County,16,2863,1259,1604
Illinois,Kankakee County,17,2119,887,1232
Illinois,Kankakee County,18,2396,845,1551
Illinois,Kendall County,0,121350,59901,61449
Illinois,Kendall County,1,8826,4478,4348
Illinois,Kendall County,2,10744,5502,5242
Illinois,Kendall County,3,10730,5530,5200
Illinois,Kendall County,4,8906,4543,4363
Illinois,Kendall County,5,6477,3229,3248
Illinois,Kendall County,6,6769,3299,3470
Illinois,Kendall County,7,9537,4607,4930
Illinois,Kendall County,8,10037,4854,5183
Illinois,Kendall County,9,10469,5171,5298
Illinois,Kendall County,10,8909,4500,4409
Illinois,Kendall County,11,7719,3918,3801
Illinois,Kendall County,12,6303,3062,3241
Illinois,Kendall County,13,4980,2372,2608
Illinois,Kendall County,14,4114,1915,2199
Illinois,Kendall County,15,2826,1320,1506
Illinois,Kendall County,16,1718,757,961
Illinois,Kendall County,17,1101,442,659
Illinois,Kendall County,18,1185,402,783
Illinois,Knox County,0,52069,26167,25902
Illinois,Knox County,1,2592,1277,1315
Illinois,Knox County,2,2844,1409,1435
Illinois,Knox County,3,3077,1592,1485
Illinois,Knox County,4,3365,1730,1635
Illinois,Knox County,5,3696,1941,1755
Illinois,Knox County,6,3057,1718,1339
Illinois,Knox County,7,3016,1661,1355
Illinois,Knox County,8,3037,1675,1362
Illinois,Knox County,9,2965,1573,1392
Illinois,Knox County,10,3125,1602,1523
Illinois,Knox County,11,3636,1842,1794
Illinois,Knox County,12,3706,1812,1894
Illinois,Knox County,13,3732,1828,1904
Illinois,Knox County,14,3038,1446,1592
Illinois,Knox County,15,2400,1112,1288
Illinois,Knox County,16,1756,797,959
Illinois,Knox County,17,1458,598,860
Illinois,Knox County,18,1569,554,1015
Illinois,Lake County,0,705186,351884,353302
Illinois,Lake County,1,41880,21212,20668
Illinois,Lake County,2,49601,25361,24240
Illinois,Lake County,3,54249,27841,26408
Illinois,Lake County,4,55935,29820,26115
Illinois,Lake County,5,49359,27121,22238
Illinois,Lake County,6,37303,19506,17797
Illinois,Lake County,7,40170,20029,20141
Illinois,Lake County,8,43264,21157,22107
Illinois,Lake County,9,48290,23695,24595
Illinois,Lake County,10,52003,25484,26519
Illinois,Lake County,11,56307,27652,28655
Illinois,Lake County,12,50942,25124,25818
Illinois,Lake County,13,39838,19530,20308
Illinois,Lake County,14,29885,14403,15482
Illinois,Lake County,15,20260,9541,10719
Illinois,Lake County,16,13808,6184,7624
Illinois,Lake County,17,10138,4125,6013
Illinois,Lake County,18,11954,4099,7855
Illinois,LaSalle County,0,111241,55839,55402
Illinois,LaSalle County,1,5954,3090,2864
Illinois,LaSalle County,2,6638,3359,3279
Illinois,LaSalle County,3,7349,3722,3627
Illinois,LaSalle County,4,7109,3667,3442
Illinois,LaSalle County,5,6756,3567,3189
Illinois,LaSalle County,6,6381,3456,2925
Illinois,LaSalle County,7,6788,3533,3255
Illinois,LaSalle County,8,6210,3261,2949
Illinois,LaSalle County,9,6626,3397,3229
Illinois,LaSalle County,10,7284,3674,3610
Illinois,LaSalle County,11,8718,4427,4291
Illinois,LaSalle County,12,8547,4323,4224
Illinois,LaSalle County,13,7355,3765,3590
Illinois,LaSalle County,14,5681,2766,2915
Illinois,LaSalle County,15,4523,2075,2448
Illinois,LaSalle County,16,3471,1563,1908
Illinois,LaSalle County,17,2674,1118,1556
Illinois,LaSalle County,18,3177,1076,2101
Illinois,Lawrence County,0,16519,9246,7273
Illinois,Lawrence County,1,839,421,418
Illinois,Lawrence County,2,897,461,436
Illinois,Lawrence County,3,859,439,420
Illinois,Lawrence County,4,860,492,368
Illinois,Lawrence County,5,1230,854,376
Illinois,Lawrence County,6,1218,844,374
Illinois,Lawrence County,7,1183,753,430
Illinois,Lawrence County,8,1149,740,409
Illinois,Lawrence County,9,1173,743,430
Illinois,Lawrence County,10,1027,613,414
Illinois,Lawrence County,11,1191,652,539
Illinois,Lawrence County,12,1127,552,575
Illinois,Lawrence County,13,956,465,491
Illinois,Lawrence County,14,770,390,380
Illinois,Lawrence County,15,665,287,378
Illinois,Lawrence County,16,526,232,294
Illinois,Lawrence County,17,427,172,255
Illinois,Lawrence County,18,422,136,286
Illinois,Lee County,0,34735,18332,16403
Illinois,Lee County,1,1781,940,841
Illinois,Lee County,2,1992,1022,970
Illinois,Lee County,3,2062,1029,1033
Illinois,Lee County,4,2006,1043,963
Illinois,Lee County,5,2093,1146,947
Illinois,Lee County,6,2020,1181,839
Illinois,Lee County,7,2203,1263,940
Illinois,Lee County,8,2016,1157,859
Illinois,Lee County,9,2170,1260,910
Illinois,Lee County,10,2412,1289,1123
Illinois,Lee County,11,2789,1532,1257
Illinois,Lee County,12,2776,1429,1347
Illinois,Lee County,13,2336,1232,1104
Illinois,Lee County,14,1936,985,951
Illinois,Lee County,15,1372,683,689
Illinois,Lee County,16,1101,510,591
Illinois,Lee County,17,825,365,460
Illinois,Lee County,18,845,266,579
Illinois,Livingston County,0,37903,19104,18799
Illinois,Livingston County,1,2125,1086,1039
Illinois,Livingston County,2,2144,1126,1018
Illinois,Livingston County,3,2402,1287,1115
Illinois,Livingston County,4,2364,1266,1098
Illinois,Livingston County,5,2473,1283,1190
Illinois,Livingston County,6,2303,1179,1124
Illinois,Livingston County,7,2389,1253,1136
Illinois,Livingston County,8,2269,1171,1098
Illinois,Livingston County,9,2298,1193,1105
Illinois,Livingston County,10,2502,1291,1211
Illinois,Livingston County,11,2909,1470,1439
Illinois,Livingston County,12,2870,1471,1399
Illinois,Livingston County,13,2418,1240,1178
Illinois,Livingston County,14,1828,881,947
Illinois,Livingston County,15,1489,686,803
Illinois,Livingston County,16,1136,493,643
Illinois,Livingston County,17,897,365,532
Illinois,Livingston County,18,1087,363,724
Illinois,Logan County,0,29746,15048,14698
Illinois,Logan County,1,1408,709,699
Illinois,Logan County,2,1579,788,791
Illinois,Logan County,3,1660,861,799
Illinois,Logan County,4,2041,1045,996
Illinois,Logan County,5,2269,1263,1006
Illinois,Logan County,6,2026,1159,867
Illinois,Logan County,7,2047,1141,906
Illinois,Logan County,8,1906,1008,898
Illinois,Logan County,9,1852,956,896
Illinois,Logan County,10,1838,941,897
Illinois,Logan County,11,2157,1090,1067
Illinois,Logan County,12,2037,1028,1009
Illinois,Logan County,13,1836,892,944
Illinois,Logan County,14,1429,690,739
Illinois,Logan County,15,1180,534,646
Illinois,Logan County,16,908,389,519
Illinois,Logan County,17,722,283,439
Illinois,Logan County,18,851,271,580
Illinois,McDonough County,0,31880,15775,16105
Illinois,McDonough County,1,1523,782,741
Illinois,McDonough County,2,1482,764,718
Illinois,McDonough County,3,1474,733,741
Illinois,McDonough County,4,3039,1372,1667
Illinois,McDonough County,5,5930,3195,2735
Illinois,McDonough County,6,2234,1230,1004
Illinois,McDonough County,7,1669,851,818
Illinois,McDonough County,8,1442,725,717
Illinois,McDonough County,9,1468,743,725
Illinois,McDonough County,10,1436,704,732
Illinois,McDonough County,11,1769,845,924
Illinois,McDonough County,12,1860,919,941
Illinois,McDonough County,13,1809,877,932
Illinois,McDonough County,14,1431,700,731
Illinois,McDonough County,15,1082,513,569
Illinois,McDonough County,16,767,335,432
Illinois,McDonough County,17,621,233,388
Illinois,McDonough County,18,844,254,590
Illinois,McHenry County,0,307283,153195,154088
Illinois,McHenry County,1,17025,8857,8168
Illinois,McHenry County,2,20928,10646,10282
Illinois,McHenry County,3,23795,12213,11582
Illinois,McHenry County,4,22902,11822,11080
Illinois,McHenry County,5,18751,9640,9111
Illinois,McHenry County,6,15391,8046,7345
Illinois,McHenry County,7,17753,8959,8794
Illinois,McHenry County,8,18849,9303,9546
Illinois,McHenry County,9,22301,11009,11292
Illinois,McHenry County,10,25058,12397,12661
Illinois,McHenry County,11,26541,13214,13327
Illinois,McHenry County,12,23023,11553,11470
Illinois,McHenry County,13,17703,8756,8947
Illinois,McHenry County,14,13437,6421,7016
Illinois,McHenry County,15,9688,4566,5122
Illinois,McHenry County,16,6039,2744,3295
Illinois,McHenry County,17,3931,1677,2254
Illinois,McHenry County,18,4168,1372,2796
Illinois,McLean County,0,174061,84780,89281
Illinois,McLean County,1,10652,5445,5207
Illinois,McLean County,2,10788,5466,5322
Illinois,McLean County,3,10810,5492,5318
Illinois,McLean County,4,14813,6966,7847
Illinois,McLean County,5,23091,11279,11812
Illinois,McLean County,6,10880,5424,5456
Illinois,McLean County,7,11555,5780,5775
Illinois,McLean County,8,10904,5458,5446
Illinois,McLean County,9,10222,5228,4994
Illinois,McLean County,10,10160,4951,5209
Illinois,McLean County,11,11221,5477,5744
Illinois,McLean County,12,10348,4958,5390
Illinois,McLean County,13,8695,4094,4601
Illinois,McLean County,14,6571,3236,3335
Illinois,McLean County,15,4511,2055,2456
Illinois,McLean County,16,3352,1502,1850
Illinois,McLean County,17,2484,974,1510
Illinois,McLean County,18,3004,995,2009
Illinois,Macon County,0,108350,51832,56518
Illinois,Macon County,1,6666,3382,3284
Illinois,Macon County,2,6765,3363,3402
Illinois,Macon County,3,6716,3473,3243
Illinois,Macon County,4,6899,3382,3517
Illinois,Macon County,5,7305,3554,3751
Illinois,Macon County,6,6323,2998,3325
Illinois,Macon County,7,6318,3033,3285
Illinois,Macon County,8,6235,2968,3267
Illinois,Macon County,9,6235,2996,3239
Illinois,Macon County,10,6332,3044,3288
Illinois,Macon County,11,7587,3688,3899
Illinois,Macon County,12,8223,3996,4227
Illinois,Macon County,13,7359,3509,3850
Illinois,Macon County,14,5958,2847,3111
Illinois,Macon County,15,4481,2100,2381
Illinois,Macon County,16,3303,1449,1854
Illinois,Macon County,17,2659,1075,1584
Illinois,Macon County,18,2986,975,2011
Illinois,Macoupin County,0,46453,22970,23483
Illinois,Macoupin County,1,2356,1263,1093
Illinois,Macoupin County,2,2839,1511,1328
Illinois,Macoupin County,3,2971,1545,1426
Illinois,Macoupin County,4,2923,1527,1396
Illinois,Macoupin County,5,2696,1365,1331
Illinois,Macoupin County,6,2433,1219,1214
Illinois,Macoupin County,7,2693,1336,1357
Illinois,Macoupin County,8,2642,1298,1344
Illinois,Macoupin County,9,2829,1431,1398
Illinois,Macoupin County,10,2958,1458,1500
Illinois,Macoupin County,11,3577,1752,1825
Illinois,Macoupin County,12,3627,1830,1797
Illinois,Macoupin County,13,3208,1601,1607
Illinois,Macoupin County,14,2646,1271,1375
Illinois,Macoupin County,15,2061,991,1070
Illinois,Macoupin County,16,1520,670,850
Illinois,Macoupin County,17,1195,476,719
Illinois,Macoupin County,18,1279,426,853
Illinois,Madison County,0,266560,130247,136313
Illinois,Madison County,1,15703,8067,7636
Illinois,Madison County,2,16464,8434,8030
Illinois,Madison County,3,17001,8856,8145
Illinois,Madison County,4,16256,8438,7818
Illinois,Madison County,5,17539,8630,8909
Illinois,Madison County,6,18475,9287,9188
Illinois,Madison County,7,17107,8446,8661
Illinois,Madison County,8,15891,7741,8150
Illinois,Madison County,9,16760,8174,8586
Illinois,Madison County,10,17302,8595,8707
Illinois,Madison County,11,19905,9901,10004
Illinois,Madison County,12,19947,9851,10096
Illinois,Madison County,13,16438,7842,8596
Illinois,Madison County,14,13059,6135,6924
Illinois,Madison County,15,9812,4476,5336
Illinois,Madison County,16,7266,3199,4067
Illinois,Madison County,17,5595,2241,3354
Illinois,Madison County,18,6040,1934,4106
Illinois,Marion County,0,38571,18862,19709
Illinois,Marion County,1,2433,1252,1181
Illinois,Marion County,2,2545,1317,1228
Illinois,Marion County,3,2384,1201,1183
Illinois,Marion County,4,2317,1158,1159
Illinois,Marion County,5,2423,1245,1178
Illinois,Marion County,6,2113,1041,1072
Illinois,Marion County,7,2215,1113,1102
Illinois,Marion County,8,2150,1093,1057
Illinois,Marion County,9,2270,1114,1156
Illinois,Marion County,10,2303,1152,1151
Illinois,Marion County,11,2870,1387,1483
Illinois,Marion County,12,2895,1424,1471
Illinois,Marion County,13,2549,1231,1318
Illinois,Marion County,14,2190,1037,1153
Illinois,Marion County,15,1673,790,883
Illinois,Marion County,16,1252,546,706
Illinois,Marion County,17,882,373,509
Illinois,Marion County,18,1107,388,719
Illinois,Marshall County,0,12014,5926,6088
Illinois,Marshall County,1,586,259,327
Illinois,Marshall County,2,664,342,322
Illinois,Marshall County,3,694,367,327
Illinois,Marshall County,4,698,375,323
Illinois,Marshall County,5,670,350,320
Illinois,Marshall County,6,572,280,292
Illinois,Marshall County,7,638,314,324
Illinois,Marshall County,8,657,332,325
Illinois,Marshall County,9,674,358,316
Illinois,Marshall County,10,742,362,380
Illinois,Marshall County,11,940,470,470
Illinois,Marshall County,12,924,459,465
Illinois,Marshall County,13,933,476,457
Illinois,Marshall County,14,737,360,377
Illinois,Marshall County,15,648,317,331
Illinois,Marshall County,16,468,203,265
Illinois,Marshall County,17,382,163,219
Illinois,Marshall County,18,387,139,248
Illinois,Mason County,0,13898,6889,7009
Illinois,Mason County,1,673,368,305
Illinois,Mason County,2,770,380,390
Illinois,Mason County,3,892,435,457
Illinois,Mason County,4,922,480,442
Illinois,Mason County,5,759,404,355
Illinois,Mason County,6,667,339,328
Illinois,Mason County,7,779,382,397
Illinois,Mason County,8,768,391,377
Illinois,Mason County,9,843,424,419
Illinois,Mason County,10,930,472,458
Illinois,Mason County,11,1082,523,559
Illinois,Mason County,12,1053,530,523
Illinois,Mason County,13,1006,526,480
Illinois,Mason County,14,845,404,441
Illinois,Mason County,15,623,310,313
Illinois,Mason County,16,484,228,256
Illinois,Mason County,17,371,151,220
Illinois,Mason County,18,431,142,289
Illinois,Massac County,0,14905,7088,7817
Illinois,Massac County,1,862,439,423
Illinois,Massac County,2,930,439,491
Illinois,Massac County,3,939,462,477
Illinois,Massac County,4,807,410,397
Illinois,Massac County,5,797,402,395
Illinois,Massac County,6,730,336,394
Illinois,Massac County,7,877,398,479
Illinois,Massac County,8,833,402,431
Illinois,Massac County,9,939,464,475
Illinois,Massac County,10,943,485,458
Illinois,Massac County,11,1132,547,585
Illinois,Massac County,12,1148,533,615
Illinois,Massac County,13,937,467,470
Illinois,Massac County,14,869,422,447
Illinois,Massac County,15,729,329,400
Illinois,Massac County,16,551,256,295
Illinois,Massac County,17,379,134,245
Illinois,Massac County,18,503,163,340
Illinois,Menard County,0,12570,6119,6451
Illinois,Menard County,1,671,344,327
Illinois,Menard County,2,796,394,402
Illinois,Menard County,3,830,410,420
Illinois,Menard County,4,805,432,373
Illinois,Menard County,5,683,357,326
Illinois,Menard County,6,604,292,312
Illinois,Menard County,7,701,316,385
Illinois,Menard County,8,730,387,343
Illinois,Menard County,9,719,356,363
Illinois,Menard County,10,864,412,452
Illinois,Menard County,11,1009,489,520
Illinois,Menard County,12,1013,526,487
Illinois,Menard County,13,869,395,474
Illinois,Menard County,14,785,384,401
Illinois,Menard County,15,510,244,266
Illinois,Menard County,16,411,181,230
Illinois,Menard County,17,253,107,146
Illinois,Menard County,18,317,93,224
Illinois,Mercer County,0,15945,7876,8069
Illinois,Mercer County,1,789,376,413
Illinois,Mercer County,2,959,479,480
Illinois,Mercer County,3,1062,532,530
Illinois,Mercer County,4,986,533,453
Illinois,Mercer County,5,821,422,399
Illinois,Mercer County,6,718,368,350
Illinois,Mercer County,7,834,421,413
Illinois,Mercer County,8,867,419,448
Illinois,Mercer County,9,948,486,462
Illinois,Mercer County,10,1068,493,575
Illinois,Mercer County,11,1259,626,633
Illinois,Mercer County,12,1206,624,582
Illinois,Mercer County,13,1165,598,567
Illinois,Mercer County,14,963,482,481
Illinois,Mercer County,15,871,431,440
Illinois,Mercer County,16,553,251,302
Illinois,Mercer County,17,402,173,229
Illinois,Mercer County,18,474,162,312
Illinois,Monroe County,0,33722,16761,16961
Illinois,Monroe County,1,1746,935,811
Illinois,Monroe County,2,2135,1066,1069
Illinois,Monroe County,3,2335,1258,1077
Illinois,Monroe County,4,2220,1173,1047
Illinois,Monroe County,5,1755,901,854
Illinois,Monroe County,6,1709,870,839
Illinois,Monroe County,7,1943,961,982
Illinois,Monroe County,8,2015,1046,969
Illinois,Monroe County,9,2172,1070,1102
Illinois,Monroe County,10,2500,1159,1341
Illinois,Monroe County,11,2836,1404,1432
Illinois,Monroe County,12,2839,1423,1416
Illinois,Monroe County,13,2134,1088,1046
Illinois,Monroe County,14,1596,817,779
Illinois,Monroe County,15,1170,560,610
Illinois,Monroe County,16,968,416,552
Illinois,Monroe County,17,788,310,478
Illinois,Monroe County,18,861,304,557
Illinois,Montgomery County,0,29359,15355,14004
Illinois,Montgomery County,1,1500,735,765
Illinois,Montgomery County,2,1736,930,806
Illinois,Montgomery County,3,1758,908,850
Illinois,Montgomery County,4,1641,865,776
Illinois,Montgomery County,5,1810,1068,742
Illinois,Montgomery County,6,1748,1053,695
Illinois,Montgomery County,7,1933,1098,835
Illinois,Montgomery County,8,1683,941,742
Illinois,Montgomery County,9,1829,1072,757
Illinois,Montgomery County,10,1984,1069,915
Illinois,Montgomery County,11,2259,1160,1099
Illinois,Montgomery County,12,2147,1117,1030
Illinois,Montgomery County,13,1915,967,948
Illinois,Montgomery County,14,1521,752,769
Illinois,Montgomery County,15,1207,573,634
Illinois,Montgomery County,16,983,433,550
Illinois,Montgomery County,17,753,297,456
Illinois,Montgomery County,18,952,317,635
Illinois,Morgan County,0,34929,17664,17265
Illinois,Morgan County,1,1805,970,835
Illinois,Morgan County,2,1903,1031,872
Illinois,Morgan County,3,2032,1046,986
Illinois,Morgan County,4,2342,1262,1080
Illinois,Morgan County,5,2524,1312,1212
Illinois,Morgan County,6,2196,1147,1049
Illinois,Morgan County,7,2206,1228,978
Illinois,Morgan County,8,1999,1086,913
Illinois,Morgan County,9,1932,997,935
Illinois,Morgan County,10,2141,1101,1040
Illinois,Morgan County,11,2618,1332,1286
Illinois,Morgan County,12,2561,1285,1276
Illinois,Morgan County,13,2293,1123,1170
Illinois,Morgan County,14,1917,927,990
Illinois,Morgan County,15,1488,675,813
Illinois,Morgan County,16,1126,495,631
Illinois,Morgan County,17,830,334,496
Illinois,Morgan County,18,1016,313,703
Illinois,Moultrie County,0,14837,7275,7562
Illinois,Moultrie County,1,898,467,431
Illinois,Moultrie County,2,1033,536,497
Illinois,Moultrie County,3,1084,563,521
Illinois,Moultrie County,4,911,476,435
Illinois,Moultrie County,5,823,415,408
Illinois,Moultrie County,6,814,416,398
Illinois,Moultrie County,7,934,452,482
Illinois,Moultrie County,8,836,407,429
Illinois,Moultrie County,9,839,429,410
Illinois,Moultrie County,10,867,437,430
Illinois,Moultrie County,11,1057,507,550
Illinois,Moultrie County,12,976,465,511
Illinois,Moultrie County,13,952,479,473
Illinois,Moultrie County,14,809,386,423
Illinois,Moultrie County,15,616,288,328
Illinois,Moultrie County,16,493,234,259
Illinois,Moultrie County,17,362,153,209
Illinois,Moultrie County,18,533,165,368
Illinois,Ogle County,0,52085,25897,26188
Illinois,Ogle County,1,2693,1409,1284
Illinois,Ogle County,2,3283,1678,1605
Illinois,Ogle County,3,3771,1847,1924
Illinois,Ogle County,4,3507,1834,1673
Illinois,Ogle County,5,3116,1631,1485
Illinois,Ogle County,6,2610,1305,1305
Illinois,Ogle County,7,2866,1460,1406
Illinois,Ogle County,8,2948,1458,1490
Illinois,Ogle County,9,3253,1624,1629
Illinois,Ogle County,10,3618,1801,1817
Illinois,Ogle County,11,4231,2138,2093
Illinois,Ogle County,12,3940,1963,1977
Illinois,Ogle County,13,3274,1673,1601
Illinois,Ogle County,14,2779,1337,1442
Illinois,Ogle County,15,2182,1036,1146
Illinois,Ogle County,16,1653,781,872
Illinois,Ogle County,17,1126,486,640
Illinois,Ogle County,18,1235,436,799
Illinois,Peoria County,0,187319,90629,96690
Illinois,Peoria County,1,13106,6569,6537
Illinois,Peoria County,2,12401,6403,5998
Illinois,Peoria County,3,12040,6083,5957
Illinois,Peoria County,4,12257,6199,6058
Illinois,Peoria County,5,13073,6381,6692
Illinois,Peoria County,6,13194,6503,6691
Illinois,Peoria County,7,12866,6460,6406
Illinois,Peoria County,8,11409,5609,5800
Illinois,Peoria County,9,11259,5457,5802
Illinois,Peoria County,10,11185,5449,5736
Illinois,Peoria County,11,12353,5988,6365
Illinois,Peoria County,12,12684,6026,6658
Illinois,Peoria County,13,11343,5412,5931
Illinois,Peoria County,14,9102,4216,4886
Illinois,Peoria County,15,6557,3029,3528
Illinois,Peoria County,16,4659,2064,2595
Illinois,Peoria County,17,3619,1436,2183
Illinois,Peoria County,18,4212,1345,2867
Illinois,Perry County,0,21672,11789,9883
Illinois,Perry County,1,1053,508,545
Illinois,Perry County,2,1160,592,568
Illinois,Perry County,3,1271,679,592
Illinois,Perry County,4,1240,716,524
Illinois,Perry County,5,1708,1118,590
Illinois,Perry County,6,1430,920,510
Illinois,Perry County,7,1398,871,527
Illinois,Perry County,8,1444,858,586
Illinois,Perry County,9,1462,838,624
Illinois,Perry County,10,1380,783,597
Illinois,Perry County,11,1556,838,718
Illinois,Perry County,12,1446,760,686
Illinois,Perry County,13,1383,706,677
Illinois,Perry County,14,1211,528,683
Illinois,Perry County,15,897,420,477
Illinois,Perry County,16,635,297,338
Illinois,Perry County,17,479,204,275
Illinois,Perry County,18,519,153,366
Illinois,Piatt County,0,16431,8160,8271
Illinois,Piatt County,1,851,447,404
Illinois,Piatt County,2,942,493,449
Illinois,Piatt County,3,1141,596,545
Illinois,Piatt County,4,1078,542,536
Illinois,Piatt County,5,850,439,411
Illinois,Piatt County,6,809,418,391
Illinois,Piatt County,7,918,483,435
Illinois,Piatt County,8,964,474,490
Illinois,Piatt County,9,992,488,504
Illinois,Piatt County,10,1062,510,552
Illinois,Piatt County,11,1387,684,703
Illinois,Piatt County,12,1349,665,684
Illinois,Piatt County,13,1106,548,558
Illinois,Piatt County,14,935,468,467
Illinois,Piatt County,15,687,336,351
Illinois,Piatt County,16,566,245,321
Illinois,Piatt County,17,396,160,236
Illinois,Piatt County,18,398,164,234
Illinois,Pike County,0,16022,8027,7995
Illinois,Pike County,1,890,459,431
Illinois,Pike County,2,1008,509,499
Illinois,Pike County,3,1028,521,507
Illinois,Pike County,4,933,488,445
Illinois,Pike County,5,897,476,421
Illinois,Pike County,6,900,458,442
Illinois,Pike County,7,924,510,414
Illinois,Pike County,8,868,457,411
Illinois,Pike County,9,983,524,459
Illinois,Pike County,10,1034,549,485
Illinois,Pike County,11,1104,524,580
Illinois,Pike County,12,1162,607,555
Illinois,Pike County,13,1121,562,559
Illinois,Pike County,14,867,425,442
Illinois,Pike County,15,765,365,400
Illinois,Pike County,16,584,269,315
Illinois,Pike County,17,438,168,270
Illinois,Pike County,18,516,156,360
Illinois,Pope County,0,4276,2260,2016
Illinois,Pope County,1,146,75,71
Illinois,Pope County,2,177,90,87
Illinois,Pope County,3,177,101,76
Illinois,Pope County,4,352,224,128
Illinois,Pope County,5,317,201,116
Illinois,Pope County,6,180,100,80
Illinois,Pope County,7,202,102,100
Illinois,Pope County,8,195,99,96
Illinois,Pope County,9,237,112,125
Illinois,Pope County,10,260,148,112
Illinois,Pope County,11,356,174,182
Illinois,Pope County,12,382,177,205
Illinois,Pope County,13,384,202,182
Illinois,Pope County,14,293,145,148
Illinois,Pope County,15,223,111,112
Illinois,Pope County,16,163,89,74
Illinois,Pope County,17,134,66,68
Illinois,Pope County,18,98,44,54
Illinois,Pulaski County,0,5815,2796,3019
Illinois,Pulaski County,1,299,146,153
Illinois,Pulaski County,2,382,199,183
Illinois,Pulaski County,3,395,203,192
Illinois,Pulaski County,4,314,176,138
Illinois,Pulaski County,5,325,159,166
Illinois,Pulaski County,6,320,160,160
Illinois,Pulaski County,7,301,133,168
Illinois,Pulaski County,8,317,151,166
Illinois,Pulaski County,9,311,138,173
Illinois,Pulaski County,10,316,157,159
Illinois,Pulaski County,11,442,222,220
Illinois,Pulaski County,12,479,231,248
Illinois,Pulaski County,13,442,204,238
Illinois,Pulaski County,14,359,163,196
Illinois,Pulaski County,15,265,119,146
Illinois,Pulaski County,16,214,103,111
Illinois,Pulaski County,17,171,79,92
Illinois,Pulaski County,18,163,53,110
Illinois,Putnam County,0,5814,2960,2854
Illinois,Putnam County,1,272,157,115
Illinois,Putnam County,2,309,166,143
Illinois,Putnam County,3,388,205,183
Illinois,Putnam County,4,326,172,154
Illinois,Putnam County,5,323,183,140
Illinois,Putnam County,6,262,126,136
Illinois,Putnam County,7,320,169,151
Illinois,Putnam County,8,310,154,156
Illinois,Putnam County,9,315,173,142
Illinois,Putnam County,10,351,159,192
Illinois,Putnam County,11,477,237,240
Illinois,Putnam County,12,513,267,246
Illinois,Putnam County,13,497,258,239
Illinois,Putnam County,14,380,187,193
Illinois,Putnam County,15,305,151,154
Illinois,Putnam County,16,193,90,103
Illinois,Putnam County,17,126,60,66
Illinois,Putnam County,18,147,46,101
Illinois,Randolph County,0,32869,18080,14789
Illinois,Randolph County,1,1655,810,845
Illinois,Randolph County,2,1770,926,844
Illinois,Randolph County,3,1855,935,920
Illinois,Randolph County,4,1757,942,815
Illinois,Randolph County,5,1972,1178,794
Illinois,Randolph County,6,2226,1462,764
Illinois,Randolph County,7,2379,1520,859
Illinois,Randolph County,8,2166,1364,802
Illinois,Randolph County,9,2125,1293,832
Illinois,Randolph County,10,2186,1288,898
Illinois,Randolph County,11,2550,1460,1090
Illinois,Randolph County,12,2433,1313,1120
Illinois,Randolph County,13,2127,1112,1015
Illinois,Randolph County,14,1710,846,864
Illinois,Randolph County,15,1327,609,718
Illinois,Randolph County,16,978,445,533
Illinois,Randolph County,17,759,279,480
Illinois,Randolph County,18,894,298,596
Illinois,Richland County,0,16061,7935,8126
Illinois,Richland County,1,933,503,430
Illinois,Richland County,2,1009,525,484
Illinois,Richland County,3,990,518,472
Illinois,Richland County,4,897,488,409
Illinois,Richland County,5,971,501,470
Illinois,Richland County,6,901,453,448
Illinois,Richland County,7,898,444,454
Illinois,Richland County,8,918,471,447
Illinois,Richland County,9,904,436,468
Illinois,Richland County,10,984,488,496
Illinois,Richland County,11,1204,617,587
Illinois,Richland County,12,1189,575,614
Illinois,Richland County,13,1044,524,520
Illinois,Richland County,14,832,395,437
Illinois,Richland County,15,727,347,380
Illinois,Richland County,16,640,297,343
Illinois,Richland County,17,451,186,265
Illinois,Richland County,18,569,167,402
Illinois,Rock Island County,0,146063,71912,74151
Illinois,Rock Island County,1,8890,4476,4414
Illinois,Rock Island County,2,9162,4681,4481
Illinois,Rock Island County,3,8801,4543,4258
Illinois,Rock Island County,4,9135,4682,4453
Illinois,Rock Island County,5,9368,4639,4729
Illinois,Rock Island County,6,9000,4575,4425
Illinois,Rock Island County,7,9456,4933,4523
Illinois,Rock Island County,8,8700,4504,4196
Illinois,Rock Island County,9,8447,4232,4215
Illinois,Rock Island County,10,8740,4387,4353
Illinois,Rock Island County,11,10184,5028,5156
Illinois,Rock Island County,12,10795,5277,5518
Illinois,Rock Island County,13,9634,4678,4956
Illinois,Rock Island County,14,8051,3800,4251
Illinois,Rock Island County,15,5967,2871,3096
Illinois,Rock Island County,16,4486,1990,2496
Illinois,Rock Island County,17,3356,1357,1999
Illinois,Rock Island County,18,3891,1259,2632
Illinois,Saline County,0,24612,12131,12481
Illinois,Saline County,1,1472,758,714
Illinois,Saline County,2,1367,711,656
Illinois,Saline County,3,1458,770,688
Illinois,Saline County,4,1597,955,642
Illinois,Saline County,5,1557,790,767
Illinois,Saline County,6,1465,749,716
Illinois,Saline County,7,1411,695,716
Illinois,Saline County,8,1330,633,697
Illinois,Saline County,9,1485,753,732
Illinois,Saline County,10,1577,800,777
Illinois,Saline County,11,1759,839,920
Illinois,Saline County,12,1734,825,909
Illinois,Saline County,13,1667,815,852
Illinois,Saline County,14,1380,658,722
Illinois,Saline County,15,1202,535,667
Illinois,Saline County,16,876,375,501
Illinois,Saline County,17,633,260,373
Illinois,Saline County,18,642,210,432
Illinois,Sangamon County,0,198997,95503,103494
Illinois,Sangamon County,1,11964,6146,5818
Illinois,Sangamon County,2,12735,6423,6312
Illinois,Sangamon County,3,13206,6725,6481
Illinois,Sangamon County,4,12212,6247,5965
Illinois,Sangamon County,5,12470,6113,6357
Illinois,Sangamon County,6,12401,6005,6396
Illinois,Sangamon County,7,13092,6298,6794
Illinois,Sangamon County,8,11996,5872,6124
Illinois,Sangamon County,9,12294,5979,6315
Illinois,Sangamon County,10,12894,6301,6593
Illinois,Sangamon County,11,14978,7272,7706
Illinois,Sangamon County,12,14581,6913,7668
Illinois,Sangamon County,13,13248,6243,7005
Illinois,Sangamon County,14,10352,4736,5616
Illinois,Sangamon County,15,6968,3113,3855
Illinois,Sangamon County,16,5238,2252,2986
Illinois,Sangamon County,17,3862,1497,2365
Illinois,Sangamon County,18,4506,1368,3138
Illinois,Schuyler County,0,7330,3862,3468
Illinois,Schuyler County,1,361,192,169
Illinois,Schuyler County,2,397,208,189
Illinois,Schuyler County,3,440,210,230
Illinois,Schuyler County,4,424,222,202
Illinois,Schuyler County,5,378,191,187
Illinois,Schuyler County,6,353,193,160
Illinois,Schuyler County,7,425,234,191
Illinois,Schuyler County,8,419,253,166
Illinois,Schuyler County,9,506,276,230
Illinois,Schuyler County,10,528,316,212
Illinois,Schuyler County,11,545,282,263
Illinois,Schuyler County,12,561,302,259
Illinois,Schuyler County,13,551,295,256
Illinois,Schuyler County,14,411,223,188
Illinois,Schuyler County,15,358,180,178
Illinois,Schuyler County,16,254,117,137
Illinois,Schuyler County,17,203,86,117
Illinois,Schuyler County,18,216,82,134
Illinois,Scott County,0,5204,2501,2703
Illinois,Scott County,1,264,128,136
Illinois,Scott County,2,342,146,196
Illinois,Scott County,3,328,170,158
Illinois,Scott County,4,330,155,175
Illinois,Scott County,5,282,148,134
Illinois,Scott County,6,250,119,131
Illinois,Scott County,7,270,131,139
Illinois,Scott County,8,306,156,150
Illinois,Scott County,9,332,165,167
Illinois,Scott County,10,333,157,176
Illinois,Scott County,11,461,227,234
Illinois,Scott County,12,407,215,192
Illinois,Scott County,13,332,162,170
Illinois,Scott County,14,264,121,143
Illinois,Scott County,15,232,109,123
Illinois,Scott County,16,204,99,105
Illinois,Scott County,17,133,51,82
Illinois,Scott County,18,134,42,92
Illinois,Shelby County,0,22048,10885,11163
Illinois,Shelby County,1,1171,575,596
Illinois,Shelby County,2,1326,700,626
Illinois,Shelby County,3,1361,686,675
Illinois,Shelby County,4,1329,655,674
Illinois,Shelby County,5,1232,643,589
Illinois,Shelby County,6,1155,580,575
Illinois,Shelby County,7,1180,601,579
Illinois,Shelby County,8,1183,614,569
Illinois,Shelby County,9,1287,644,643
Illinois,Shelby County,10,1360,684,676
Illinois,Shelby County,11,1687,841,846
Illinois,Shelby County,12,1680,828,852
Illinois,Shelby County,13,1550,769,781
Illinois,Shelby County,14,1384,667,717
Illinois,Shelby County,15,1092,533,559
Illinois,Shelby County,16,797,374,423
Illinois,Shelby County,17,608,254,354
Illinois,Shelby County,18,666,237,429
Illinois,Stark County,0,5813,2867,2946
Illinois,Stark County,1,284,153,131
Illinois,Stark County,2,306,147,159
Illinois,Stark County,3,353,169,184
Illinois,Stark County,4,378,186,192
Illinois,Stark County,5,294,140,154
Illinois,Stark County,6,263,136,127
Illinois,Stark County,7,259,138,121
Illinois,Stark County,8,311,168,143
Illinois,Stark County,9,325,149,176
Illinois,Stark County,10,354,180,174
Illinois,Stark County,11,414,222,192
Illinois,Stark County,12,444,227,217
Illinois,Stark County,13,411,195,216
Illinois,Stark County,14,395,205,190
Illinois,Stark County,15,349,177,172
Illinois,Stark County,16,269,135,134
Illinois,Stark County,17,190,75,115
Illinois,Stark County,18,214,65,149
Illinois,Stephenson County,0,46435,22475,23960
Illinois,Stephenson County,1,2613,1323,1290
Illinois,Stephenson County,2,2828,1398,1430
Illinois,Stephenson County,3,2891,1496,1395
Illinois,Stephenson County,4,2788,1423,1365
Illinois,Stephenson County,5,2722,1395,1327
Illinois,Stephenson County,6,2350,1137,1213
Illinois,Stephenson County,7,2424,1164,1260
Illinois,Stephenson County,8,2240,1060,1180
Illinois,Stephenson County,9,2604,1325,1279
Illinois,Stephenson County,10,2964,1476,1488
Illinois,Stephenson County,11,3587,1734,1853
Illinois,Stephenson County,12,3597,1791,1806
Illinois,Stephenson County,13,3304,1618,1686
Illinois,Stephenson County,14,2725,1294,1431
Illinois,Stephenson County,15,2164,999,1165
Illinois,Stephenson County,16,1735,785,950
Illinois,Stephenson County,17,1334,581,753
Illinois,Stephenson County,18,1565,476,1089
Illinois,Tazewell County,0,135707,66987,68720
Illinois,Tazewell County,1,8179,4147,4032
Illinois,Tazewell County,2,8908,4518,4390
Illinois,Tazewell County,3,8909,4532,4377
Illinois,Tazewell County,4,8080,4234,3846
Illinois,Tazewell County,5,7539,3796,3743
Illinois,Tazewell County,6,7893,4042,3851
Illinois,Tazewell County,7,9013,4644,4369
Illinois,Tazewell County,8,8917,4557,4360
Illinois,Tazewell County,9,8648,4310,4338
Illinois,Tazewell County,10,8606,4374,4232
Illinois,Tazewell County,11,9651,4776,4875
Illinois,Tazewell County,12,9697,4746,4951
Illinois,Tazewell County,13,8584,4169,4415
Illinois,Tazewell County,14,7177,3433,3744
Illinois,Tazewell County,15,5257,2434,2823
Illinois,Tazewell County,16,4147,1817,2330
Illinois,Tazewell County,17,3179,1302,1877
Illinois,Tazewell County,18,3323,1156,2167
Illinois,Union County,0,17447,8702,8745
Illinois,Union County,1,924,476,448
Illinois,Union County,2,1004,517,487
Illinois,Union County,3,1116,564,552
Illinois,Union County,4,932,492,440
Illinois,Union County,5,1027,525,502
Illinois,Union County,6,1015,532,483
Illinois,Union County,7,928,482,446
Illinois,Union County,8,954,481,473
Illinois,Union County,9,1083,531,552
Illinois,Union County,10,1109,561,548
Illinois,Union County,11,1349,688,661
Illinois,Union County,12,1339,649,690
Illinois,Union County,13,1194,611,583
Illinois,Union County,14,1080,524,556
Illinois,Union County,15,870,410,460
Illinois,Union County,16,695,333,362
Illinois,Union County,17,393,169,224
Illinois,Union County,18,435,157,278
Illinois,Vermilion County,0,79728,39600,40128
Illinois,Vermilion County,1,5343,2746,2597
Illinois,Vermilion County,2,5421,2797,2624
Illinois,Vermilion County,3,5231,2630,2601
Illinois,Vermilion County,4,4901,2555,2346
Illinois,Vermilion County,5,5013,2550,2463
Illinois,Vermilion County,6,4579,2355,2224
Illinois,Vermilion County,7,4706,2422,2284
Illinois,Vermilion County,8,4627,2469,2158
Illinois,Vermilion County,9,4740,2445,2295
Illinois,Vermilion County,10,4712,2313,2399
Illinois,Vermilion County,11,5730,2853,2877
Illinois,Vermilion County,12,5653,2772,2881
Illinois,Vermilion County,13,5231,2514,2717
Illinois,Vermilion County,14,4365,2116,2249
Illinois,Vermilion County,15,3266,1533,1733
Illinois,Vermilion County,16,2485,1098,1387
Illinois,Vermilion County,17,1820,763,1057
Illinois,Vermilion County,18,1905,669,1236
Illinois,Wabash County,0,11549,5704,5845
Illinois,Wabash County,1,675,341,334
Illinois,Wabash County,2,746,387,359
Illinois,Wabash County,3,697,361,336
Illinois,Wabash County,4,670,332,338
Illinois,Wabash County,5,740,404,336
Illinois,Wabash County,6,589,292,297
Illinois,Wabash County,7,701,374,327
Illinois,Wabash County,8,615,318,297
Illinois,Wabash County,9,648,304,344
Illinois,Wabash County,10,654,326,328
Illinois,Wabash County,11,879,448,431
Illinois,Wabash County,12,937,444,493
Illinois,Wabash County,13,819,407,412
Illinois,Wabash County,14,634,314,320
Illinois,Wabash County,15,477,235,242
Illinois,Wabash County,16,397,181,216
Illinois,Wabash County,17,309,122,187
Illinois,Wabash County,18,362,114,248
Illinois,Warren County,0,17874,8720,9154
Illinois,Warren County,1,1077,556,521
Illinois,Warren County,2,1078,526,552
Illinois,Warren County,3,1050,508,542
Illinois,Warren County,4,1448,710,738
Illinois,Warren County,5,1440,716,724
Illinois,Warren County,6,899,464,435
Illinois,Warren County,7,985,499,486
Illinois,Warren County,8,947,492,455
Illinois,Warren County,9,1001,489,512
Illinois,Warren County,10,1000,521,479
Illinois,Warren County,11,1182,574,608
Illinois,Warren County,12,1283,644,639
Illinois,Warren County,13,1196,593,603
Illinois,Warren County,14,991,478,513
Illinois,Warren County,15,778,363,415
Illinois,Warren County,16,649,292,357
Illinois,Warren County,17,416,157,259
Illinois,Warren County,18,454,138,316
Illinois,Washington County,0,14337,7177,7160
Illinois,Washington County,1,642,306,336
Illinois,Washington County,2,891,436,455
Illinois,Washington County,3,910,466,444
Illinois,Washington County,4,836,437,399
Illinois,Washington County,5,800,399,401
Illinois,Washington County,6,824,443,381
Illinois,Washington County,7,857,459,398
Illinois,Washington County,8,860,430,430
Illinois,Washington County,9,853,434,419
Illinois,Washington County,10,906,455,451
Illinois,Washington County,11,1195,595,600
Illinois,Washington County,12,1160,604,556
Illinois,Washington County,13,972,533,439
Illinois,Washington County,14,755,385,370
Illinois,Washington County,15,605,264,341
Illinois,Washington County,16,476,217,259
Illinois,Washington County,17,348,152,196
Illinois,Washington County,18,447,162,285
Illinois,Wayne County,0,16543,8159,8384
Illinois,Wayne County,1,938,466,472
Illinois,Wayne County,2,1051,553,498
Illinois,Wayne County,3,1090,546,544
Illinois,Wayne County,4,972,502,470
Illinois,Wayne County,5,922,499,423
Illinois,Wayne County,6,870,439,431
Illinois,Wayne County,7,967,472,495
Illinois,Wayne County,8,938,446,492
Illinois,Wayne County,9,986,488,498
Illinois,Wayne County,10,1031,528,503
Illinois,Wayne County,11,1180,589,591
Illinois,Wayne County,12,1215,629,586
Illinois,Wayne County,13,1104,527,577
Illinois,Wayne County,14,939,470,469
Illinois,Wayne County,15,813,371,442
Illinois,Wayne County,16,632,288,344
Illinois,Wayne County,17,460,191,269
Illinois,Wayne County,18,435,155,280
Illinois,White County,0,14374,6984,7390
Illinois,White County,1,928,448,480
Illinois,White County,2,893,445,448
Illinois,White County,3,816,404,412
Illinois,White County,4,748,385,363
Illinois,White County,5,716,348,368
Illinois,White County,6,758,394,364
Illinois,White County,7,870,428,442
Illinois,White County,8,751,378,373
Illinois,White County,9,746,368,378
Illinois,White County,10,881,459,422
Illinois,White County,11,1099,547,552
Illinois,White County,12,1106,561,545
Illinois,White County,13,928,457,471
Illinois,White County,14,888,412,476
Illinois,White County,15,698,318,380
Illinois,White County,16,604,274,330
Illinois,White County,17,439,174,265
Illinois,White County,18,505,184,321
Illinois,Whiteside County,0,56876,28048,28828
Illinois,Whiteside County,1,3087,1603,1484
Illinois,Whiteside County,2,3580,1836,1744
Illinois,Whiteside County,3,3707,1875,1832
Illinois,Whiteside County,4,3671,1860,1811
Illinois,Whiteside County,5,3328,1734,1594
Illinois,Whiteside County,6,3020,1513,1507
Illinois,Whiteside County,7,3047,1525,1522
Illinois,Whiteside County,8,3055,1539,1516
Illinois,Whiteside County,9,3475,1756,1719
Illinois,Whiteside County,10,3652,1833,1819
Illinois,Whiteside County,11,4177,2066,2111
Illinois,Whiteside County,12,4354,2201,2153
Illinois,Whiteside County,13,3958,1955,2003
Illinois,Whiteside County,14,3202,1526,1676
Illinois,Whiteside County,15,2496,1204,1292
Illinois,Whiteside County,16,1942,863,1079
Illinois,Whiteside County,17,1448,609,839
Illinois,Whiteside County,18,1677,550,1127
Illinois,Will County,0,685419,339944,345475
Illinois,Will County,1,41698,21164,20534
Illinois,Will County,2,50774,25888,24886
Illinois,Will County,3,56456,28961,27495
Illinois,Will County,4,52684,27323,25361
Illinois,Will County,5,44042,22658,21384
Illinois,Will County,6,36467,18664,17803
Illinois,Will County,7,42150,20654,21496
Illinois,Will County,8,46475,22694,23781
Illinois,Will County,9,53215,26257,26958
Illinois,Will County,10,53555,26630,26925
Illinois,Will County,11,52199,26084,26115
Illinois,Will County,12,44524,22165,22359
Illinois,Will County,13,34750,16886,17864
Illinois,Will County,14,27402,13080,14322
Illinois,Will County,15,18999,8808,10191
Illinois,Will County,16,12825,5661,7164
Illinois,Will County,17,8442,3463,4979
Illinois,Will County,18,8762,2904,5858
Illinois,Williamson County,0,67008,33270,33738
Illinois,Williamson County,1,3947,2039,1908
Illinois,Williamson County,2,4122,2123,1999
Illinois,Williamson County,3,4179,2136,2043
Illinois,Williamson County,4,3674,1886,1788
Illinois,Williamson County,5,3947,1981,1966
Illinois,Williamson County,6,4413,2274,2139
Illinois,Williamson County,7,4470,2267,2203
Illinois,Williamson County,8,4236,2246,1990
Illinois,Williamson County,9,4372,2225,2147
Illinois,Williamson County,10,4174,2154,2020
Illinois,Williamson County,11,4841,2395,2446
Illinois,Williamson County,12,4680,2317,2363
Illinois,Williamson County,13,4144,2023,2121
Illinois,Williamson County,14,3827,1809,2018
Illinois,Williamson County,15,2984,1367,1617
Illinois,Williamson County,16,2177,965,1212
Illinois,Williamson County,17,1436,602,834
Illinois,Williamson County,18,1385,461,924
Illinois,Winnebago County,0,288542,140803,147739
Illinois,Winnebago County,1,17863,9066,8797
Illinois,Winnebago County,2,19107,9802,9305
Illinois,Winnebago County,3,19797,10128,9669
Illinois,Winnebago County,4,18716,9523,9193
Illinois,Winnebago County,5,18326,9121,9205
Illinois,Winnebago County,6,17456,8550,8906
Illinois,Winnebago County,7,17783,8614,9169
Illinois,Winnebago County,8,16965,8338,8627
Illinois,Winnebago County,9,18561,9226,9335
Illinois,Winnebago County,10,18895,9301,9594
Illinois,Winnebago County,11,21465,10686,10779
Illinois,Winnebago County,12,20505,10045,10460
Illinois,Winnebago County,13,17989,8693,9296
Illinois,Winnebago County,14,14637,6938,7699
Illinois,Winnebago County,15,10745,4991,5754
Illinois,Winnebago County,16,7531,3324,4207
Illinois,Winnebago County,17,5685,2307,3378
Illinois,Winnebago County,18,6516,2150,4366
Illinois,Woodford County,0,39187,19429,19758
Illinois,Woodford County,1,2387,1230,1157
Illinois,Woodford County,2,2666,1363,1303
Illinois,Woodford County,3,2861,1491,1370
Illinois,Woodford County,4,2746,1407,1339
Illinois,Woodford County,5,2450,1228,1222
Illinois,Woodford County,6,1902,973,929
Illinois,Woodford County,7,2263,1121,1142
Illinois,Woodford County,8,2313,1196,1117
Illinois,Woodford County,9,2296,1122,1174
Illinois,Woodford County,10,2514,1252,1262
Illinois,Woodford County,11,2919,1453,1466
Illinois,Woodford County,12,2897,1444,1453
Illinois,Woodford County,13,2582,1294,1288
Illinois,Woodford County,14,1911,979,932
Illinois,Woodford County,15,1412,671,741
Illinois,Woodford County,16,1109,505,604
Illinois,Woodford County,17,850,337,513
Illinois,Woodford County,18,1109,363,746
Indiana,Adams County,0,34791,17232,17559
Indiana,Adams County,1,3276,1712,1564
Indiana,Adams County,2,3075,1545,1530
Indiana,Adams County,3,2865,1415,1450
Indiana,Adams County,4,2533,1320,1213
Indiana,Adams County,5,2145,1128,1017
Indiana,Adams County,6,1919,966,953
Indiana,Adams County,7,1982,1027,955
Indiana,Adams County,8,1886,946,940
Indiana,Adams County,9,1917,976,941
Indiana,Adams County,10,1987,1016,971
Indiana,Adams County,11,2143,1058,1085
Indiana,Adams County,12,2144,1034,1110
Indiana,Adams County,13,1892,947,945
Indiana,Adams County,14,1495,713,782
Indiana,Adams County,15,1099,502,597
Indiana,Adams County,16,876,377,499
Indiana,Adams County,17,652,273,379
Indiana,Adams County,18,905,277,628
Indiana,Allen County,0,365918,178564,187354
Indiana,Allen County,1,26436,13573,12863
Indiana,Allen County,2,26807,13673,13134
Indiana,Allen County,3,27065,13546,13519
Indiana,Allen County,4,25211,12866,12345
Indiana,Allen County,5,25102,12314,12788
Indiana,Allen County,6,24730,12210,12520
Indiana,Allen County,7,24042,11833,12209
Indiana,Allen County,8,22717,11175,11542
Indiana,Allen County,9,23344,11555,11789
Indiana,Allen County,10,22521,11107,11414
Indiana,Allen County,11,24864,12294,12570
Indiana,Allen County,12,24338,11790,12548
Indiana,Allen County,13,20847,10059,10788
Indiana,Allen County,14,16161,7536,8625
Indiana,Allen County,15,11062,5095,5967
Indiana,Allen County,16,7682,3309,4373
Indiana,Allen County,17,5954,2335,3619
Indiana,Allen County,18,7035,2294,4741
Indiana,Bartholomew County,0,80217,39999,40218
Indiana,Bartholomew County,1,5291,2555,2736
Indiana,Bartholomew County,2,5543,2852,2691
Indiana,Bartholomew County,3,5434,2744,2690
Indiana,Bartholomew County,4,4907,2570,2337
Indiana,Bartholomew County,5,5006,2601,2405
Indiana,Bartholomew County,6,5510,2970,2540
Indiana,Bartholomew County,7,5320,2807,2513
Indiana,Bartholomew County,8,5198,2692,2506
Indiana,Bartholomew County,9,5385,2753,2632
Indiana,Bartholomew County,10,5190,2645,2545
Indiana,Bartholomew County,11,5510,2709,2801
Indiana,Bartholomew County,12,5267,2597,2670
Indiana,Bartholomew County,13,4698,2266,2432
Indiana,Bartholomew County,14,3864,1804,2060
Indiana,Bartholomew County,15,2991,1377,1614
Indiana,Bartholomew County,16,2083,915,1168
Indiana,Bartholomew County,17,1505,653,852
Indiana,Bartholomew County,18,1515,489,1026
Indiana,Benton County,0,8700,4325,4375
Indiana,Benton County,1,533,299,234
Indiana,Benton County,2,637,330,307
Indiana,Benton County,3,649,349,300
Indiana,Benton County,4,578,310,268
Indiana,Benton County,5,481,264,217
Indiana,Benton County,6,410,207,203
Indiana,Benton County,7,536,269,267
Indiana,Benton County,8,504,238,266
Indiana,Benton County,9,529,236,293
Indiana,Benton County,10,589,304,285
Indiana,Benton County,11,664,326,338
Indiana,Benton County,12,646,322,324
Indiana,Benton County,13,531,269,262
Indiana,Benton County,14,424,198,226
Indiana,Benton County,15,367,166,201
Indiana,Benton County,16,250,110,140
Indiana,Benton County,17,175,67,108
Indiana,Benton County,18,197,61,136
Indiana,Blackford County,0,12401,6153,6248
Indiana,Blackford County,1,757,392,365
Indiana,Blackford County,2,735,369,366
Indiana,Blackford County,3,769,427,342
Indiana,Blackford County,4,780,419,361
Indiana,Blackford County,5,708,362,346
Indiana,Blackford County,6,641,325,316
Indiana,Blackford County,7,636,322,314
Indiana,Blackford County,8,620,308,312
Indiana,Blackford County,9,806,402,404
Indiana,Blackford County,10,786,415,371
Indiana,Blackford County,11,939,471,468
Indiana,Blackford County,12,921,463,458
Indiana,Blackford County,13,853,423,430
Indiana,Blackford County,14,737,358,379
Indiana,Blackford County,15,626,289,337
Indiana,Blackford County,16,452,185,267
Indiana,Blackford County,17,332,141,191
Indiana,Blackford County,18,303,82,221
Indiana,Boone County,0,61915,30644,31271
Indiana,Boone County,1,4087,2122,1965
Indiana,Boone County,2,4791,2503,2288
Indiana,Boone County,3,4905,2567,2338
Indiana,Boone County,4,4438,2309,2129
Indiana,Boone County,5,3263,1685,1578
Indiana,Boone County,6,3123,1569,1554
Indiana,Boone County,7,3803,1859,1944
Indiana,Boone County,8,4068,1984,2084
Indiana,Boone County,9,4542,2230,2312
Indiana,Boone County,10,4562,2277,2285
Indiana,Boone County,11,4917,2370,2547
Indiana,Boone County,12,4387,2190,2197
Indiana,Boone County,13,3224,1560,1664
Indiana,Boone County,14,2537,1229,1308
Indiana,Boone County,15,1893,869,1024
Indiana,Boone County,16,1361,598,763
Indiana,Boone County,17,944,384,560
Indiana,Boone County,18,1070,339,731
Indiana,Brown County,0,14962,7458,7504
Indiana,Brown County,1,616,311,305
Indiana,Brown County,2,780,388,392
Indiana,Brown County,3,953,483,470
Indiana,Brown County,4,874,467,407
Indiana,Brown County,5,724,350,374
Indiana,Brown County,6,572,292,280
Indiana,Brown County,7,697,355,342
Indiana,Brown County,8,740,376,364
Indiana,Brown County,9,902,464,438
Indiana,Brown County,10,1003,488,515
Indiana,Brown County,11,1177,594,583
Indiana,Brown County,12,1403,679,724
Indiana,Brown County,13,1362,661,701
Indiana,Brown County,14,1211,603,608
Indiana,Brown County,15,836,437,399
Indiana,Brown County,16,520,256,264
Indiana,Brown County,17,309,149,160
Indiana,Brown County,18,283,105,178
Indiana,Carroll County,0,19923,9899,10024
Indiana,Carroll County,1,1056,531,525
Indiana,Carroll County,2,1288,640,648
Indiana,Carroll County,3,1384,706,678
Indiana,Carroll County,4,1379,688,691
Indiana,Carroll County,5,1087,563,524
Indiana,Carroll County,6,974,478,496
Indiana,Carroll County,7,1094,561,533
Indiana,Carroll County,8,1106,524,582
Indiana,Carroll County,9,1324,691,633
Indiana,Carroll County,10,1257,645,612
Indiana,Carroll County,11,1528,769,759
Indiana,Carroll County,12,1558,812,746
Indiana,Carroll County,13,1360,680,680
Indiana,Carroll County,14,1107,533,574
Indiana,Carroll County,15,899,433,466
Indiana,Carroll County,16,673,311,362
Indiana,Carroll County,17,391,167,224
Indiana,Carroll County,18,458,167,291
Indiana,Cass County,0,38438,19213,19225
Indiana,Cass County,1,2512,1241,1271
Indiana,Cass County,2,2473,1278,1195
Indiana,Cass County,3,2571,1333,1238
Indiana,Cass County,4,2634,1464,1170
Indiana,Cass County,5,2364,1283,1081
Indiana,Cass County,6,2037,1022,1015
Indiana,Cass County,7,2292,1134,1158
Indiana,Cass County,8,2347,1215,1132
Indiana,Cass County,9,2519,1298,1221
Indiana,Cass County,10,2531,1320,1211
Indiana,Cass County,11,2788,1402,1386
Indiana,Cass County,12,2800,1443,1357
Indiana,Cass County,13,2344,1116,1228
Indiana,Cass County,14,1885,891,994
Indiana,Cass County,15,1444,662,782
Indiana,Cass County,16,1159,485,674
Indiana,Cass County,17,834,334,500
Indiana,Cass County,18,904,292,612
Indiana,Clark County,0,114262,56097,58165
Indiana,Clark County,1,7146,3732,3414
Indiana,Clark County,2,7343,3727,3616
Indiana,Clark County,3,7359,3837,3522
Indiana,Clark County,4,6807,3525,3282
Indiana,Clark County,5,6947,3416,3531
Indiana,Clark County,6,7702,3818,3884
Indiana,Clark County,7,8103,4079,4024
Indiana,Clark County,8,7787,3961,3826
Indiana,Clark County,9,7980,4082,3898
Indiana,Clark County,10,7433,3667,3766
Indiana,Clark County,11,8372,4149,4223
Indiana,Clark County,12,7978,3842,4136
Indiana,Clark County,13,6967,3264,3703
Indiana,Clark County,14,5825,2688,3137
Indiana,Clark County,15,4028,1801,2227
Indiana,Clark County,16,2761,1172,1589
Indiana,Clark County,17,1917,776,1141
Indiana,Clark County,18,1807,561,1246
Indiana,Clay County,0,26562,13076,13486
Indiana,Clay County,1,1623,832,791
Indiana,Clay County,2,1640,844,796
Indiana,Clay County,3,1747,859,888
Indiana,Clay County,4,1728,881,847
Indiana,Clay County,5,1543,769,774
Indiana,Clay County,6,1523,770,753
Indiana,Clay County,7,1611,816,795
Indiana,Clay County,8,1571,768,803
Indiana,Clay County,9,1719,859,860
Indiana,Clay County,10,1693,849,844
Indiana,Clay County,11,1968,1008,960
Indiana,Clay County,12,2030,1009,1021
Indiana,Clay County,13,1746,857,889
Indiana,Clay County,14,1417,705,712
Indiana,Clay County,15,1055,479,576
Indiana,Clay County,16,784,328,456
Indiana,Clay County,17,614,255,359
Indiana,Clay County,18,550,188,362
Indiana,Clinton County,0,32776,16213,16563
Indiana,Clinton County,1,2263,1149,1114
Indiana,Clinton County,2,2472,1304,1168
Indiana,Clinton County,3,2472,1236,1236
Indiana,Clinton County,4,2115,1100,1015
Indiana,Clinton County,5,1945,975,970
Indiana,Clinton County,6,1903,976,927
Indiana,Clinton County,7,1906,961,945
Indiana,Clinton County,8,1891,939,952
Indiana,Clinton County,9,2059,1090,969
Indiana,Clinton County,10,2021,1015,1006
Indiana,Clinton County,11,2349,1163,1186
Indiana,Clinton County,12,2211,1077,1134
Indiana,Clinton County,13,1991,1000,991
Indiana,Clinton County,14,1526,737,789
Indiana,Clinton County,15,1167,532,635
Indiana,Clinton County,16,927,415,512
Indiana,Clinton County,17,720,270,450
Indiana,Clinton County,18,838,274,564
Indiana,Crawford County,0,10655,5403,5252
Indiana,Crawford County,1,561,282,279
Indiana,Crawford County,2,700,351,349
Indiana,Crawford County,3,682,356,326
Indiana,Crawford County,4,653,345,308
Indiana,Crawford County,5,616,285,331
Indiana,Crawford County,6,541,287,254
Indiana,Crawford County,7,535,286,249
Indiana,Crawford County,8,649,330,319
Indiana,Crawford County,9,668,326,342
Indiana,Crawford County,10,723,378,345
Indiana,Crawford County,11,854,437,417
Indiana,Crawford County,12,837,433,404
Indiana,Crawford County,13,802,413,389
Indiana,Crawford County,14,658,334,324
Indiana,Crawford County,15,487,250,237
Indiana,Crawford County,16,328,166,162
Indiana,Crawford County,17,198,83,115
Indiana,Crawford County,18,163,61,102
Indiana,Daviess County,0,32729,16296,16433
Indiana,Daviess County,1,2678,1377,1301
Indiana,Daviess County,2,2778,1375,1403
Indiana,Daviess County,3,2635,1349,1286
Indiana,Daviess County,4,2264,1168,1096
Indiana,Daviess County,5,2118,1089,1029
Indiana,Daviess County,6,2006,1046,960
Indiana,Daviess County,7,1936,1008,928
Indiana,Daviess County,8,1837,908,929
Indiana,Daviess County,9,1815,940,875
Indiana,Daviess County,10,1878,933,945
Indiana,Daviess County,11,2141,1088,1053
Indiana,Daviess County,12,2036,1039,997
Indiana,Daviess County,13,1856,915,941
Indiana,Daviess County,14,1496,721,775
Indiana,Daviess County,15,1137,536,601
Indiana,Daviess County,16,831,358,473
Indiana,Daviess County,17,609,244,365
Indiana,Daviess County,18,678,202,476
Indiana,Dearborn County,0,49506,24642,24864
Indiana,Dearborn County,1,2729,1418,1311
Indiana,Dearborn County,2,3161,1639,1522
Indiana,Dearborn County,3,3575,1777,1798
Indiana,Dearborn County,4,3299,1697,1602
Indiana,Dearborn County,5,2845,1464,1381
Indiana,Dearborn County,6,2517,1318,1199
Indiana,Dearborn County,7,2757,1359,1398
Indiana,Dearborn County,8,2863,1413,1450
Indiana,Dearborn County,9,3346,1697,1649
Indiana,Dearborn County,10,3547,1764,1783
Indiana,Dearborn County,11,4116,2076,2040
Indiana,Dearborn County,12,3775,1851,1924
Indiana,Dearborn County,13,3384,1682,1702
Indiana,Dearborn County,14,2656,1283,1373
Indiana,Dearborn County,15,1893,929,964
Indiana,Dearborn County,16,1340,636,704
Indiana,Dearborn County,17,843,358,485
Indiana,Dearborn County,18,860,281,579
Indiana,Decatur County,0,26524,13109,13415
Indiana,Decatur County,1,1579,811,768
Indiana,Decatur County,2,1796,912,884
Indiana,Decatur County,3,2021,1042,979
Indiana,Decatur County,4,1754,910,844
Indiana,Decatur County,5,1663,789,874
Indiana,Decatur County,6,1578,816,762
Indiana,Decatur County,7,1549,747,802
Indiana,Decatur County,8,1618,817,801
Indiana,Decatur County,9,1693,882,811
Indiana,Decatur County,10,1692,853,839
Indiana,Decatur County,11,1988,1007,981
Indiana,Decatur County,12,1895,951,944
Indiana,Decatur County,13,1621,805,816
Indiana,Decatur County,14,1310,618,692
Indiana,Decatur County,15,917,405,512
Indiana,Decatur County,16,768,347,421
Indiana,Decatur County,17,526,201,325
Indiana,Decatur County,18,556,196,360
Indiana,DeKalb County,0,42383,21087,21296
Indiana,DeKalb County,1,2542,1325,1217
Indiana,DeKalb County,2,2898,1456,1442
Indiana,DeKalb County,3,3041,1569,1472
Indiana,DeKalb County,4,2979,1562,1417
Indiana,DeKalb County,5,2644,1308,1336
Indiana,DeKalb County,6,2416,1205,1211
Indiana,DeKalb County,7,2444,1178,1266
Indiana,DeKalb County,8,2587,1371,1216
Indiana,DeKalb County,9,2738,1375,1363
Indiana,DeKalb County,10,2857,1473,1384
Indiana,DeKalb County,11,3261,1640,1621
Indiana,DeKalb County,12,3054,1543,1511
Indiana,DeKalb County,13,2638,1299,1339
Indiana,DeKalb County,14,2122,1049,1073
Indiana,DeKalb County,15,1510,702,808
Indiana,DeKalb County,16,1059,466,593
Indiana,DeKalb County,17,772,299,473
Indiana,DeKalb County,18,821,267,554
Indiana,Delaware County,0,117074,56336,60738
Indiana,Delaware County,1,5978,3111,2867
Indiana,Delaware County,2,5966,2972,2994
Indiana,Delaware County,3,6106,3201,2905
Indiana,Delaware County,4,10793,5048,5745
Indiana,Delaware County,5,16825,8086,8739
Indiana,Delaware County,6,6925,3561,3364
Indiana,Delaware County,7,5985,2944,3041
Indiana,Delaware County,8,5746,2797,2949
Indiana,Delaware County,9,6480,3215,3265
Indiana,Delaware County,10,6615,3213,3402
Indiana,Delaware County,11,7339,3580,3759
Indiana,Delaware County,12,7202,3503,3699
Indiana,Delaware County,13,6410,3003,3407
Indiana,Delaware County,14,5868,2669,3199
Indiana,Delaware County,15,4475,2050,2425
Indiana,Delaware County,16,3306,1519,1787
Indiana,Delaware County,17,2445,978,1467
Indiana,Delaware County,18,2610,886,1724
Indiana,Dubois County,0,42345,20913,21432
Indiana,Dubois County,1,2595,1294,1301
Indiana,Dubois County,2,2789,1420,1369
Indiana,Dubois County,3,2963,1477,1486
Indiana,Dubois County,4,2854,1414,1440
Indiana,Dubois County,5,2397,1151,1246
Indiana,Dubois County,6,2270,1164,1106
Indiana,Dubois County,7,2538,1322,1216
Indiana,Dubois County,8,2487,1296,1191
Indiana,Dubois County,9,2529,1309,1220
Indiana,Dubois County,10,2899,1476,1423
Indiana,Dubois County,11,3407,1756,1651
Indiana,Dubois County,12,3238,1647,1591
Indiana,Dubois County,13,2631,1326,1305
Indiana,Dubois County,14,2064,996,1068
Indiana,Dubois County,15,1587,695,892
Indiana,Dubois County,16,1245,546,699
Indiana,Dubois County,17,850,321,529
Indiana,Dubois County,18,1002,303,699
Indiana,Elkhart County,0,201971,99898,102073
Indiana,Elkhart County,1,15176,7870,7306
Indiana,Elkhart County,2,16217,8225,7992
Indiana,Elkhart County,3,15793,8076,7717
Indiana,Elkhart County,4,14170,7198,6972
Indiana,Elkhart County,5,13142,6635,6507
Indiana,Elkhart County,6,12670,6416,6254
Indiana,Elkhart County,7,12846,6461,6385
Indiana,Elkhart County,8,12370,6188,6182
Indiana,Elkhart County,9,12914,6471,6443
Indiana,Elkhart County,10,12814,6404,6410
Indiana,Elkhart County,11,13302,6758,6544
Indiana,Elkhart County,12,12472,6047,6425
Indiana,Elkhart County,13,11134,5420,5714
Indiana,Elkhart County,14,8613,4049,4564
Indiana,Elkhart County,15,6353,2958,3395
Indiana,Elkhart County,16,4616,2070,2546
Indiana,Elkhart County,17,3494,1414,2080
Indiana,Elkhart County,18,3875,1238,2637
Indiana,Fayette County,0,23468,11605,11863
Indiana,Fayette County,1,1239,622,617
Indiana,Fayette County,2,1444,735,709
Indiana,Fayette County,3,1629,857,772
Indiana,Fayette County,4,1457,782,675
Indiana,Fayette County,5,1324,669,655
Indiana,Fayette County,6,1171,571,600
Indiana,Fayette County,7,1240,599,641
Indiana,Fayette County,8,1497,738,759
Indiana,Fayette County,9,1522,816,706
Indiana,Fayette County,10,1540,812,728
Indiana,Fayette County,11,1649,785,864
Indiana,Fayette County,12,1689,809,880
Indiana,Fayette County,13,1739,856,883
Indiana,Fayette County,14,1383,655,728
Indiana,Fayette County,15,1054,511,543
Indiana,Fayette County,16,762,329,433
Indiana,Fayette County,17,541,231,310
Indiana,Fayette County,18,588,228,360
Indiana,Floyd County,0,76179,37046,39133
Indiana,Floyd County,1,4422,2289,2133
Indiana,Floyd County,2,4822,2448,2374
Indiana,Floyd County,3,5163,2612,2551
Indiana,Floyd County,4,5003,2521,2482
Indiana,Floyd County,5,4864,2390,2474
Indiana,Floyd County,6,4543,2277,2266
Indiana,Floyd County,7,4783,2330,2453
Indiana,Floyd County,8,4549,2235,2314
Indiana,Floyd County,9,5098,2488,2610
Indiana,Floyd County,10,5243,2575,2668
Indiana,Floyd County,11,6036,2952,3084
Indiana,Floyd County,12,5716,2785,2931
Indiana,Floyd County,13,4881,2312,2569
Indiana,Floyd County,14,3843,1837,2006
Indiana,Floyd County,15,2649,1225,1424
Indiana,Floyd County,16,1810,781,1029
Indiana,Floyd County,17,1302,505,797
Indiana,Floyd County,18,1452,484,968
Indiana,Fountain County,0,16658,8300,8358
Indiana,Fountain County,1,964,510,454
Indiana,Fountain County,2,962,491,471
Indiana,Fountain County,3,1094,563,531
Indiana,Fountain County,4,1131,602,529
Indiana,Fountain County,5,942,523,419
Indiana,Fountain County,6,845,446,399
Indiana,Fountain County,7,907,450,457
Indiana,Fountain County,8,916,447,469
Indiana,Fountain County,9,1041,509,532
Indiana,Fountain County,10,1114,578,536
Indiana,Fountain County,11,1302,658,644
Indiana,Fountain County,12,1234,613,621
Indiana,Fountain County,13,1001,493,508
Indiana,Fountain County,14,967,461,506
Indiana,Fountain County,15,760,355,405
Indiana,Fountain County,16,650,314,336
Indiana,Fountain County,17,396,167,229
Indiana,Fountain County,18,432,120,312
Indiana,Franklin County,0,22934,11517,11417
Indiana,Franklin County,1,1303,707,596
Indiana,Franklin County,2,1550,788,762
Indiana,Franklin County,3,1735,914,821
Indiana,Franklin County,4,1620,853,767
Indiana,Franklin County,5,1316,651,665
Indiana,Franklin County,6,1051,529,522
Indiana,Franklin County,7,1228,629,599
Indiana,Franklin County,8,1358,676,682
Indiana,Franklin County,9,1518,778,740
Indiana,Franklin County,10,1601,771,830
Indiana,Franklin County,11,1791,950,841
Indiana,Franklin County,12,1731,865,866
Indiana,Franklin County,13,1563,795,768
Indiana,Franklin County,14,1146,561,585
Indiana,Franklin County,15,887,432,455
Indiana,Franklin County,16,651,301,350
Indiana,Franklin County,17,452,186,266
Indiana,Franklin County,18,433,131,302
Indiana,Fulton County,0,20500,10254,10246
Indiana,Fulton County,1,1244,678,566
Indiana,Fulton County,2,1373,703,670
Indiana,Fulton County,3,1380,681,699
Indiana,Fulton County,4,1350,721,629
Indiana,Fulton County,5,1199,609,590
Indiana,Fulton County,6,1049,564,485
Indiana,Fulton County,7,1200,617,583
Indiana,Fulton County,8,1170,577,593
Indiana,Fulton County,9,1286,636,650
Indiana,Fulton County,10,1215,632,583
Indiana,Fulton County,11,1522,753,769
Indiana,Fulton County,12,1510,777,733
Indiana,Fulton County,13,1392,703,689
Indiana,Fulton County,14,1121,536,585
Indiana,Fulton County,15,909,430,479
Indiana,Fulton County,16,692,293,399
Indiana,Fulton County,17,446,180,266
Indiana,Fulton County,18,442,164,278
Indiana,Gibson County,0,33759,16862,16897
Indiana,Gibson County,1,2032,1097,935
Indiana,Gibson County,2,2232,1137,1095
Indiana,Gibson County,3,2215,1167,1048
Indiana,Gibson County,4,2156,1081,1075
Indiana,Gibson County,5,2116,1061,1055
Indiana,Gibson County,6,1902,974,928
Indiana,Gibson County,7,2041,1076,965
Indiana,Gibson County,8,1921,987,934
Indiana,Gibson County,9,2134,1069,1065
Indiana,Gibson County,10,2258,1149,1109
Indiana,Gibson County,11,2478,1271,1207
Indiana,Gibson County,12,2532,1262,1270
Indiana,Gibson County,13,2172,1095,1077
Indiana,Gibson County,14,1714,811,903
Indiana,Gibson County,15,1316,618,698
Indiana,Gibson County,16,990,434,556
Indiana,Gibson County,17,778,308,470
Indiana,Gibson County,18,772,265,507
Indiana,Grant County,0,68569,32788,35781
Indiana,Grant County,1,3778,1899,1879
Indiana,Grant County,2,3903,2013,1890
Indiana,Grant County,3,4047,2057,1990
Indiana,Grant County,4,5343,2543,2800
Indiana,Grant County,5,6432,3011,3421
Indiana,Grant County,6,3606,1720,1886
Indiana,Grant County,7,3473,1651,1822
Indiana,Grant County,8,3457,1712,1745
Indiana,Grant County,9,3976,1981,1995
Indiana,Grant County,10,4119,2024,2095
Indiana,Grant County,11,4885,2401,2484
Indiana,Grant County,12,4967,2413,2554
Indiana,Grant County,13,4423,2107,2316
Indiana,Grant County,14,3760,1806,1954
Indiana,Grant County,15,2941,1303,1638
Indiana,Grant County,16,2289,1019,1270
Indiana,Grant County,17,1639,663,976
Indiana,Grant County,18,1531,465,1066
Indiana,Greene County,0,32726,16338,16388
Indiana,Greene County,1,1772,875,897
Indiana,Greene County,2,2030,1015,1015
Indiana,Greene County,3,2264,1195,1069
Indiana,Greene County,4,2037,1060,977
Indiana,Greene County,5,1812,992,820
Indiana,Greene County,6,1725,851,874
Indiana,Greene County,7,1838,941,897
Indiana,Greene County,8,1782,919,863
Indiana,Greene County,9,2125,1014,1111
Indiana,Greene County,10,2309,1187,1122
Indiana,Greene County,11,2497,1297,1200
Indiana,Greene County,12,2429,1224,1205
Indiana,Greene County,13,2218,1093,1125
Indiana,Greene County,14,1883,922,961
Indiana,Greene County,15,1502,715,787
Indiana,Greene County,16,1032,491,541
Indiana,Greene County,17,707,273,434
Indiana,Greene County,18,764,274,490
Indiana,Hamilton County,0,302623,147791,154832
Indiana,Hamilton County,1,20506,10490,10016
Indiana,Hamilton County,2,24912,12637,12275
Indiana,Hamilton County,3,26082,13275,12807
Indiana,Hamilton County,4,21761,11172,10589
Indiana,Hamilton County,5,14509,7365,7144
Indiana,Hamilton County,6,16041,7488,8553
Indiana,Hamilton County,7,21278,10072,11206
Indiana,Hamilton County,8,22441,10780,11661
Indiana,Hamilton County,9,24697,12170,12527
Indiana,Hamilton County,10,23393,11497,11896
Indiana,Hamilton County,11,22304,10928,11376
Indiana,Hamilton County,12,18364,8907,9457
Indiana,Hamilton County,13,14771,7047,7724
Indiana,Hamilton County,14,11659,5557,6102
Indiana,Hamilton County,15,7681,3507,4174
Indiana,Hamilton County,16,5075,2237,2838
Indiana,Hamilton County,17,3367,1364,2003
Indiana,Hamilton County,18,3782,1298,2484
Indiana,Hancock County,0,71978,35315,36663
Indiana,Hancock County,1,3938,1937,2001
Indiana,Hancock County,2,4720,2407,2313
Indiana,Hancock County,3,5322,2719,2603
Indiana,Hancock County,4,5094,2655,2439
Indiana,Hancock County,5,3988,2017,1971
Indiana,Hancock County,6,3799,1866,1933
Indiana,Hancock County,7,4364,2160,2204
Indiana,Hancock County,8,4503,2220,2283
Indiana,Hancock County,9,4918,2403,2515
Indiana,Hancock County,10,5295,2602,2693
Indiana,Hancock County,11,5697,2772,2925
Indiana,Hancock County,12,5151,2552,2599
Indiana,Hancock County,13,4293,2060,2233
Indiana,Hancock County,14,3859,1836,2023
Indiana,Hancock County,15,2801,1324,1477
Indiana,Hancock County,16,1810,837,973
Indiana,Hancock County,17,1243,538,705
Indiana,Hancock County,18,1183,410,773
Indiana,Harrison County,0,39299,19622,19677
Indiana,Harrison County,1,2112,1145,967
Indiana,Harrison County,2,2559,1319,1240
Indiana,Harrison County,3,2638,1320,1318
Indiana,Harrison County,4,2360,1231,1129
Indiana,Harrison County,5,2197,1111,1086
Indiana,Harrison County,6,2223,1124,1099
Indiana,Harrison County,7,2430,1250,1180
Indiana,Harrison County,8,2382,1170,1212
Indiana,Harrison County,9,2570,1303,1267
Indiana,Harrison County,10,2656,1333,1323
Indiana,Harrison County,11,3269,1658,1611
Indiana,Harrison County,12,3070,1513,1557
Indiana,Harrison County,13,2548,1246,1302
Indiana,Harrison County,14,2202,1098,1104
Indiana,Harrison County,15,1589,781,808
Indiana,Harrison County,16,1028,465,563
Indiana,Harrison County,17,739,312,427
Indiana,Harrison County,18,727,243,484
Indiana,Hendricks County,0,156056,77790,78266
Indiana,Hendricks County,1,9408,4642,4766
Indiana,Hendricks County,2,11520,6057,5463
Indiana,Hendricks County,3,12349,6274,6075
Indiana,Hendricks County,4,10835,5522,5313
Indiana,Hendricks County,5,8630,4562,4068
Indiana,Hendricks County,6,9009,4641,4368
Indiana,Hendricks County,7,10822,5474,5348
Indiana,Hendricks County,8,11188,5577,5611
Indiana,Hendricks County,9,11760,5984,5776
Indiana,Hendricks County,10,11167,5609,5558
Indiana,Hendricks County,11,11526,5824,5702
Indiana,Hendricks County,12,10155,5006,5149
Indiana,Hendricks County,13,8450,4103,4347
Indiana,Hendricks County,14,6748,3225,3523
Indiana,Hendricks County,15,4733,2181,2552
Indiana,Hendricks County,16,3260,1417,1843
Indiana,Hendricks County,17,2249,951,1298
Indiana,Hendricks County,18,2247,741,1506
Indiana,Henry County,0,48995,25326,23669
Indiana,Henry County,1,2386,1285,1101
Indiana,Henry County,2,2752,1399,1353
Indiana,Henry County,3,3136,1651,1485
Indiana,Henry County,4,3033,1574,1459
Indiana,Henry County,5,3002,1656,1346
Indiana,Henry County,6,2810,1655,1155
Indiana,Henry County,7,2796,1581,1215
Indiana,Henry County,8,2989,1617,1372
Indiana,Henry County,9,3333,1891,1442
Indiana,Henry County,10,3503,1890,1613
Indiana,Henry County,11,3727,1928,1799
Indiana,Henry County,12,3549,1810,1739
Indiana,Henry County,13,3168,1558,1610
Indiana,Henry County,14,2806,1354,1452
Indiana,Henry County,15,2160,966,1194
Indiana,Henry County,16,1607,717,890
Indiana,Henry County,17,1086,425,661
Indiana,Henry County,18,1152,369,783
Indiana,Howard County,0,82982,40118,42864
Indiana,Howard County,1,5075,2599,2476
Indiana,Howard County,2,5236,2680,2556
Indiana,Howard County,3,5389,2747,2642
Indiana,Howard County,4,5143,2638,2505
Indiana,Howard County,5,5041,2517,2524
Indiana,Howard County,6,4774,2346,2428
Indiana,Howard County,7,4627,2230,2397
Indiana,Howard County,8,4733,2290,2443
Indiana,Howard County,9,5096,2494,2602
Indiana,Howard County,10,5313,2694,2619
Indiana,Howard County,11,6209,3001,3208
Indiana,Howard County,12,5958,2837,3121
Indiana,Howard County,13,5420,2542,2878
Indiana,Howard County,14,4703,2189,2514
Indiana,Howard County,15,3755,1705,2050
Indiana,Howard County,16,2623,1180,1443
Indiana,Howard County,17,1948,804,1144
Indiana,Howard County,18,1939,625,1314
Indiana,Huntington County,0,36706,18065,18641
Indiana,Huntington County,1,2115,1092,1023
Indiana,Huntington County,2,2192,1111,1081
Indiana,Huntington County,3,2363,1228,1135
Indiana,Huntington County,4,2612,1321,1291
Indiana,Huntington County,5,2654,1296,1358
Indiana,Huntington County,6,2187,1105,1082
Indiana,Huntington County,7,2125,1112,1013
Indiana,Huntington County,8,2138,1083,1055
Indiana,Huntington County,9,2217,1130,1087
Indiana,Huntington County,10,2313,1141,1172
Indiana,Huntington County,11,2850,1396,1454
Indiana,Huntington County,12,2833,1424,1409
Indiana,Huntington County,13,2278,1145,1133
Indiana,Huntington County,14,1777,833,944
Indiana,Huntington County,15,1344,608,736
Indiana,Huntington County,16,1081,482,599
Indiana,Huntington County,17,749,299,450
Indiana,Huntington County,18,878,259,619
Indiana,Jackson County,0,43705,21747,21958
Indiana,Jackson County,1,3015,1560,1455
Indiana,Jackson County,2,2867,1475,1392
Indiana,Jackson County,3,2997,1543,1454
Indiana,Jackson County,4,2681,1414,1267
Indiana,Jackson County,5,2650,1321,1329
Indiana,Jackson County,6,2602,1337,1265
Indiana,Jackson County,7,2843,1441,1402
Indiana,Jackson County,8,2795,1439,1356
Indiana,Jackson County,9,2898,1521,1377
Indiana,Jackson County,10,2931,1489,1442
Indiana,Jackson County,11,3161,1588,1573
Indiana,Jackson County,12,3061,1469,1592
Indiana,Jackson County,13,2535,1243,1292
Indiana,Jackson County,14,2139,1013,1126
Indiana,Jackson County,15,1599,750,849
Indiana,Jackson County,16,1264,546,718
Indiana,Jackson County,17,860,320,540
Indiana,Jackson County,18,807,278,529
Indiana,Jasper County,0,33475,16684,16791
Indiana,Jasper County,1,1986,1002,984
Indiana,Jasper County,2,2257,1154,1103
Indiana,Jasper County,3,2419,1216,1203
Indiana,Jasper County,4,2507,1339,1168
Indiana,Jasper County,5,2275,1193,1082
Indiana,Jasper County,6,1715,889,826
Indiana,Jasper County,7,1874,942,932
Indiana,Jasper County,8,2083,1052,1031
Indiana,Jasper County,9,2055,1018,1037
Indiana,Jasper County,10,2108,1054,1054
Indiana,Jasper County,11,2555,1276,1279
Indiana,Jasper County,12,2359,1176,1183
Indiana,Jasper County,13,1991,983,1008
Indiana,Jasper County,14,1772,835,937
Indiana,Jasper County,15,1322,645,677
Indiana,Jasper County,16,964,443,521
Indiana,Jasper County,17,611,263,348
Indiana,Jasper County,18,622,204,418
Indiana,Jay County,0,21179,10438,10741
Indiana,Jay County,1,1482,747,735
Indiana,Jay County,2,1458,741,717
Indiana,Jay County,3,1568,812,756
Indiana,Jay County,4,1495,761,734
Indiana,Jay County,5,1257,623,634
Indiana,Jay County,6,1155,603,552
Indiana,Jay County,7,1156,586,570
Indiana,Jay County,8,1134,587,547
Indiana,Jay County,9,1352,655,697
Indiana,Jay County,10,1405,711,694
Indiana,Jay County,11,1494,723,771
Indiana,Jay County,12,1434,732,702
Indiana,Jay County,13,1299,629,670
Indiana,Jay County,14,1125,524,601
Indiana,Jay County,15,825,395,430
Indiana,Jay County,16,660,301,359
Indiana,Jay County,17,405,150,255
Indiana,Jay County,18,475,158,317
Indiana,Jefferson County,0,32494,15660,16834
Indiana,Jefferson County,1,1761,878,883
Indiana,Jefferson County,2,1866,955,911
Indiana,Jefferson County,3,1946,1022,924
Indiana,Jefferson County,4,2346,1079,1267
Indiana,Jefferson County,5,2332,1122,1210
Indiana,Jefferson County,6,1814,871,943
Indiana,Jefferson County,7,1912,878,1034
Indiana,Jefferson County,8,1954,935,1019
Indiana,Jefferson County,9,2082,1020,1062
Indiana,Jefferson County,10,2163,1028,1135
Indiana,Jefferson County,11,2516,1269,1247
Indiana,Jefferson County,12,2423,1180,1243
Indiana,Jefferson County,13,2097,1047,1050
Indiana,Jefferson County,14,1787,866,921
Indiana,Jefferson County,15,1369,655,714
Indiana,Jefferson County,16,840,384,456
Indiana,Jefferson County,17,677,280,397
Indiana,Jefferson County,18,609,191,418
Indiana,Jennings County,0,28000,14047,13953
Indiana,Jennings County,1,1732,917,815
Indiana,Jennings County,2,1833,927,906
Indiana,Jennings County,3,1901,967,934
Indiana,Jennings County,4,1988,1010,978
Indiana,Jennings County,5,1862,965,897
Indiana,Jennings County,6,1548,803,745
Indiana,Jennings County,7,1494,753,741
Indiana,Jennings County,8,1646,842,804
Indiana,Jennings County,9,1979,986,993
Indiana,Jennings County,10,2040,1055,985
Indiana,Jennings County,11,2187,1099,1088
Indiana,Jennings County,12,2005,1045,960
Indiana,Jennings County,13,1650,805,845
Indiana,Jennings County,14,1486,707,779
Indiana,Jennings County,15,1138,558,580
Indiana,Jennings County,16,737,324,413
Indiana,Jennings County,17,414,166,248
Indiana,Jennings County,18,360,118,242
Indiana,Johnson County,0,147538,72705,74833
Indiana,Johnson County,1,9549,4976,4573
Indiana,Johnson County,2,10334,5282,5052
Indiana,Johnson County,3,11010,5728,5282
Indiana,Johnson County,4,10224,5242,4982
Indiana,Johnson County,5,9184,4611,4573
Indiana,Johnson County,6,9093,4460,4633
Indiana,Johnson County,7,9898,4900,4998
Indiana,Johnson County,8,9767,4866,4901
Indiana,Johnson County,9,10255,5160,5095
Indiana,Johnson County,10,9929,4975,4954
Indiana,Johnson County,11,10521,5220,5301
Indiana,Johnson County,12,9370,4554,4816
Indiana,Johnson County,13,7978,3804,4174
Indiana,Johnson County,14,6856,3220,3636
Indiana,Johnson County,15,5041,2323,2718
Indiana,Johnson County,16,3539,1546,1993
Indiana,Johnson County,17,2417,979,1438
Indiana,Johnson County,18,2573,859,1714
Indiana,Knox County,0,37938,19220,18718
Indiana,Knox County,1,2368,1247,1121
Indiana,Knox County,2,2182,1113,1069
Indiana,Knox County,3,2135,1071,1064
Indiana,Knox County,4,3191,1775,1416
Indiana,Knox County,5,3392,1986,1406
Indiana,Knox County,6,2165,1177,988
Indiana,Knox County,7,2238,1167,1071
Indiana,Knox County,8,1956,1006,950
Indiana,Knox County,9,2061,1020,1041
Indiana,Knox County,10,2147,1130,1017
Indiana,Knox County,11,2737,1379,1358
Indiana,Knox County,12,2671,1320,1351
Indiana,Knox County,13,2358,1167,1191
Indiana,Knox County,14,1958,916,1042
Indiana,Knox County,15,1518,670,848
Indiana,Knox County,16,1188,535,653
Indiana,Knox County,17,823,295,528
Indiana,Knox County,18,850,246,604
Indiana,Kosciusko County,0,78564,39173,39391
Indiana,Kosciusko County,1,5099,2619,2480
Indiana,Kosciusko County,2,5449,2802,2647
Indiana,Kosciusko County,3,5524,2812,2712
Indiana,Kosciusko County,4,5399,2762,2637
Indiana,Kosciusko County,5,5289,2632,2657
Indiana,Kosciusko County,6,4782,2416,2366
Indiana,Kosciusko County,7,4969,2593,2376
Indiana,Kosciusko County,8,4534,2361,2173
Indiana,Kosciusko County,9,4828,2411,2417
Indiana,Kosciusko County,10,4908,2456,2452
Indiana,Kosciusko County,11,5635,2780,2855
Indiana,Kosciusko County,12,5547,2776,2771
Indiana,Kosciusko County,13,4794,2394,2400
Indiana,Kosciusko County,14,3966,1945,2021
Indiana,Kosciusko County,15,2913,1372,1541
Indiana,Kosciusko County,16,2097,974,1123
Indiana,Kosciusko County,17,1454,599,855
Indiana,Kosciusko County,18,1377,469,908
Indiana,LaGrange County,0,38436,19390,19046
Indiana,LaGrange County,1,3696,1924,1772
Indiana,LaGrange County,2,3608,1867,1741
Indiana,LaGrange County,3,3519,1794,1725
Indiana,LaGrange County,4,3109,1669,1440
Indiana,LaGrange County,5,2439,1275,1164
Indiana,LaGrange County,6,2275,1102,1173
Indiana,LaGrange County,7,2303,1187,1116
Indiana,LaGrange County,8,2131,1085,1046
Indiana,LaGrange County,9,2101,1083,1018
Indiana,LaGrange County,10,2078,1033,1045
Indiana,LaGrange County,11,2222,1070,1152
Indiana,LaGrange County,12,2099,1047,1052
Indiana,LaGrange County,13,1998,989,1009
Indiana,LaGrange County,14,1649,819,830
Indiana,LaGrange County,15,1275,616,659
Indiana,LaGrange County,16,838,390,448
Indiana,LaGrange County,17,572,245,327
Indiana,LaGrange County,18,524,195,329
Indiana,Lake County,0,490228,237188,253040
Indiana,Lake County,1,30659,15821,14838
Indiana,Lake County,2,32905,16945,15960
Indiana,Lake County,3,35081,17847,17234
Indiana,Lake County,4,33590,17124,16466
Indiana,Lake County,5,32317,16208,16109
Indiana,Lake County,6,28561,14145,14416
Indiana,Lake County,7,31767,15264,16503
Indiana,Lake County,8,30395,14663,15732
Indiana,Lake County,9,31026,15011,16015
Indiana,Lake County,10,31110,15090,16020
Indiana,Lake County,11,35259,16931,18328
Indiana,Lake County,12,36045,17336,18709
Indiana,Lake County,13,30030,14348,15682
Indiana,Lake County,14,23254,10794,12460
Indiana,Lake County,15,16645,7295,9350
Indiana,Lake County,16,12256,5270,6986
Indiana,Lake County,17,9345,3750,5595
Indiana,Lake County,18,9983,3346,6637
Indiana,LaPorte County,0,111444,57677,53767
Indiana,LaPorte County,1,6535,3255,3280
Indiana,LaPorte County,2,6658,3408,3250
Indiana,LaPorte County,3,6821,3448,3373
Indiana,LaPorte County,4,6814,3578,3236
Indiana,LaPorte County,5,7253,4116,3137
Indiana,LaPorte County,6,7117,4110,3007
Indiana,LaPorte County,7,7405,4217,3188
Indiana,LaPorte County,8,6835,3805,3030
Indiana,LaPorte County,9,7165,3896,3269
Indiana,LaPorte County,10,7458,3965,3493
Indiana,LaPorte County,11,8144,4199,3945
Indiana,LaPorte County,12,8212,4192,4020
Indiana,LaPorte County,13,7441,3688,3753
Indiana,LaPorte County,14,5999,2900,3099
Indiana,LaPorte County,15,4323,2017,2306
Indiana,LaPorte County,16,2960,1321,1639
Indiana,LaPorte County,17,2077,844,1233
Indiana,LaPorte County,18,2227,718,1509
Indiana,Lawrence County,0,45704,22644,23060
Indiana,Lawrence County,1,2538,1291,1247
Indiana,Lawrence County,2,2761,1466,1295
Indiana,Lawrence County,3,2970,1508,1462
Indiana,Lawrence County,4,2889,1556,1333
Indiana,Lawrence County,5,2524,1303,1221
Indiana,Lawrence County,6,2416,1205,1211
Indiana,Lawrence County,7,2553,1253,1300
Indiana,Lawrence County,8,2628,1320,1308
Indiana,Lawrence County,9,2924,1502,1422
Indiana,Lawrence County,10,3124,1577,1547
Indiana,Lawrence County,11,3502,1714,1788
Indiana,Lawrence County,12,3373,1663,1710
Indiana,Lawrence County,13,3193,1590,1603
Indiana,Lawrence County,14,2747,1332,1415
Indiana,Lawrence County,15,2092,965,1127
Indiana,Lawrence County,16,1445,645,800
Indiana,Lawrence County,17,1001,413,588
Indiana,Lawrence County,18,1024,341,683
Indiana,Madison County,0,130069,64967,65102
Indiana,Madison County,1,7376,3702,3674
Indiana,Madison County,2,8057,4178,3879
Indiana,Madison County,3,8163,4271,3892
Indiana,Madison County,4,8279,4329,3950
Indiana,Madison County,5,8374,4289,4085
Indiana,Madison County,6,7999,4157,3842
Indiana,Madison County,7,8152,4358,3794
Indiana,Madison County,8,8049,4192,3857
Indiana,Madison County,9,8486,4381,4105
Indiana,Madison County,10,8730,4528,4202
Indiana,Madison County,11,9267,4663,4604
Indiana,Madison County,12,8910,4369,4541
Indiana,Madison County,13,8188,3912,4276
Indiana,Madison County,14,7299,3429,3870
Indiana,Madison County,15,5221,2448,2773
Indiana,Madison County,16,3845,1657,2188
Indiana,Madison County,17,2808,1147,1661
Indiana,Madison County,18,2866,957,1909
Indiana,Marion County,0,934243,449848,484395
Indiana,Marion County,1,70544,36168,34376
Indiana,Marion County,2,65954,33613,32341
Indiana,Marion County,3,61410,31313,30097
Indiana,Marion County,4,56984,28535,28449
Indiana,Marion County,5,69470,33437,36033
Indiana,Marion County,6,80188,38197,41991
Indiana,Marion County,7,73283,35714,37569
Indiana,Marion County,8,61544,30204,31340
Indiana,Marion County,9,58689,28740,29949
Indiana,Marion County,10,57177,27911,29266
Indiana,Marion County,11,63572,30583,32989
Indiana,Marion County,12,60722,28936,31786
Indiana,Marion County,13,49263,22886,26377
Indiana,Marion County,14,35479,16182,19297
Indiana,Marion County,15,24128,10445,13683
Indiana,Marion County,16,17629,7223,10406
Indiana,Marion County,17,13293,5063,8230
Indiana,Marion County,18,14914,4698,10216
Indiana,Marshall County,0,47107,23334,23773
Indiana,Marshall County,1,2983,1537,1446
Indiana,Marshall County,2,3298,1712,1586
Indiana,Marshall County,3,3512,1791,1721
Indiana,Marshall County,4,3332,1728,1604
Indiana,Marshall County,5,2952,1532,1420
Indiana,Marshall County,6,2513,1237,1276
Indiana,Marshall County,7,2611,1368,1243
Indiana,Marshall County,8,2750,1352,1398
Indiana,Marshall County,9,2841,1428,1413
Indiana,Marshall County,10,3073,1547,1526
Indiana,Marshall County,11,3353,1674,1679
Indiana,Marshall County,12,3339,1676,1663
Indiana,Marshall County,13,2955,1441,1514
Indiana,Marshall County,14,2363,1162,1201
Indiana,Marshall County,15,1786,836,950
Indiana,Marshall County,16,1302,565,737
Indiana,Marshall County,17,1005,406,599
Indiana,Marshall County,18,1139,342,797
Indiana,Martin County,0,10203,5160,5043
Indiana,Martin County,1,622,328,294
Indiana,Martin County,2,656,350,306
Indiana,Martin County,3,628,342,286
Indiana,Martin County,4,686,361,325
Indiana,Martin County,5,550,265,285
Indiana,Martin County,6,527,260,267
Indiana,Martin County,7,574,307,267
Indiana,Martin County,8,582,297,285
Indiana,Martin County,9,607,312,295
Indiana,Martin County,10,671,343,328
Indiana,Martin County,11,809,425,384
Indiana,Martin County,12,816,421,395
Indiana,Martin County,13,731,350,381
Indiana,Martin County,14,574,278,296
Indiana,Martin County,15,443,204,239
Indiana,Martin County,16,338,149,189
Indiana,Martin County,17,212,96,116
Indiana,Martin County,18,177,72,105
Indiana,Miami County,0,35954,19320,16634
Indiana,Miami County,1,1819,922,897
Indiana,Miami County,2,2177,1128,1049
Indiana,Miami County,3,2334,1223,1111
Indiana,Miami County,4,2228,1146,1082
Indiana,Miami County,5,2306,1355,951
Indiana,Miami County,6,2246,1375,871
Indiana,Miami County,7,2236,1369,867
Indiana,Miami County,8,2426,1424,1002
Indiana,Miami County,9,2493,1436,1057
Indiana,Miami County,10,2463,1384,1079
Indiana,Miami County,11,2742,1478,1264
Indiana,Miami County,12,2505,1303,1202
Indiana,Miami County,13,2271,1163,1108
Indiana,Miami County,14,1953,974,979
Indiana,Miami County,15,1396,658,738
Indiana,Miami County,16,974,446,528
Indiana,Miami County,17,692,290,402
Indiana,Miami County,18,693,246,447
Indiana,Monroe County,0,143339,71385,71954
Indiana,Monroe County,1,6478,3362,3116
Indiana,Monroe County,2,6420,3386,3034
Indiana,Monroe County,3,6316,3216,3100
Indiana,Monroe County,4,15105,7532,7573
Indiana,Monroe County,5,28610,14380,14230
Indiana,Monroe County,6,11825,6366,5459
Indiana,Monroe County,7,9261,4777,4484
Indiana,Monroe County,8,7468,3843,3625
Indiana,Monroe County,9,6838,3467,3371
Indiana,Monroe County,10,6960,3396,3564
Indiana,Monroe County,11,7332,3635,3697
Indiana,Monroe County,12,7551,3610,3941
Indiana,Monroe County,13,6864,3299,3565
Indiana,Monroe County,14,5423,2557,2866
Indiana,Monroe County,15,3799,1784,2015
Indiana,Monroe County,16,2654,1129,1525
Indiana,Monroe County,17,2104,880,1224
Indiana,Monroe County,18,2331,766,1565
Indiana,Montgomery County,0,38146,19218,18928
Indiana,Montgomery County,1,2401,1230,1171
Indiana,Montgomery County,2,2433,1196,1237
Indiana,Montgomery County,3,2546,1295,1251
Indiana,Montgomery County,4,2583,1472,1111
Indiana,Montgomery County,5,2644,1545,1099
Indiana,Montgomery County,6,2096,1103,993
Indiana,Montgomery County,7,2090,1063,1027
Indiana,Montgomery County,8,2159,1098,1061
Indiana,Montgomery County,9,2396,1205,1191
Indiana,Montgomery County,10,2459,1220,1239
Indiana,Montgomery County,11,2911,1443,1468
Indiana,Montgomery County,12,2795,1420,1375
Indiana,Montgomery County,13,2287,1124,1163
Indiana,Montgomery County,14,1932,893,1039
Indiana,Montgomery County,15,1572,727,845
Indiana,Montgomery County,16,1189,548,641
Indiana,Montgomery County,17,802,345,457
Indiana,Montgomery County,18,851,291,560
Indiana,Morgan County,0,69693,34575,35118
Indiana,Morgan County,1,3907,2021,1886
Indiana,Morgan County,2,4485,2291,2194
Indiana,Morgan County,3,4963,2541,2422
Indiana,Morgan County,4,4666,2447,2219
Indiana,Morgan County,5,4134,2086,2048
Indiana,Morgan County,6,3710,1836,1874
Indiana,Morgan County,7,3888,1878,2010
Indiana,Morgan County,8,4012,2018,1994
Indiana,Morgan County,9,4681,2295,2386
Indiana,Morgan County,10,5105,2529,2576
Indiana,Morgan County,11,5705,2878,2827
Indiana,Morgan County,12,5383,2744,2639
Indiana,Morgan County,13,4549,2162,2387
Indiana,Morgan County,14,3755,1852,1903
Indiana,Morgan County,15,2687,1291,1396
Indiana,Morgan County,16,1823,831,992
Indiana,Morgan County,17,1224,516,708
Indiana,Morgan County,18,1016,359,657
Indiana,Newton County,0,14156,7224,6932
Indiana,Newton County,1,728,388,340
Indiana,Newton County,2,855,423,432
Indiana,Newton County,3,944,508,436
Indiana,Newton County,4,919,487,432
Indiana,Newton County,5,787,427,360
Indiana,Newton County,6,761,391,370
Indiana,Newton County,7,780,411,369
Indiana,Newton County,8,823,418,405
Indiana,Newton County,9,848,462,386
Indiana,Newton County,10,906,474,432
Indiana,Newton County,11,1164,588,576
Indiana,Newton County,12,1124,594,530
Indiana,Newton County,13,1009,510,499
Indiana,Newton County,14,753,369,384
Indiana,Newton County,15,709,352,357
Indiana,Newton County,16,429,198,231
Indiana,Newton County,17,293,135,158
Indiana,Newton County,18,324,89,235
Indiana,Noble County,0,47618,23782,23836
Indiana,Noble County,1,3053,1497,1556
Indiana,Noble County,2,3446,1766,1680
Indiana,Noble County,3,3486,1775,1711
Indiana,Noble County,4,3367,1731,1636
Indiana,Noble County,5,2873,1485,1388
Indiana,Noble County,6,2740,1402,1338
Indiana,Noble County,7,2759,1385,1374
Indiana,Noble County,8,2949,1493,1456
Indiana,Noble County,9,3071,1569,1502
Indiana,Noble County,10,3089,1595,1494
Indiana,Noble County,11,3518,1801,1717
Indiana,Noble County,12,3426,1778,1648
Indiana,Noble County,13,2911,1454,1457
Indiana,Noble County,14,2434,1197,1237
Indiana,Noble County,15,1661,739,922
Indiana,Noble County,16,1093,514,579
Indiana,Noble County,17,784,297,487
Indiana,Noble County,18,958,304,654
Indiana,Ohio County,0,6035,3007,3028
Indiana,Ohio County,1,286,169,117
Indiana,Ohio County,2,309,151,158
Indiana,Ohio County,3,382,187,195
Indiana,Ohio County,4,333,162,171
Indiana,Ohio County,5,296,150,146
Indiana,Ohio County,6,337,171,166
Indiana,Ohio County,7,301,157,144
Indiana,Ohio County,8,323,153,170
Indiana,Ohio County,9,364,190,174
Indiana,Ohio County,10,410,219,191
Indiana,Ohio County,11,563,282,281
Indiana,Ohio County,12,495,250,245
Indiana,Ohio County,13,451,234,217
Indiana,Ohio County,14,372,177,195
Indiana,Ohio County,15,348,156,192
Indiana,Ohio County,16,210,102,108
Indiana,Ohio County,17,129,55,74
Indiana,Ohio County,18,126,42,84
Indiana,Orange County,0,19626,9764,9862
Indiana,Orange County,1,1084,570,514
Indiana,Orange County,2,1262,676,586
Indiana,Orange County,3,1394,725,669
Indiana,Orange County,4,1352,679,673
Indiana,Orange County,5,1112,570,542
Indiana,Orange County,6,1031,518,513
Indiana,Orange County,7,1069,559,510
Indiana,Orange County,8,1122,537,585
Indiana,Orange County,9,1229,616,613
Indiana,Orange County,10,1305,667,638
Indiana,Orange County,11,1449,706,743
Indiana,Orange County,12,1523,772,751
Indiana,Orange County,13,1257,614,643
Indiana,Orange County,14,1192,557,635
Indiana,Orange County,15,835,390,445
Indiana,Orange County,16,615,302,313
Indiana,Orange County,17,432,178,254
Indiana,Orange County,18,363,128,235
Indiana,Owen County,0,20969,10551,10418
Indiana,Owen County,1,984,529,455
Indiana,Owen County,2,1269,645,624
Indiana,Owen County,3,1435,731,704
Indiana,Owen County,4,1332,683,649
Indiana,Owen County,5,1145,580,565
Indiana,Owen County,6,1079,546,533
Indiana,Owen County,7,1067,559,508
Indiana,Owen County,8,1152,568,584
Indiana,Owen County,9,1271,651,620
Indiana,Owen County,10,1469,731,738
Indiana,Owen County,11,1807,923,884
Indiana,Owen County,12,1772,910,862
Indiana,Owen County,13,1555,755,800
Indiana,Owen County,14,1329,680,649
Indiana,Owen County,15,974,488,486
Indiana,Owen County,16,626,280,346
Indiana,Owen County,17,412,180,232
Indiana,Owen County,18,291,112,179
Indiana,Parke County,0,17233,8087,9146
Indiana,Parke County,1,1042,546,496
Indiana,Parke County,2,1003,524,479
Indiana,Parke County,3,1016,516,500
Indiana,Parke County,4,1005,529,476
Indiana,Parke County,5,1083,475,608
Indiana,Parke County,6,1120,455,665
Indiana,Parke County,7,1078,446,632
Indiana,Parke County,8,955,386,569
Indiana,Parke County,9,1101,483,618
Indiana,Parke County,10,1140,518,622
Indiana,Parke County,11,1343,630,713
Indiana,Parke County,12,1253,616,637
Indiana,Parke County,13,1139,548,591
Indiana,Parke County,14,1015,504,511
Indiana,Parke County,15,783,385,398
Indiana,Parke County,16,519,275,244
Indiana,Parke County,17,331,142,189
Indiana,Parke County,18,307,109,198
Indiana,Perry County,0,19454,10461,8993
Indiana,Perry County,1,1062,560,502
Indiana,Perry County,2,1193,600,593
Indiana,Perry County,3,1146,575,571
Indiana,Perry County,4,1045,566,479
Indiana,Perry County,5,1263,800,463
Indiana,Perry County,6,1274,792,482
Indiana,Perry County,7,1309,774,535
Indiana,Perry County,8,1232,737,495
Indiana,Perry County,9,1230,698,532
Indiana,Perry County,10,1247,708,539
Indiana,Perry County,11,1499,787,712
Indiana,Perry County,12,1429,740,689
Indiana,Perry County,13,1289,665,624
Indiana,Perry County,14,1079,528,551
Indiana,Perry County,15,716,343,373
Indiana,Perry County,16,523,251,272
Indiana,Perry County,17,455,180,275
Indiana,Perry County,18,463,157,306
Indiana,Pike County,0,12624,6367,6257
Indiana,Pike County,1,687,359,328
Indiana,Pike County,2,781,405,376
Indiana,Pike County,3,791,394,397
Indiana,Pike County,4,741,381,360
Indiana,Pike County,5,661,341,320
Indiana,Pike County,6,644,340,304
Indiana,Pike County,7,698,355,343
Indiana,Pike County,8,693,350,343
Indiana,Pike County,9,801,418,383
Indiana,Pike County,10,816,433,383
Indiana,Pike County,11,1019,506,513
Indiana,Pike County,12,1030,525,505
Indiana,Pike County,13,867,443,424
Indiana,Pike County,14,780,389,391
Indiana,Pike County,15,560,270,290
Indiana,Pike County,16,453,215,238
Indiana,Pike County,17,303,140,163
Indiana,Pike County,18,299,103,196
Indiana,Porter County,0,167076,82024,85052
Indiana,Porter County,1,9179,4567,4612
Indiana,Porter County,2,10262,5237,5025
Indiana,Porter County,3,11607,5947,5660
Indiana,Porter County,4,11591,5930,5661
Indiana,Porter County,5,10949,5522,5427
Indiana,Porter County,6,10067,5079,4988
Indiana,Porter County,7,10684,5345,5339
Indiana,Porter County,8,10631,5240,5391
Indiana,Porter County,9,11258,5565,5693
Indiana,Porter County,10,11003,5404,5599
Indiana,Porter County,11,12190,5872,6318
Indiana,Porter County,12,12705,6180,6525
Indiana,Porter County,13,10959,5433,5526
Indiana,Porter County,14,8415,4096,4319
Indiana,Porter County,15,5790,2761,3029
Indiana,Porter County,16,3971,1719,2252
Indiana,Porter County,17,2810,1168,1642
Indiana,Porter County,18,3005,959,2046
Indiana,Posey County,0,25540,12699,12841
Indiana,Posey County,1,1491,733,758
Indiana,Posey County,2,1536,812,724
Indiana,Posey County,3,1699,886,813
Indiana,Posey County,4,1681,854,827
Indiana,Posey County,5,1463,792,671
Indiana,Posey County,6,1409,697,712
Indiana,Posey County,7,1367,687,680
Indiana,Posey County,8,1432,725,707
Indiana,Posey County,9,1582,763,819
Indiana,Posey County,10,1638,809,829
Indiana,Posey County,11,2084,1056,1028
Indiana,Posey County,12,2194,1128,1066
Indiana,Posey County,13,1836,929,907
Indiana,Posey County,14,1390,668,722
Indiana,Posey County,15,987,474,513
Indiana,Posey County,16,734,338,396
Indiana,Posey County,17,500,190,310
Indiana,Posey County,18,517,158,359
Indiana,Pulaski County,0,12967,6570,6397
Indiana,Pulaski County,1,706,361,345
Indiana,Pulaski County,2,811,426,385
Indiana,Pulaski County,3,875,449,426
Indiana,Pulaski County,4,848,455,393
Indiana,Pulaski County,5,737,385,352
Indiana,Pulaski County,6,654,343,311
Indiana,Pulaski County,7,730,371,359
Indiana,Pulaski County,8,719,375,344
Indiana,Pulaski County,9,812,414,398
Indiana,Pulaski County,10,877,429,448
Indiana,Pulaski County,11,1001,530,471
Indiana,Pulaski County,12,1006,518,488
Indiana,Pulaski County,13,878,439,439
Indiana,Pulaski County,14,681,339,342
Indiana,Pulaski County,15,621,318,303
Indiana,Pulaski County,16,402,179,223
Indiana,Pulaski County,17,313,130,183
Indiana,Pulaski County,18,296,109,187
Indiana,Putnam County,0,37618,19932,17686
Indiana,Putnam County,1,1751,922,829
Indiana,Putnam County,2,1991,1018,973
Indiana,Putnam County,3,2221,1169,1052
Indiana,Putnam County,4,3116,1561,1555
Indiana,Putnam County,5,3660,1998,1662
Indiana,Putnam County,6,2278,1413,865
Indiana,Putnam County,7,2199,1320,879
Indiana,Putnam County,8,2141,1250,891
Indiana,Putnam County,9,2337,1277,1060
Indiana,Putnam County,10,2544,1416,1128
Indiana,Putnam County,11,2850,1542,1308
Indiana,Putnam County,12,2631,1349,1282
Indiana,Putnam County,13,2196,1141,1055
Indiana,Putnam County,14,1811,863,948
Indiana,Putnam County,15,1363,628,735
Indiana,Putnam County,16,1101,493,608
Indiana,Putnam County,17,764,329,435
Indiana,Putnam County,18,664,243,421
Indiana,Randolph County,0,25384,12496,12888
Indiana,Randolph County,1,1494,733,761
Indiana,Randolph County,2,1580,803,777
Indiana,Randolph County,3,1751,893,858
Indiana,Randolph County,4,1726,899,827
Indiana,Randolph County,5,1398,708,690
Indiana,Randolph County,6,1260,642,618
Indiana,Randolph County,7,1325,642,683
Indiana,Randolph County,8,1509,731,778
Indiana,Randolph County,9,1599,829,770
Indiana,Randolph County,10,1596,811,785
Indiana,Randolph County,11,1925,968,957
Indiana,Randolph County,12,1837,924,913
Indiana,Randolph County,13,1672,812,860
Indiana,Randolph County,14,1402,677,725
Indiana,Randolph County,15,1172,546,626
Indiana,Randolph County,16,849,398,451
Indiana,Randolph County,17,591,241,350
Indiana,Randolph County,18,698,239,459
Indiana,Ripley County,0,28497,14057,14440
Indiana,Ripley County,1,1720,861,859
Indiana,Ripley County,2,1841,945,896
Indiana,Ripley County,3,2046,1075,971
Indiana,Ripley County,4,2027,1026,1001
Indiana,Ripley County,5,1668,849,819
Indiana,Ripley County,6,1415,682,733
Indiana,Ripley County,7,1607,803,804
Indiana,Ripley County,8,1638,832,806
Indiana,Ripley County,9,1829,875,954
Indiana,Ripley County,10,1926,974,952
Indiana,Ripley County,11,2140,1052,1088
Indiana,Ripley County,12,2000,1014,986
Indiana,Ripley County,13,1811,898,913
Indiana,Ripley County,14,1539,737,802
Indiana,Ripley County,15,1168,564,604
Indiana,Ripley County,16,806,369,437
Indiana,Ripley County,17,651,277,374
Indiana,Ripley County,18,665,224,441
Indiana,Rush County,0,16892,8340,8552
Indiana,Rush County,1,944,501,443
Indiana,Rush County,2,1076,530,546
Indiana,Rush County,3,1179,610,569
Indiana,Rush County,4,1130,593,537
Indiana,Rush County,5,991,490,501
Indiana,Rush County,6,883,434,449
Indiana,Rush County,7,892,441,451
Indiana,Rush County,8,944,479,465
Indiana,Rush County,9,1075,546,529
Indiana,Rush County,10,1162,593,569
Indiana,Rush County,11,1307,657,650
Indiana,Rush County,12,1297,645,652
Indiana,Rush County,13,1072,525,547
Indiana,Rush County,14,908,444,464
Indiana,Rush County,15,704,315,389
Indiana,Rush County,16,543,240,303
Indiana,Rush County,17,394,167,227
Indiana,Rush County,18,391,130,261
Indiana,Scott County,0,23712,11656,12056
Indiana,Scott County,1,1404,675,729
Indiana,Scott County,2,1470,703,767
Indiana,Scott County,3,1527,788,739
Indiana,Scott County,4,1552,806,746
Indiana,Scott County,5,1401,705,696
Indiana,Scott County,6,1368,696,672
Indiana,Scott County,7,1386,702,684
Indiana,Scott County,8,1431,690,741
Indiana,Scott County,9,1648,830,818
Indiana,Scott County,10,1715,867,848
Indiana,Scott County,11,1837,917,920
Indiana,Scott County,12,1702,826,876
Indiana,Scott County,13,1530,768,762
Indiana,Scott County,14,1323,626,697
Indiana,Scott County,15,983,458,525
Indiana,Scott County,16,671,302,369
Indiana,Scott County,17,394,165,229
Indiana,Scott County,18,370,132,238
Indiana,Shelby County,0,44579,22014,22565
Indiana,Shelby County,1,2598,1325,1273
Indiana,Shelby County,2,2870,1509,1361
Indiana,Shelby County,3,2997,1491,1506
Indiana,Shelby County,4,2797,1463,1334
Indiana,Shelby County,5,2715,1379,1336
Indiana,Shelby County,6,2567,1312,1255
Indiana,Shelby County,7,2551,1260,1291
Indiana,Shelby County,8,2667,1306,1361
Indiana,Shelby County,9,2876,1473,1403
Indiana,Shelby County,10,3117,1481,1636
Indiana,Shelby County,11,3598,1832,1766
Indiana,Shelby County,12,3468,1751,1717
Indiana,Shelby County,13,2823,1411,1412
Indiana,Shelby County,14,2242,1091,1151
Indiana,Shelby County,15,1669,775,894
Indiana,Shelby County,16,1236,539,697
Indiana,Shelby County,17,857,322,535
Indiana,Shelby County,18,931,294,637
Indiana,Spencer County,0,20801,10539,10262
Indiana,Spencer County,1,1134,623,511
Indiana,Spencer County,2,1305,675,630
Indiana,Spencer County,3,1374,713,661
Indiana,Spencer County,4,1351,693,658
Indiana,Spencer County,5,1102,574,528
Indiana,Spencer County,6,978,512,466
Indiana,Spencer County,7,1162,617,545
Indiana,Spencer County,8,1195,591,604
Indiana,Spencer County,9,1268,618,650
Indiana,Spencer County,10,1406,729,677
Indiana,Spencer County,11,1720,883,837
Indiana,Spencer County,12,1658,839,819
Indiana,Spencer County,13,1399,719,680
Indiana,Spencer County,14,1291,645,646
Indiana,Spencer County,15,930,453,477
Indiana,Spencer County,16,646,312,334
Indiana,Spencer County,17,462,191,271
Indiana,Spencer County,18,420,152,268
Indiana,Starke County,0,23074,11452,11622
Indiana,Starke County,1,1327,710,617
Indiana,Starke County,2,1489,737,752
Indiana,Starke County,3,1595,771,824
Indiana,Starke County,4,1465,772,693
Indiana,Starke County,5,1375,694,681
Indiana,Starke County,6,1263,617,646
Indiana,Starke County,7,1296,633,663
Indiana,Starke County,8,1293,654,639
Indiana,Starke County,9,1463,735,728
Indiana,Starke County,10,1469,723,746
Indiana,Starke County,11,1740,864,876
Indiana,Starke County,12,1854,933,921
Indiana,Starke County,13,1574,791,783
Indiana,Starke County,14,1278,609,669
Indiana,Starke County,15,1025,477,548
Indiana,Starke County,16,776,379,397
Indiana,Starke County,17,452,216,236
Indiana,Starke County,18,340,137,203
Indiana,Steuben County,0,34308,17395,16913
Indiana,Steuben County,1,1689,868,821
Indiana,Steuben County,2,1978,999,979
Indiana,Steuben County,3,2222,1105,1117
Indiana,Steuben County,4,2564,1413,1151
Indiana,Steuben County,5,2512,1398,1114
Indiana,Steuben County,6,1815,943,872
Indiana,Steuben County,7,1767,916,851
Indiana,Steuben County,8,1793,896,897
Indiana,Steuben County,9,2093,1060,1033
Indiana,Steuben County,10,2330,1193,1137
Indiana,Steuben County,11,2534,1278,1256
Indiana,Steuben County,12,2600,1315,1285
Indiana,Steuben County,13,2500,1251,1249
Indiana,Steuben County,14,2032,998,1034
Indiana,Steuben County,15,1507,743,764
Indiana,Steuben County,16,1044,520,524
Indiana,Steuben County,17,708,318,390
Indiana,Steuben County,18,620,181,439
Indiana,Sullivan County,0,21050,11436,9614
Indiana,Sullivan County,1,1079,589,490
Indiana,Sullivan County,2,1126,587,539
Indiana,Sullivan County,3,1255,646,609
Indiana,Sullivan County,4,1261,737,524
Indiana,Sullivan County,5,1374,820,554
Indiana,Sullivan County,6,1438,892,546
Indiana,Sullivan County,7,1427,888,539
Indiana,Sullivan County,8,1399,798,601
Indiana,Sullivan County,9,1479,870,609
Indiana,Sullivan County,10,1457,841,616
Indiana,Sullivan County,11,1539,815,724
Indiana,Sullivan County,12,1475,760,715
Indiana,Sullivan County,13,1308,662,646
Indiana,Sullivan County,14,1161,575,586
Indiana,Sullivan County,15,839,399,440
Indiana,Sullivan County,16,595,263,332
Indiana,Sullivan County,17,404,159,245
Indiana,Sullivan County,18,434,135,299
Indiana,Switzerland County,0,10452,5338,5114
Indiana,Switzerland County,1,641,351,290
Indiana,Switzerland County,2,760,396,364
Indiana,Switzerland County,3,755,378,377
Indiana,Switzerland County,4,642,362,280
Indiana,Switzerland County,5,596,306,290
Indiana,Switzerland County,6,490,248,242
Indiana,Switzerland County,7,655,322,333
Indiana,Switzerland County,8,611,317,294
Indiana,Switzerland County,9,648,334,314
Indiana,Switzerland County,10,768,400,368
Indiana,Switzerland County,11,814,415,399
Indiana,Switzerland County,12,746,382,364
Indiana,Switzerland County,13,618,323,295
Indiana,Switzerland County,14,591,296,295
Indiana,Switzerland County,15,447,220,227
Indiana,Switzerland County,16,336,170,166
Indiana,Switzerland County,17,176,72,104
Indiana,Switzerland County,18,158,46,112
Indiana,Tippecanoe County,0,183074,93636,89438
Indiana,Tippecanoe County,1,11347,5805,5542
Indiana,Tippecanoe County,2,10874,5566,5308
Indiana,Tippecanoe County,3,10028,5107,4921
Indiana,Tippecanoe County,4,16612,8800,7812
Indiana,Tippecanoe County,5,33194,18664,14530
Indiana,Tippecanoe County,6,14586,7713,6873
Indiana,Tippecanoe County,7,11516,6055,5461
Indiana,Tippecanoe County,8,9864,5046,4818
Indiana,Tippecanoe County,9,9540,4782,4758
Indiana,Tippecanoe County,10,9124,4589,4535
Indiana,Tippecanoe County,11,9692,4773,4919
Indiana,Tippecanoe County,12,9427,4557,4870
Indiana,Tippecanoe County,13,8341,3941,4400
Indiana,Tippecanoe County,14,6304,2963,3341
Indiana,Tippecanoe County,15,4379,2008,2371
Indiana,Tippecanoe County,16,3173,1396,1777
Indiana,Tippecanoe County,17,2283,932,1351
Indiana,Tippecanoe County,18,2790,939,1851
Indiana,Tipton County,0,15415,7687,7728
Indiana,Tipton County,1,666,364,302
Indiana,Tipton County,2,894,469,425
Indiana,Tipton County,3,1029,523,506
Indiana,Tipton County,4,1062,580,482
Indiana,Tipton County,5,887,467,420
Indiana,Tipton County,6,757,400,357
Indiana,Tipton County,7,762,386,376
Indiana,Tipton County,8,810,402,408
Indiana,Tipton County,9,1018,493,525
Indiana,Tipton County,10,1085,548,537
Indiana,Tipton County,11,1213,584,629
Indiana,Tipton County,12,1213,629,584
Indiana,Tipton County,13,1043,520,523
Indiana,Tipton County,14,949,469,480
Indiana,Tipton County,15,755,347,408
Indiana,Tipton County,16,519,244,275
Indiana,Tipton County,17,330,139,191
Indiana,Tipton County,18,423,123,300
Indiana,Union County,0,7246,3571,3675
Indiana,Union County,1,329,177,152
Indiana,Union County,2,424,221,203
Indiana,Union County,3,529,276,253
Indiana,Union County,4,528,282,246
Indiana,Union County,5,448,242,206
Indiana,Union County,6,344,153,191
Indiana,Union County,7,380,184,196
Indiana,Union County,8,412,202,210
Indiana,Union County,9,467,221,246
Indiana,Union County,10,537,269,268
Indiana,Union County,11,595,296,299
Indiana,Union County,12,536,274,262
Indiana,Union County,13,493,233,260
Indiana,Union County,14,439,209,230
Indiana,Union County,15,304,144,160
Indiana,Union County,16,198,82,116
Indiana,Union County,17,133,54,79
Indiana,Union County,18,150,52,98
Indiana,Vanderburgh County,0,182006,88017,93989
Indiana,Vanderburgh County,1,11597,5914,5683
Indiana,Vanderburgh County,2,11332,5704,5628
Indiana,Vanderburgh County,3,10845,5634,5211
Indiana,Vanderburgh County,4,11499,5619,5880
Indiana,Vanderburgh County,5,13882,6613,7269
Indiana,Vanderburgh County,6,13750,6756,6994
Indiana,Vanderburgh County,7,12432,6199,6233
Indiana,Vanderburgh County,8,10354,5209,5145
Indiana,Vanderburgh County,9,10217,5118,5099
Indiana,Vanderburgh County,10,10732,5282,5450
Indiana,Vanderburgh County,11,13070,6376,6694
Indiana,Vanderburgh County,12,13290,6518,6772
Indiana,Vanderburgh County,13,11351,5484,5867
Indiana,Vanderburgh County,14,8570,3977,4593
Indiana,Vanderburgh County,15,6095,2743,3352
Indiana,Vanderburgh County,16,4875,2049,2826
Indiana,Vanderburgh County,17,3804,1430,2374
Indiana,Vanderburgh County,18,4311,1392,2919
Indiana,Vermillion County,0,15693,7745,7948
Indiana,Vermillion County,1,837,429,408
Indiana,Vermillion County,2,922,515,407
Indiana,Vermillion County,3,1077,575,502
Indiana,Vermillion County,4,974,523,451
Indiana,Vermillion County,5,835,432,403
Indiana,Vermillion County,6,817,411,406
Indiana,Vermillion County,7,868,419,449
Indiana,Vermillion County,8,885,435,450
Indiana,Vermillion County,9,1060,515,545
Indiana,Vermillion County,10,1006,520,486
Indiana,Vermillion County,11,1151,561,590
Indiana,Vermillion County,12,1171,567,604
Indiana,Vermillion County,13,1172,568,604
Indiana,Vermillion County,14,972,469,503
Indiana,Vermillion County,15,711,360,351
Indiana,Vermillion County,16,493,203,290
Indiana,Vermillion County,17,355,139,216
Indiana,Vermillion County,18,387,104,283
Indiana,Vigo County,0,108175,54848,53327
Indiana,Vigo County,1,6340,3278,3062
Indiana,Vigo County,2,6142,3113,3029
Indiana,Vigo County,3,6190,3234,2956
Indiana,Vigo County,4,8069,4159,3910
Indiana,Vigo County,5,12555,6544,6011
Indiana,Vigo County,6,6668,3684,2984
Indiana,Vigo County,7,6976,3847,3129
Indiana,Vigo County,8,6319,3450,2869
Indiana,Vigo County,9,6384,3412,2972
Indiana,Vigo County,10,6481,3428,3053
Indiana,Vigo County,11,6891,3518,3373
Indiana,Vigo County,12,7084,3525,3559
Indiana,Vigo County,13,6338,3102,3236
Indiana,Vigo County,14,5123,2399,2724
Indiana,Vigo County,15,3750,1675,2075
Indiana,Vigo County,16,2605,1073,1532
Indiana,Vigo County,17,1949,721,1228
Indiana,Vigo County,18,2311,686,1625
Indiana,Wabash County,0,32252,15686,16566
Indiana,Wabash County,1,1678,817,861
Indiana,Wabash County,2,1935,999,936
Indiana,Wabash County,3,2042,1026,1016
Indiana,Wabash County,4,2436,1280,1156
Indiana,Wabash County,5,2207,1149,1058
Indiana,Wabash County,6,1671,808,863
Indiana,Wabash County,7,1686,836,850
Indiana,Wabash County,8,1718,844,874
Indiana,Wabash County,9,1914,965,949
Indiana,Wabash County,10,1977,967,1010
Indiana,Wabash County,11,2276,1116,1160
Indiana,Wabash County,12,2374,1191,1183
Indiana,Wabash County,13,2074,992,1082
Indiana,Wabash County,14,1760,850,910
Indiana,Wabash County,15,1440,684,756
Indiana,Wabash County,16,1106,479,627
Indiana,Wabash County,17,925,347,578
Indiana,Wabash County,18,1033,336,697
Indiana,Warren County,0,8352,4154,4198
Indiana,Warren County,1,480,238,242
Indiana,Warren County,2,491,255,236
Indiana,Warren County,3,564,287,277
Indiana,Warren County,4,508,278,230
Indiana,Warren County,5,467,229,238
Indiana,Warren County,6,415,210,205
Indiana,Warren County,7,416,201,215
Indiana,Warren County,8,429,207,222
Indiana,Warren County,9,526,273,253
Indiana,Warren County,10,599,295,304
Indiana,Warren County,11,680,368,312
Indiana,Warren County,12,645,327,318
Indiana,Warren County,13,573,286,287
Indiana,Warren County,14,466,228,238
Indiana,Warren County,15,397,168,229
Indiana,Warren County,16,308,153,155
Indiana,Warren County,17,181,81,100
Indiana,Warren County,18,207,70,137
Indiana,Warrick County,0,61149,30202,30947
Indiana,Warrick County,1,3476,1811,1665
Indiana,Warrick County,2,4196,2138,2058
Indiana,Warrick County,3,4639,2398,2241
Indiana,Warrick County,4,4134,2211,1923
Indiana,Warrick County,5,3248,1658,1590
Indiana,Warrick County,6,2875,1376,1499
Indiana,Warrick County,7,3575,1768,1807
Indiana,Warrick County,8,3767,1851,1916
Indiana,Warrick County,9,4261,2160,2101
Indiana,Warrick County,10,4080,2008,2072
Indiana,Warrick County,11,4652,2289,2363
Indiana,Warrick County,12,4508,2189,2319
Indiana,Warrick County,13,3881,1883,1998
Indiana,Warrick County,14,3519,1694,1825
Indiana,Warrick County,15,2424,1191,1233
Indiana,Warrick County,16,1573,755,818
Indiana,Warrick County,17,1084,420,664
Indiana,Warrick County,18,1257,402,855
Indiana,Washington County,0,27878,13898,13980
Indiana,Washington County,1,1589,808,781
Indiana,Washington County,2,1739,883,856
Indiana,Washington County,3,2026,1047,979
Indiana,Washington County,4,1897,990,907
Indiana,Washington County,5,1603,826,777
Indiana,Washington County,6,1523,768,755
Indiana,Washington County,7,1605,804,801
Indiana,Washington County,8,1712,873,839
Indiana,Washington County,9,1831,946,885
Indiana,Washington County,10,1991,1000,991
Indiana,Washington County,11,2194,1081,1113
Indiana,Washington County,12,2113,1030,1083
Indiana,Washington County,13,1751,884,867
Indiana,Washington County,14,1481,677,804
Indiana,Washington County,15,1115,551,564
Indiana,Washington County,16,737,350,387
Indiana,Washington County,17,506,211,295
Indiana,Washington County,18,465,169,296
Indiana,Wayne County,0,67671,32809,34862
Indiana,Wayne County,1,4190,2098,2092
Indiana,Wayne County,2,4242,2161,2081
Indiana,Wayne County,3,4163,2112,2051
Indiana,Wayne County,4,4292,2275,2017
Indiana,Wayne County,5,4391,2208,2183
Indiana,Wayne County,6,3848,1894,1954
Indiana,Wayne County,7,3884,1900,1984
Indiana,Wayne County,8,3842,1987,1855
Indiana,Wayne County,9,4201,2075,2126
Indiana,Wayne County,10,4359,2121,2238
Indiana,Wayne County,11,4929,2394,2535
Indiana,Wayne County,12,4858,2401,2457
Indiana,Wayne County,13,4378,2072,2306
Indiana,Wayne County,14,3711,1709,2002
Indiana,Wayne County,15,2882,1288,1594
Indiana,Wayne County,16,2152,927,1225
Indiana,Wayne County,17,1542,614,928
Indiana,Wayne County,18,1807,573,1234
Indiana,Wells County,0,27862,13741,14121
Indiana,Wells County,1,1798,901,897
Indiana,Wells County,2,1900,943,957
Indiana,Wells County,3,1854,960,894
Indiana,Wells County,4,1781,941,840
Indiana,Wells County,5,1651,854,797
Indiana,Wells County,6,1511,773,738
Indiana,Wells County,7,1678,827,851
Indiana,Wells County,8,1522,781,741
Indiana,Wells County,9,1600,793,807
Indiana,Wells County,10,1716,853,863
Indiana,Wells County,11,2123,1054,1069
Indiana,Wells County,12,2180,1111,1069
Indiana,Wells County,13,1807,877,930
Indiana,Wells County,14,1428,708,720
Indiana,Wells County,15,1117,516,601
Indiana,Wells County,16,821,355,466
Indiana,Wells County,17,639,263,376
Indiana,Wells County,18,736,231,505
Indiana,White County,0,24453,12142,12311
Indiana,White County,1,1514,795,719
Indiana,White County,2,1512,778,734
Indiana,White County,3,1681,853,828
Indiana,White County,4,1598,857,741
Indiana,White County,5,1362,728,634
Indiana,White County,6,1210,584,626
Indiana,White County,7,1234,637,597
Indiana,White County,8,1361,683,678
Indiana,White County,9,1513,814,699
Indiana,White County,10,1494,717,777
Indiana,White County,11,1806,902,904
Indiana,White County,12,1865,899,966
Indiana,White County,13,1710,827,883
Indiana,White County,14,1525,752,773
Indiana,White County,15,1000,469,531
Indiana,White County,16,805,372,433
Indiana,White County,17,619,265,354
Indiana,White County,18,644,210,434
Indiana,Whitley County,0,33403,16659,16744
Indiana,Whitley County,1,1945,986,959
Indiana,Whitley County,2,2159,1129,1030
Indiana,Whitley County,3,2296,1198,1098
Indiana,Whitley County,4,2164,1107,1057
Indiana,Whitley County,5,1897,982,915
Indiana,Whitley County,6,1889,979,910
Indiana,Whitley County,7,1881,944,937
Indiana,Whitley County,8,2027,1068,959
Indiana,Whitley County,9,2115,1092,1023
Indiana,Whitley County,10,2169,1066,1103
Indiana,Whitley County,11,2575,1279,1296
Indiana,Whitley County,12,2683,1364,1319
Indiana,Whitley County,13,2245,1098,1147
Indiana,Whitley County,14,1848,922,926
Indiana,Whitley County,15,1198,539,659
Indiana,Whitley County,16,874,396,478
Indiana,Whitley County,17,689,274,415
Indiana,Whitley County,18,749,236,513
Iowa,Adair County,0,7454,3659,3795
Iowa,Adair County,1,358,195,163
Iowa,Adair County,2,489,244,245
Iowa,Adair County,3,499,241,258
Iowa,Adair County,4,446,216,230
Iowa,Adair County,5,368,210,158
Iowa,Adair County,6,369,195,174
Iowa,Adair County,7,379,184,195
Iowa,Adair County,8,397,186,211
Iowa,Adair County,9,377,197,180
Iowa,Adair County,10,447,226,221
Iowa,Adair County,11,602,300,302
Iowa,Adair County,12,580,308,272
Iowa,Adair County,13,495,261,234
Iowa,Adair County,14,419,209,210
Iowa,Adair County,15,317,134,183
Iowa,Adair County,16,308,138,170
Iowa,Adair County,17,252,97,155
Iowa,Adair County,18,352,118,234
Iowa,Adams County,0,3875,1940,1935
Iowa,Adams County,1,250,146,104
Iowa,Adams County,2,227,109,118
Iowa,Adams County,3,214,118,96
Iowa,Adams County,4,214,112,102
Iowa,Adams County,5,178,79,99
Iowa,Adams County,6,211,109,102
Iowa,Adams County,7,219,115,104
Iowa,Adams County,8,182,85,97
Iowa,Adams County,9,198,112,86
Iowa,Adams County,10,213,100,113
Iowa,Adams County,11,329,167,162
Iowa,Adams County,12,333,167,166
Iowa,Adams County,13,254,130,124
Iowa,Adams County,14,238,113,125
Iowa,Adams County,15,204,100,104
Iowa,Adams County,16,144,65,79
Iowa,Adams County,17,143,69,74
Iowa,Adams County,18,124,44,80
Iowa,Allamakee County,0,14038,7184,6854
Iowa,Allamakee County,1,861,448,413
Iowa,Allamakee County,2,919,504,415
Iowa,Allamakee County,3,854,425,429
Iowa,Allamakee County,4,797,432,365
Iowa,Allamakee County,5,736,385,351
Iowa,Allamakee County,6,691,378,313
Iowa,Allamakee County,7,722,386,336
Iowa,Allamakee County,8,697,342,355
Iowa,Allamakee County,9,696,374,322
Iowa,Allamakee County,10,847,438,409
Iowa,Allamakee County,11,1062,535,527
Iowa,Allamakee County,12,1084,557,527
Iowa,Allamakee County,13,1081,540,541
Iowa,Allamakee County,14,902,460,442
Iowa,Allamakee County,15,702,363,339
Iowa,Allamakee County,16,555,272,283
Iowa,Allamakee County,17,404,185,219
Iowa,Allamakee County,18,428,160,268
Iowa,Appanoose County,0,12661,6256,6405
Iowa,Appanoose County,1,761,396,365
Iowa,Appanoose County,2,827,426,401
Iowa,Appanoose County,3,789,401,388
Iowa,Appanoose County,4,705,377,328
Iowa,Appanoose County,5,680,338,342
Iowa,Appanoose County,6,637,306,331
Iowa,Appanoose County,7,710,343,367
Iowa,Appanoose County,8,615,317,298
Iowa,Appanoose County,9,690,335,355
Iowa,Appanoose County,10,722,369,353
Iowa,Appanoose County,11,935,461,474
Iowa,Appanoose County,12,987,516,471
Iowa,Appanoose County,13,892,456,436
Iowa,Appanoose County,14,825,388,437
Iowa,Appanoose County,15,625,315,310
Iowa,Appanoose County,16,470,212,258
Iowa,Appanoose County,17,373,154,219
Iowa,Appanoose County,18,418,146,272
Iowa,Audubon County,0,5794,2804,2990
Iowa,Audubon County,1,265,138,127
Iowa,Audubon County,2,334,165,169
Iowa,Audubon County,3,324,171,153
Iowa,Audubon County,4,367,179,188
Iowa,Audubon County,5,284,135,149
Iowa,Audubon County,6,233,111,122
Iowa,Audubon County,7,279,144,135
Iowa,Audubon County,8,271,148,123
Iowa,Audubon County,9,282,123,159
Iowa,Audubon County,10,355,182,173
Iowa,Audubon County,11,504,252,252
Iowa,Audubon County,12,497,252,245
Iowa,Audubon County,13,391,216,175
Iowa,Audubon County,14,345,163,182
Iowa,Audubon County,15,302,143,159
Iowa,Audubon County,16,269,124,145
Iowa,Audubon County,17,199,77,122
Iowa,Audubon County,18,293,81,212
Iowa,Benton County,0,25680,12764,12916
Iowa,Benton County,1,1453,731,722
Iowa,Benton County,2,1694,866,828
Iowa,Benton County,3,1851,906,945
Iowa,Benton County,4,1706,910,796
Iowa,Benton County,5,1378,704,674
Iowa,Benton County,6,1155,584,571
Iowa,Benton County,7,1444,725,719
Iowa,Benton County,8,1495,737,758
Iowa,Benton County,9,1576,779,797
Iowa,Benton County,10,1849,893,956
Iowa,Benton County,11,2158,1087,1071
Iowa,Benton County,12,2044,1081,963
Iowa,Benton County,13,1535,801,734
Iowa,Benton County,14,1283,624,659
Iowa,Benton County,15,1030,501,529
Iowa,Benton County,16,727,337,390
Iowa,Benton County,17,610,285,325
Iowa,Benton County,18,692,213,479
Iowa,Black Hawk County,0,132897,65001,67896
Iowa,Black Hawk County,1,8164,4188,3976
Iowa,Black Hawk County,2,8131,4167,3964
Iowa,Black Hawk County,3,7643,3835,3808
Iowa,Black Hawk County,4,9417,4413,5004
Iowa,Black Hawk County,5,16283,7957,8326
Iowa,Black Hawk County,6,8858,4644,4214
Iowa,Black Hawk County,7,8528,4328,4200
Iowa,Black Hawk County,8,7417,3740,3677
Iowa,Black Hawk County,9,6915,3482,3433
Iowa,Black Hawk County,10,7054,3572,3482
Iowa,Black Hawk County,11,8063,3950,4113
Iowa,Black Hawk County,12,8606,4099,4507
Iowa,Black Hawk County,13,8105,3968,4137
Iowa,Black Hawk County,14,6152,2967,3185
Iowa,Black Hawk County,15,4364,2061,2303
Iowa,Black Hawk County,16,3392,1458,1934
Iowa,Black Hawk County,17,2626,1101,1525
Iowa,Black Hawk County,18,3179,1071,2108
Iowa,Boone County,0,26433,13309,13124
Iowa,Boone County,1,1475,749,726
Iowa,Boone County,2,1611,856,755
Iowa,Boone County,3,1658,873,785
Iowa,Boone County,4,1834,1064,770
Iowa,Boone County,5,1455,728,727
Iowa,Boone County,6,1500,747,753
Iowa,Boone County,7,1709,903,806
Iowa,Boone County,8,1583,805,778
Iowa,Boone County,9,1525,767,758
Iowa,Boone County,10,1646,854,792
Iowa,Boone County,11,1981,958,1023
Iowa,Boone County,12,2084,1037,1047
Iowa,Boone County,13,1885,979,906
Iowa,Boone County,14,1348,664,684
Iowa,Boone County,15,998,464,534
Iowa,Boone County,16,796,384,412
Iowa,Boone County,17,624,264,360
Iowa,Boone County,18,721,213,508
Iowa,Bremer County,0,24721,12165,12556
Iowa,Bremer County,1,1268,707,561
Iowa,Bremer County,2,1596,804,792
Iowa,Bremer County,3,1558,805,753
Iowa,Bremer County,4,2040,958,1082
Iowa,Bremer County,5,1991,1016,975
Iowa,Bremer County,6,1269,645,624
Iowa,Bremer County,7,1442,726,716
Iowa,Bremer County,8,1404,714,690
Iowa,Bremer County,9,1377,686,691
Iowa,Bremer County,10,1458,738,720
Iowa,Bremer County,11,1650,815,835
Iowa,Bremer County,12,1599,792,807
Iowa,Bremer County,13,1520,761,759
Iowa,Bremer County,14,1329,649,680
Iowa,Bremer County,15,1073,504,569
Iowa,Bremer County,16,817,367,450
Iowa,Bremer County,17,584,257,327
Iowa,Bremer County,18,746,221,525
Iowa,Buchanan County,0,21038,10472,10566
Iowa,Buchanan County,1,1424,694,730
Iowa,Buchanan County,2,1608,806,802
Iowa,Buchanan County,3,1649,858,791
Iowa,Buchanan County,4,1359,725,634
Iowa,Buchanan County,5,1102,564,538
Iowa,Buchanan County,6,1157,574,583
Iowa,Buchanan County,7,1333,699,634
Iowa,Buchanan County,8,1186,607,579
Iowa,Buchanan County,9,1166,599,567
Iowa,Buchanan County,10,1298,627,671
Iowa,Buchanan County,11,1554,785,769
Iowa,Buchanan County,12,1518,739,779
Iowa,Buchanan County,13,1269,656,613
Iowa,Buchanan County,14,1048,513,535
Iowa,Buchanan County,15,794,383,411
Iowa,Buchanan County,16,642,299,343
Iowa,Buchanan County,17,406,167,239
Iowa,Buchanan County,18,525,177,348
Iowa,Buena Vista County,0,20578,10410,10168
Iowa,Buena Vista County,1,1499,727,772
Iowa,Buena Vista County,2,1487,764,723
Iowa,Buena Vista County,3,1403,731,672
Iowa,Buena Vista County,4,1539,790,749
Iowa,Buena Vista County,5,1847,998,849
Iowa,Buena Vista County,6,1261,689,572
Iowa,Buena Vista County,7,1227,652,575
Iowa,Buena Vista County,8,1061,556,505
Iowa,Buena Vista County,9,1068,549,519
Iowa,Buena Vista County,10,1165,579,586
Iowa,Buena Vista County,11,1354,676,678
Iowa,Buena Vista County,12,1433,753,680
Iowa,Buena Vista County,13,1223,642,581
Iowa,Buena Vista County,14,804,420,384
Iowa,Buena Vista County,15,583,276,307
Iowa,Buena Vista County,16,478,207,271
Iowa,Buena Vista County,17,483,191,292
Iowa,Buena Vista County,18,663,210,453
Iowa,Butler County,0,15006,7422,7584
Iowa,Butler County,1,916,448,468
Iowa,Butler County,2,1062,541,521
Iowa,Butler County,3,1000,530,470
Iowa,Butler County,4,865,454,411
Iowa,Butler County,5,696,350,346
Iowa,Butler County,6,660,318,342
Iowa,Butler County,7,912,452,460
Iowa,Butler County,8,814,432,382
Iowa,Butler County,9,817,415,402
Iowa,Butler County,10,922,441,481
Iowa,Butler County,11,988,498,490
Iowa,Butler County,12,1131,580,551
Iowa,Butler County,13,1065,541,524
Iowa,Butler County,14,904,450,454
Iowa,Butler County,15,702,338,364
Iowa,Butler County,16,540,240,300
Iowa,Butler County,17,443,182,261
Iowa,Butler County,18,569,212,357
Iowa,Calhoun County,0,9866,5067,4799
Iowa,Calhoun County,1,555,272,283
Iowa,Calhoun County,2,566,281,285
Iowa,Calhoun County,3,555,290,265
Iowa,Calhoun County,4,571,326,245
Iowa,Calhoun County,5,548,330,218
Iowa,Calhoun County,6,527,307,220
Iowa,Calhoun County,7,519,269,250
Iowa,Calhoun County,8,509,286,223
Iowa,Calhoun County,9,507,288,219
Iowa,Calhoun County,10,566,283,283
Iowa,Calhoun County,11,705,377,328
Iowa,Calhoun County,12,808,409,399
Iowa,Calhoun County,13,729,387,342
Iowa,Calhoun County,14,567,276,291
Iowa,Calhoun County,15,443,219,224
Iowa,Calhoun County,16,443,187,256
Iowa,Calhoun County,17,316,123,193
Iowa,Calhoun County,18,432,157,275
Iowa,Carroll County,0,20562,10002,10560
Iowa,Carroll County,1,1333,636,697
Iowa,Carroll County,2,1440,742,698
Iowa,Carroll County,3,1340,669,671
Iowa,Carroll County,4,1274,676,598
Iowa,Carroll County,5,1126,553,573
Iowa,Carroll County,6,1005,496,509
Iowa,Carroll County,7,1147,599,548
Iowa,Carroll County,8,1106,562,544
Iowa,Carroll County,9,1086,536,550
Iowa,Carroll County,10,1245,634,611
Iowa,Carroll County,11,1541,775,766
Iowa,Carroll County,12,1607,811,796
Iowa,Carroll County,13,1361,682,679
Iowa,Carroll County,14,964,466,498
Iowa,Carroll County,15,790,353,437
Iowa,Carroll County,16,726,325,401
Iowa,Carroll County,17,664,249,415
Iowa,Carroll County,18,807,238,569
Iowa,Cass County,0,13448,6636,6812
Iowa,Cass County,1,768,369,399
Iowa,Cass County,2,919,487,432
Iowa,Cass County,3,853,453,400
Iowa,Cass County,4,764,423,341
Iowa,Cass County,5,679,341,338
Iowa,Cass County,6,629,320,309
Iowa,Cass County,7,747,381,366
Iowa,Cass County,8,695,343,352
Iowa,Cass County,9,712,387,325
Iowa,Cass County,10,747,364,383
Iowa,Cass County,11,1042,506,536
Iowa,Cass County,12,1050,536,514
Iowa,Cass County,13,949,458,491
Iowa,Cass County,14,775,385,390
Iowa,Cass County,15,644,291,353
Iowa,Cass County,16,566,261,305
Iowa,Cass County,17,409,150,259
Iowa,Cass County,18,500,181,319
Iowa,Cedar County,0,18411,9119,9292
Iowa,Cedar County,1,948,478,470
Iowa,Cedar County,2,1220,603,617
Iowa,Cedar County,3,1282,631,651
Iowa,Cedar County,4,1176,613,563
Iowa,Cedar County,5,857,453,404
Iowa,Cedar County,6,866,447,419
Iowa,Cedar County,7,1082,541,541
Iowa,Cedar County,8,1086,571,515
Iowa,Cedar County,9,1095,559,536
Iowa,Cedar County,10,1245,615,630
Iowa,Cedar County,11,1489,715,774
Iowa,Cedar County,12,1429,732,697
Iowa,Cedar County,13,1248,650,598
Iowa,Cedar County,14,1004,516,488
Iowa,Cedar County,15,748,353,395
Iowa,Cedar County,16,565,245,320
Iowa,Cedar County,17,444,190,254
Iowa,Cedar County,18,627,207,420
Iowa,Cerro Gordo County,0,43254,21213,22041
Iowa,Cerro Gordo County,1,2402,1236,1166
Iowa,Cerro Gordo County,2,2452,1270,1182
Iowa,Cerro Gordo County,3,2453,1323,1130
Iowa,Cerro Gordo County,4,2591,1322,1269
Iowa,Cerro Gordo County,5,2625,1366,1259
Iowa,Cerro Gordo County,6,2289,1169,1120
Iowa,Cerro Gordo County,7,2542,1329,1213
Iowa,Cerro Gordo County,8,2293,1150,1143
Iowa,Cerro Gordo County,9,2308,1137,1171
Iowa,Cerro Gordo County,10,2608,1291,1317
Iowa,Cerro Gordo County,11,3407,1670,1737
Iowa,Cerro Gordo County,12,3503,1707,1796
Iowa,Cerro Gordo County,13,3243,1628,1615
Iowa,Cerro Gordo County,14,2494,1148,1346
Iowa,Cerro Gordo County,15,1822,837,985
Iowa,Cerro Gordo County,16,1527,670,857
Iowa,Cerro Gordo County,17,1204,475,729
Iowa,Cerro Gordo County,18,1491,485,1006
Iowa,Cherokee County,0,11836,5875,5961
Iowa,Cherokee County,1,710,354,356
Iowa,Cherokee County,2,698,342,356
Iowa,Cherokee County,3,676,331,345
Iowa,Cherokee County,4,639,329,310
Iowa,Cherokee County,5,594,306,288
Iowa,Cherokee County,6,597,314,283
Iowa,Cherokee County,7,617,326,291
Iowa,Cherokee County,8,585,301,284
Iowa,Cherokee County,9,584,294,290
Iowa,Cherokee County,10,655,342,313
Iowa,Cherokee County,11,952,500,452
Iowa,Cherokee County,12,974,491,483
Iowa,Cherokee County,13,909,485,424
Iowa,Cherokee County,14,674,344,330
Iowa,Cherokee County,15,534,255,279
Iowa,Cherokee County,16,458,194,264
Iowa,Cherokee County,17,431,176,255
Iowa,Cherokee County,18,549,191,358
Iowa,Chickasaw County,0,12264,6131,6133
Iowa,Chickasaw County,1,744,353,391
Iowa,Chickasaw County,2,844,433,411
Iowa,Chickasaw County,3,843,425,418
Iowa,Chickasaw County,4,763,416,347
Iowa,Chickasaw County,5,672,357,315
Iowa,Chickasaw County,6,523,265,258
Iowa,Chickasaw County,7,678,347,331
Iowa,Chickasaw County,8,595,296,299
Iowa,Chickasaw County,9,624,333,291
Iowa,Chickasaw County,10,754,376,378
Iowa,Chickasaw County,11,951,495,456
Iowa,Chickasaw County,12,1018,537,481
Iowa,Chickasaw County,13,870,437,433
Iowa,Chickasaw County,14,664,329,335
Iowa,Chickasaw County,15,556,253,303
Iowa,Chickasaw County,16,442,200,242
Iowa,Chickasaw County,17,307,136,171
Iowa,Chickasaw County,18,416,143,273
Iowa,Clarke County,0,9217,4630,4587
Iowa,Clarke County,1,597,310,287
Iowa,Clarke County,2,679,379,300
Iowa,Clarke County,3,617,313,304
Iowa,Clarke County,4,562,295,267
Iowa,Clarke County,5,517,271,246
Iowa,Clarke County,6,536,273,263
Iowa,Clarke County,7,527,289,238
Iowa,Clarke County,8,486,241,245
Iowa,Clarke County,9,512,239,273
Iowa,Clarke County,10,580,310,270
Iowa,Clarke County,11,670,328,342
Iowa,Clarke County,12,684,359,325
Iowa,Clarke County,13,627,304,323
Iowa,Clarke County,14,480,238,242
Iowa,Clarke County,15,397,189,208
Iowa,Clarke County,16,280,119,161
Iowa,Clarke County,17,194,88,106
Iowa,Clarke County,18,272,85,187
Iowa,Clay County,0,16515,8105,8410
Iowa,Clay County,1,940,485,455
Iowa,Clay County,2,1102,555,547
Iowa,Clay County,3,1072,519,553
Iowa,Clay County,4,988,513,475
Iowa,Clay County,5,910,489,421
Iowa,Clay County,6,855,439,416
Iowa,Clay County,7,983,500,483
Iowa,Clay County,8,1003,496,507
Iowa,Clay County,9,878,448,430
Iowa,Clay County,10,935,483,452
Iowa,Clay County,11,1202,584,618
Iowa,Clay County,12,1294,641,653
Iowa,Clay County,13,1123,565,558
Iowa,Clay County,14,879,434,445
Iowa,Clay County,15,694,315,379
Iowa,Clay County,16,548,249,299
Iowa,Clay County,17,466,191,275
Iowa,Clay County,18,643,199,444
Iowa,Clayton County,0,17692,8900,8792
Iowa,Clayton County,1,1003,501,502
Iowa,Clayton County,2,1097,572,525
Iowa,Clayton County,3,1113,564,549
Iowa,Clayton County,4,1073,578,495
Iowa,Clayton County,5,905,476,429
Iowa,Clayton County,6,765,382,383
Iowa,Clayton County,7,920,481,439
Iowa,Clayton County,8,848,435,413
Iowa,Clayton County,9,948,502,446
Iowa,Clayton County,10,1030,527,503
Iowa,Clayton County,11,1416,708,708
Iowa,Clayton County,12,1548,778,770
Iowa,Clayton County,13,1330,701,629
Iowa,Clayton County,14,1089,558,531
Iowa,Clayton County,15,804,398,406
Iowa,Clayton County,16,656,301,355
Iowa,Clayton County,17,541,240,301
Iowa,Clayton County,18,606,198,408
Iowa,Clinton County,0,48051,23572,24479
Iowa,Clinton County,1,2922,1511,1411
Iowa,Clinton County,2,2985,1554,1431
Iowa,Clinton County,3,3060,1568,1492
Iowa,Clinton County,4,3084,1552,1532
Iowa,Clinton County,5,2869,1436,1433
Iowa,Clinton County,6,2483,1235,1248
Iowa,Clinton County,7,2732,1343,1389
Iowa,Clinton County,8,2637,1318,1319
Iowa,Clinton County,9,2790,1384,1406
Iowa,Clinton County,10,3021,1512,1509
Iowa,Clinton County,11,3792,1892,1900
Iowa,Clinton County,12,3726,1831,1895
Iowa,Clinton County,13,3136,1583,1553
Iowa,Clinton County,14,2587,1233,1354
Iowa,Clinton County,15,2016,965,1051
Iowa,Clinton County,16,1651,749,902
Iowa,Clinton County,17,1180,471,709
Iowa,Clinton County,18,1380,435,945
Iowa,Crawford County,0,17228,8788,8440
Iowa,Crawford County,1,1236,624,612
Iowa,Crawford County,2,1211,592,619
Iowa,Crawford County,3,1200,636,564
Iowa,Crawford County,4,1274,678,596
Iowa,Crawford County,5,1044,576,468
Iowa,Crawford County,6,939,524,415
Iowa,Crawford County,7,992,549,443
Iowa,Crawford County,8,984,514,470
Iowa,Crawford County,9,1021,507,514
Iowa,Crawford County,10,985,483,502
Iowa,Crawford County,11,1224,647,577
Iowa,Crawford County,12,1206,636,570
Iowa,Crawford County,13,1008,527,481
Iowa,Crawford County,14,848,415,433
Iowa,Crawford County,15,668,340,328
Iowa,Crawford County,16,500,210,290
Iowa,Crawford County,17,347,148,199
Iowa,Crawford County,18,541,182,359
Iowa,Dallas County,0,77400,37927,39473
Iowa,Dallas County,1,6330,3112,3218
Iowa,Dallas County,2,6445,3265,3180
Iowa,Dallas County,3,6092,2999,3093
Iowa,Dallas County,4,4743,2469,2274
Iowa,Dallas County,5,3324,1634,1690
Iowa,Dallas County,6,5369,2560,2809
Iowa,Dallas County,7,6608,3255,3353
Iowa,Dallas County,8,6163,3177,2986
Iowa,Dallas County,9,5853,2890,2963
Iowa,Dallas County,10,5193,2602,2591
Iowa,Dallas County,11,4750,2384,2366
Iowa,Dallas County,12,4255,2047,2208
Iowa,Dallas County,13,3637,1710,1927
Iowa,Dallas County,14,2944,1402,1542
Iowa,Dallas County,15,1973,950,1023
Iowa,Dallas County,16,1515,676,839
Iowa,Dallas County,17,1026,411,615
Iowa,Dallas County,18,1180,384,796
Iowa,Davis County,0,8781,4341,4440
Iowa,Davis County,1,701,317,384
Iowa,Davis County,2,720,357,363
Iowa,Davis County,3,666,323,343
Iowa,Davis County,4,651,342,309
Iowa,Davis County,5,475,261,214
Iowa,Davis County,6,428,210,218
Iowa,Davis County,7,466,233,233
Iowa,Davis County,8,453,233,220
Iowa,Davis County,9,467,249,218
Iowa,Davis County,10,481,239,242
Iowa,Davis County,11,600,299,301
Iowa,Davis County,12,606,308,298
Iowa,Davis County,13,532,261,271
Iowa,Davis County,14,432,227,205
Iowa,Davis County,15,355,160,195
Iowa,Davis County,16,303,135,168
Iowa,Davis County,17,221,105,116
Iowa,Davis County,18,224,82,142
Iowa,Decatur County,0,8263,4150,4113
Iowa,Decatur County,1,419,209,210
Iowa,Decatur County,2,536,281,255
Iowa,Decatur County,3,527,271,256
Iowa,Decatur County,4,789,410,379
Iowa,Decatur County,5,988,554,434
Iowa,Decatur County,6,381,193,188
Iowa,Decatur County,7,393,195,198
Iowa,Decatur County,8,371,180,191
Iowa,Decatur County,9,403,207,196
Iowa,Decatur County,10,387,201,186
Iowa,Decatur County,11,504,248,256
Iowa,Decatur County,12,534,260,274
Iowa,Decatur County,13,518,265,253
Iowa,Decatur County,14,424,214,210
Iowa,Decatur County,15,330,151,179
Iowa,Decatur County,16,288,124,164
Iowa,Decatur County,17,246,114,132
Iowa,Decatur County,18,225,73,152
Iowa,Delaware County,0,17398,8692,8706
Iowa,Delaware County,1,986,537,449
Iowa,Delaware County,2,1173,606,567
Iowa,Delaware County,3,1210,619,591
Iowa,Delaware County,4,1184,575,609
Iowa,Delaware County,5,946,471,475
Iowa,Delaware County,6,706,354,352
Iowa,Delaware County,7,990,507,483
Iowa,Delaware County,8,908,457,451
Iowa,Delaware County,9,976,491,485
Iowa,Delaware County,10,1100,565,535
Iowa,Delaware County,11,1484,729,755
Iowa,Delaware County,12,1441,761,680
Iowa,Delaware County,13,1151,575,576
Iowa,Delaware County,14,872,447,425
Iowa,Delaware County,15,706,332,374
Iowa,Delaware County,16,609,289,320
Iowa,Delaware County,17,439,185,254
Iowa,Delaware County,18,517,192,325
Iowa,Des Moines County,0,40255,19778,20477
Iowa,Des Moines County,1,2423,1281,1142
Iowa,Des Moines County,2,2706,1375,1331
Iowa,Des Moines County,3,2528,1276,1252
Iowa,Des Moines County,4,2459,1302,1157
Iowa,Des Moines County,5,2219,1134,1085
Iowa,Des Moines County,6,2202,1092,1110
Iowa,Des Moines County,7,2517,1222,1295
Iowa,Des Moines County,8,2285,1168,1117
Iowa,Des Moines County,9,2254,1132,1122
Iowa,Des Moines County,10,2436,1209,1227
Iowa,Des Moines County,11,2956,1445,1511
Iowa,Des Moines County,12,2912,1462,1450
Iowa,Des Moines County,13,2775,1364,1411
Iowa,Des Moines County,14,2263,1091,1172
Iowa,Des Moines County,15,1791,849,942
Iowa,Des Moines County,16,1317,565,752
Iowa,Des Moines County,17,1011,410,601
Iowa,Des Moines County,18,1201,401,800
Iowa,Dickinson County,0,16935,8427,8508
Iowa,Dickinson County,1,831,422,409
Iowa,Dickinson County,2,909,466,443
Iowa,Dickinson County,3,923,485,438
Iowa,Dickinson County,4,841,454,387
Iowa,Dickinson County,5,810,401,409
Iowa,Dickinson County,6,781,431,350
Iowa,Dickinson County,7,889,472,417
Iowa,Dickinson County,8,882,477,405
Iowa,Dickinson County,9,905,458,447
Iowa,Dickinson County,10,930,455,475
Iowa,Dickinson County,11,1270,624,646
Iowa,Dickinson County,12,1406,691,715
Iowa,Dickinson County,13,1461,722,739
Iowa,Dickinson County,14,1232,607,625
Iowa,Dickinson County,15,911,448,463
Iowa,Dickinson County,16,743,328,415
Iowa,Dickinson County,17,557,231,326
Iowa,Dickinson County,18,654,255,399
Iowa,Dubuque County,0,96370,47634,48736
Iowa,Dubuque County,1,5910,3011,2899
Iowa,Dubuque County,2,6190,3100,3090
Iowa,Dubuque County,3,6322,3174,3148
Iowa,Dubuque County,4,6832,3483,3349
Iowa,Dubuque County,5,6803,3478,3325
Iowa,Dubuque County,6,6306,3275,3031
Iowa,Dubuque County,7,6060,3159,2901
Iowa,Dubuque County,8,5151,2557,2594
Iowa,Dubuque County,9,5275,2694,2581
Iowa,Dubuque County,10,6072,3030,3042
Iowa,Dubuque County,11,6929,3517,3412
Iowa,Dubuque County,12,6821,3382,3439
Iowa,Dubuque County,13,6056,2978,3078
Iowa,Dubuque County,14,4588,2247,2341
Iowa,Dubuque County,15,3505,1580,1925
Iowa,Dubuque County,16,2912,1309,1603
Iowa,Dubuque County,17,2172,865,1307
Iowa,Dubuque County,18,2466,795,1671
Iowa,Emmet County,0,9990,5066,4924
Iowa,Emmet County,1,558,299,259
Iowa,Emmet County,2,592,301,291
Iowa,Emmet County,3,598,297,301
Iowa,Emmet County,4,695,317,378
Iowa,Emmet County,5,693,439,254
Iowa,Emmet County,6,562,327,235
Iowa,Emmet County,7,602,322,280
Iowa,Emmet County,8,537,285,252
Iowa,Emmet County,9,516,266,250
Iowa,Emmet County,10,527,267,260
Iowa,Emmet County,11,672,335,337
Iowa,Emmet County,12,801,414,387
Iowa,Emmet County,13,716,356,360
Iowa,Emmet County,14,524,256,268
Iowa,Emmet County,15,400,197,203
Iowa,Emmet County,16,357,156,201
Iowa,Emmet County,17,265,117,148
Iowa,Emmet County,18,375,115,260
Iowa,Fayette County,0,20343,10183,10160
Iowa,Fayette County,1,1187,612,575
Iowa,Fayette County,2,1209,654,555
Iowa,Fayette County,3,1139,547,592
Iowa,Fayette County,4,1473,795,678
Iowa,Fayette County,5,1347,707,640
Iowa,Fayette County,6,1042,549,493
Iowa,Fayette County,7,1033,531,502
Iowa,Fayette County,8,1013,517,496
Iowa,Fayette County,9,998,506,492
Iowa,Fayette County,10,1236,643,593
Iowa,Fayette County,11,1548,814,734
Iowa,Fayette County,12,1614,835,779
Iowa,Fayette County,13,1356,679,677
Iowa,Fayette County,14,1133,550,583
Iowa,Fayette County,15,937,424,513
Iowa,Fayette County,16,826,361,465
Iowa,Fayette County,17,597,253,344
Iowa,Fayette County,18,655,206,449
Iowa,Floyd County,0,16077,7899,8178
Iowa,Floyd County,1,916,454,462
Iowa,Floyd County,2,1062,529,533
Iowa,Floyd County,3,1101,555,546
Iowa,Floyd County,4,1010,509,501
Iowa,Floyd County,5,929,477,452
Iowa,Floyd County,6,793,388,405
Iowa,Floyd County,7,823,438,385
Iowa,Floyd County,8,825,407,418
Iowa,Floyd County,9,914,455,459
Iowa,Floyd County,10,968,476,492
Iowa,Floyd County,11,1167,589,578
Iowa,Floyd County,12,1125,568,557
Iowa,Floyd County,13,1115,542,573
Iowa,Floyd County,14,925,447,478
Iowa,Floyd County,15,781,393,388
Iowa,Floyd County,16,604,276,328
Iowa,Floyd County,17,440,176,264
Iowa,Floyd County,18,579,220,359
Iowa,Franklin County,0,10436,5238,5198
Iowa,Franklin County,1,592,327,265
Iowa,Franklin County,2,687,395,292
Iowa,Franklin County,3,696,339,357
Iowa,Franklin County,4,621,320,301
Iowa,Franklin County,5,588,285,303
Iowa,Franklin County,6,469,243,226
Iowa,Franklin County,7,611,337,274
Iowa,Franklin County,8,539,267,272
Iowa,Franklin County,9,576,306,270
Iowa,Franklin County,10,592,282,310
Iowa,Franklin County,11,756,376,380
Iowa,Franklin County,12,866,448,418
Iowa,Franklin County,13,749,377,372
Iowa,Franklin County,14,578,291,287
Iowa,Franklin County,15,445,214,231
Iowa,Franklin County,16,381,175,206
Iowa,Franklin County,17,300,116,184
Iowa,Franklin County,18,390,140,250
Iowa,Fremont County,0,7022,3470,3552
Iowa,Fremont County,1,376,180,196
Iowa,Fremont County,2,440,218,222
Iowa,Fremont County,3,453,237,216
Iowa,Fremont County,4,419,217,202
Iowa,Fremont County,5,294,156,138
Iowa,Fremont County,6,326,178,148
Iowa,Fremont County,7,344,168,176
Iowa,Fremont County,8,381,201,180
Iowa,Fremont County,9,390,190,200
Iowa,Fremont County,10,387,191,196
Iowa,Fremont County,11,534,265,269
Iowa,Fremont County,12,625,320,305
Iowa,Fremont County,13,534,272,262
Iowa,Fremont County,14,472,231,241
Iowa,Fremont County,15,313,147,166
Iowa,Fremont County,16,255,114,141
Iowa,Fremont County,17,222,99,123
Iowa,Fremont County,18,257,86,171
Iowa,Greene County,0,9200,4501,4699
Iowa,Greene County,1,492,229,263
Iowa,Greene County,2,570,292,278
Iowa,Greene County,3,631,336,295
Iowa,Greene County,4,593,311,282
Iowa,Greene County,5,493,255,238
Iowa,Greene County,6,408,214,194
Iowa,Greene County,7,475,251,224
Iowa,Greene County,8,466,235,231
Iowa,Greene County,9,480,241,239
Iowa,Greene County,10,527,275,252
Iowa,Greene County,11,722,353,369
Iowa,Greene County,12,728,354,374
Iowa,Greene County,13,647,325,322
Iowa,Greene County,14,524,259,265
Iowa,Greene County,15,404,187,217
Iowa,Greene County,16,359,157,202
Iowa,Greene County,17,285,104,181
Iowa,Greene County,18,396,123,273
Iowa,Grundy County,0,12375,6074,6301
Iowa,Grundy County,1,744,339,405
Iowa,Grundy County,2,826,418,408
Iowa,Grundy County,3,816,415,401
Iowa,Grundy County,4,767,398,369
Iowa,Grundy County,5,658,345,313
Iowa,Grundy County,6,554,274,280
Iowa,Grundy County,7,727,370,357
Iowa,Grundy County,8,710,362,348
Iowa,Grundy County,9,704,377,327
Iowa,Grundy County,10,740,370,370
Iowa,Grundy County,11,942,463,479
Iowa,Grundy County,12,922,453,469
Iowa,Grundy County,13,814,419,395
Iowa,Grundy County,14,696,330,366
Iowa,Grundy County,15,521,251,270
Iowa,Grundy County,16,458,214,244
Iowa,Grundy County,17,344,136,208
Iowa,Grundy County,18,432,140,292
Iowa,Guthrie County,0,10722,5340,5382
Iowa,Guthrie County,1,567,258,309
Iowa,Guthrie County,2,610,310,300
Iowa,Guthrie County,3,747,387,360
Iowa,Guthrie County,4,692,377,315
Iowa,Guthrie County,5,493,259,234
Iowa,Guthrie County,6,449,244,205
Iowa,Guthrie County,7,560,280,280
Iowa,Guthrie County,8,553,297,256
Iowa,Guthrie County,9,602,298,304
Iowa,Guthrie County,10,651,322,329
Iowa,Guthrie County,11,835,427,408
Iowa,Guthrie County,12,814,408,406
Iowa,Guthrie County,13,818,427,391
Iowa,Guthrie County,14,664,330,334
Iowa,Guthrie County,15,526,247,279
Iowa,Guthrie County,16,418,205,213
Iowa,Guthrie County,17,344,143,201
Iowa,Guthrie County,18,379,121,258
Iowa,Hamilton County,0,15117,7446,7671
Iowa,Hamilton County,1,849,405,444
Iowa,Hamilton County,2,959,488,471
Iowa,Hamilton County,3,990,512,478
Iowa,Hamilton County,4,987,530,457
Iowa,Hamilton County,5,752,388,364
Iowa,Hamilton County,6,792,407,385
Iowa,Hamilton County,7,906,473,433
Iowa,Hamilton County,8,794,373,421
Iowa,Hamilton County,9,863,451,412
Iowa,Hamilton County,10,937,474,463
Iowa,Hamilton County,11,1207,633,574
Iowa,Hamilton County,12,1133,557,576
Iowa,Hamilton County,13,1019,493,526
Iowa,Hamilton County,14,838,411,427
Iowa,Hamilton County,15,584,281,303
Iowa,Hamilton County,16,503,211,292
Iowa,Hamilton County,17,429,165,264
Iowa,Hamilton County,18,575,194,381
Iowa,Hancock County,0,11027,5541,5486
Iowa,Hancock County,1,592,284,308
Iowa,Hancock County,2,706,364,342
Iowa,Hancock County,3,732,401,331
Iowa,Hancock County,4,718,393,325
Iowa,Hancock County,5,497,260,237
Iowa,Hancock County,6,491,245,246
Iowa,Hancock County,7,645,351,294
Iowa,Hancock County,8,613,303,310
Iowa,Hancock County,9,576,293,283
Iowa,Hancock County,10,602,307,295
Iowa,Hancock County,11,908,448,460
Iowa,Hancock County,12,908,465,443
Iowa,Hancock County,13,810,438,372
Iowa,Hancock County,14,627,319,308
Iowa,Hancock County,15,466,235,231
Iowa,Hancock County,16,429,196,233
Iowa,Hancock County,17,303,122,181
Iowa,Hancock County,18,404,117,287
Iowa,Hardin County,0,17311,8664,8647
Iowa,Hardin County,1,892,447,445
Iowa,Hardin County,2,989,492,497
Iowa,Hardin County,3,1011,504,507
Iowa,Hardin County,4,1330,807,523
Iowa,Hardin County,5,1031,567,464
Iowa,Hardin County,6,816,420,396
Iowa,Hardin County,7,953,476,477
Iowa,Hardin County,8,885,454,431
Iowa,Hardin County,9,947,528,419
Iowa,Hardin County,10,981,471,510
Iowa,Hardin County,11,1260,606,654
Iowa,Hardin County,12,1369,722,647
Iowa,Hardin County,13,1172,611,561
Iowa,Hardin County,14,910,436,474
Iowa,Hardin County,15,813,360,453
Iowa,Hardin County,16,662,282,380
Iowa,Hardin County,17,562,226,336
Iowa,Hardin County,18,728,255,473
Iowa,Harrison County,0,14324,7117,7207
Iowa,Harrison County,1,781,406,375
Iowa,Harrison County,2,910,471,439
Iowa,Harrison County,3,965,476,489
Iowa,Harrison County,4,911,480,431
Iowa,Harrison County,5,745,378,367
Iowa,Harrison County,6,695,363,332
Iowa,Harrison County,7,737,361,376
Iowa,Harrison County,8,754,377,377
Iowa,Harrison County,9,871,438,433
Iowa,Harrison County,10,887,436,451
Iowa,Harrison County,11,1191,605,586
Iowa,Harrison County,12,1193,600,593
Iowa,Harrison County,13,946,483,463
Iowa,Harrison County,14,801,410,391
Iowa,Harrison County,15,637,297,340
Iowa,Harrison County,16,500,225,275
Iowa,Harrison County,17,361,155,206
Iowa,Harrison County,18,439,156,283
Iowa,Henry County,0,20217,10355,9862
Iowa,Henry County,1,1198,615,583
Iowa,Henry County,2,1184,604,580
Iowa,Henry County,3,1257,641,616
Iowa,Henry County,4,1441,771,670
Iowa,Henry County,5,1435,783,652
Iowa,Henry County,6,1155,637,518
Iowa,Henry County,7,1250,676,574
Iowa,Henry County,8,1127,609,518
Iowa,Henry County,9,1216,632,584
Iowa,Henry County,10,1307,694,613
Iowa,Henry County,11,1429,751,678
Iowa,Henry County,12,1398,718,680
Iowa,Henry County,13,1256,630,626
Iowa,Henry County,14,1107,557,550
Iowa,Henry County,15,812,381,431
Iowa,Henry County,16,628,281,347
Iowa,Henry County,17,472,186,286
Iowa,Henry County,18,545,189,356
Iowa,Howard County,0,9449,4705,4744
Iowa,Howard County,1,645,313,332
Iowa,Howard County,2,725,381,344
Iowa,Howard County,3,647,334,313
Iowa,Howard County,4,555,289,266
Iowa,Howard County,5,478,236,242
Iowa,Howard County,6,449,224,225
Iowa,Howard County,7,559,280,279
Iowa,Howard County,8,512,279,233
Iowa,Howard County,9,460,233,227
Iowa,Howard County,10,565,300,265
Iowa,Howard County,11,702,351,351
Iowa,Howard County,12,702,351,351
Iowa,Howard County,13,592,331,261
Iowa,Howard County,14,488,238,250
Iowa,Howard County,15,418,189,229
Iowa,Howard County,16,321,137,184
Iowa,Howard County,17,291,116,175
Iowa,Howard County,18,340,123,217
Iowa,Humboldt County,0,9640,4728,4912
Iowa,Humboldt County,1,532,251,281
Iowa,Humboldt County,2,683,346,337
Iowa,Humboldt County,3,626,301,325
Iowa,Humboldt County,4,580,304,276
Iowa,Humboldt County,5,503,249,254
Iowa,Humboldt County,6,483,238,245
Iowa,Humboldt County,7,583,310,273
Iowa,Humboldt County,8,489,258,231
Iowa,Humboldt County,9,484,257,227
Iowa,Humboldt County,10,541,265,276
Iowa,Humboldt County,11,742,365,377
Iowa,Humboldt County,12,779,381,398
Iowa,Humboldt County,13,654,333,321
Iowa,Humboldt County,14,492,242,250
Iowa,Humboldt County,15,423,206,217
Iowa,Humboldt County,16,374,157,217
Iowa,Humboldt County,17,328,147,181
Iowa,Humboldt County,18,344,118,226
Iowa,Ida County,0,7042,3517,3525
Iowa,Ida County,1,498,240,258
Iowa,Ida County,2,482,265,217
Iowa,Ida County,3,428,235,193
Iowa,Ida County,4,409,213,196
Iowa,Ida County,5,349,167,182
Iowa,Ida County,6,335,162,173
Iowa,Ida County,7,407,221,186
Iowa,Ida County,8,359,187,172
Iowa,Ida County,9,337,187,150
Iowa,Ida County,10,361,167,194
Iowa,Ida County,11,503,252,251
Iowa,Ida County,12,558,287,271
Iowa,Ida County,13,497,264,233
Iowa,Ida County,14,395,201,194
Iowa,Ida County,15,311,146,165
Iowa,Ida County,16,275,129,146
Iowa,Ida County,17,233,94,139
Iowa,Ida County,18,305,100,205
Iowa,Iowa County,0,16375,8112,8263
Iowa,Iowa County,1,966,506,460
Iowa,Iowa County,2,1075,557,518
Iowa,Iowa County,3,1085,554,531
Iowa,Iowa County,4,1071,543,528
Iowa,Iowa County,5,852,436,416
Iowa,Iowa County,6,776,380,396
Iowa,Iowa County,7,959,500,459
Iowa,Iowa County,8,918,466,452
Iowa,Iowa County,9,945,462,483
Iowa,Iowa County,10,1078,548,530
Iowa,Iowa County,11,1308,662,646
Iowa,Iowa County,12,1322,676,646
Iowa,Iowa County,13,1075,568,507
Iowa,Iowa County,14,756,377,379
Iowa,Iowa County,15,618,285,333
Iowa,Iowa County,16,580,252,328
Iowa,Iowa County,17,452,170,282
Iowa,Iowa County,18,539,170,369
Iowa,Jackson County,0,19482,9682,9800
Iowa,Jackson County,1,1056,523,533
Iowa,Jackson County,2,1179,587,592
Iowa,Jackson County,3,1288,680,608
Iowa,Jackson County,4,1251,683,568
Iowa,Jackson County,5,1033,526,507
Iowa,Jackson County,6,878,460,418
Iowa,Jackson County,7,1021,520,501
Iowa,Jackson County,8,984,496,488
Iowa,Jackson County,9,1107,545,562
Iowa,Jackson County,10,1302,644,658
Iowa,Jackson County,11,1629,831,798
Iowa,Jackson County,12,1570,798,772
Iowa,Jackson County,13,1329,672,657
Iowa,Jackson County,14,1153,561,592
Iowa,Jackson County,15,881,407,474
Iowa,Jackson County,16,693,325,368
Iowa,Jackson County,17,562,229,333
Iowa,Jackson County,18,566,195,371
Iowa,Jasper County,0,36872,18811,18061
Iowa,Jasper County,1,2025,1012,1013
Iowa,Jasper County,2,2385,1205,1180
Iowa,Jasper County,3,2474,1261,1213
Iowa,Jasper County,4,2164,1149,1015
Iowa,Jasper County,5,1994,1123,871
Iowa,Jasper County,6,2045,1145,900
Iowa,Jasper County,7,2357,1282,1075
Iowa,Jasper County,8,2147,1191,956
Iowa,Jasper County,9,2273,1247,1026
Iowa,Jasper County,10,2424,1250,1174
Iowa,Jasper County,11,2874,1466,1408
Iowa,Jasper County,12,2790,1440,1350
Iowa,Jasper County,13,2289,1133,1156
Iowa,Jasper County,14,2027,997,1030
Iowa,Jasper County,15,1457,692,765
Iowa,Jasper County,16,1167,504,663
Iowa,Jasper County,17,903,367,536
Iowa,Jasper County,18,1077,347,730
Iowa,Jefferson County,0,17325,9340,7985
Iowa,Jefferson County,1,741,391,350
Iowa,Jefferson County,2,793,409,384
Iowa,Jefferson County,3,847,411,436
Iowa,Jefferson County,4,867,446,421
Iowa,Jefferson County,5,1803,1350,453
Iowa,Jefferson County,6,1275,854,421
Iowa,Jefferson County,7,1017,573,444
Iowa,Jefferson County,8,839,460,379
Iowa,Jefferson County,9,853,441,412
Iowa,Jefferson County,10,822,383,439
Iowa,Jefferson County,11,1085,528,557
Iowa,Jefferson County,12,1374,696,678
Iowa,Jefferson County,13,1759,922,837
Iowa,Jefferson County,14,1315,651,664
Iowa,Jefferson County,15,658,319,339
Iowa,Jefferson County,16,443,211,232
Iowa,Jefferson County,17,352,124,228
Iowa,Jefferson County,18,482,171,311
Iowa,Johnson County,0,142287,70892,71395
Iowa,Johnson County,1,8774,4619,4155
Iowa,Johnson County,2,8181,4185,3996
Iowa,Johnson County,3,7652,3854,3798
Iowa,Johnson County,4,11829,5735,6094
Iowa,Johnson County,5,22014,10936,11078
Iowa,Johnson County,6,12573,6661,5912
Iowa,Johnson County,7,10986,5541,5445
Iowa,Johnson County,8,8785,4598,4187
Iowa,Johnson County,9,7709,3947,3762
Iowa,Johnson County,10,7372,3670,3702
Iowa,Johnson County,11,7596,3723,3873
Iowa,Johnson County,12,7575,3701,3874
Iowa,Johnson County,13,7119,3438,3681
Iowa,Johnson County,14,5068,2459,2609
Iowa,Johnson County,15,3201,1529,1672
Iowa,Johnson County,16,2246,999,1247
Iowa,Johnson County,17,1600,651,949
Iowa,Johnson County,18,2007,646,1361
Iowa,Jones County,0,20454,10617,9837
Iowa,Jones County,1,1073,574,499
Iowa,Jones County,2,1293,665,628
Iowa,Jones County,3,1325,657,668
Iowa,Jones County,4,1159,594,565
Iowa,Jones County,5,1130,632,498
Iowa,Jones County,6,1044,587,457
Iowa,Jones County,7,1236,685,551
Iowa,Jones County,8,1205,662,543
Iowa,Jones County,9,1208,657,551
Iowa,Jones County,10,1367,751,616
Iowa,Jones County,11,1645,857,788
Iowa,Jones County,12,1549,808,741
Iowa,Jones County,13,1427,779,648
Iowa,Jones County,14,1129,560,569
Iowa,Jones County,15,845,410,435
Iowa,Jones County,16,695,321,374
Iowa,Jones County,17,511,213,298
Iowa,Jones County,18,613,205,408
Iowa,Keokuk County,0,10231,5133,5098
Iowa,Keokuk County,1,648,306,342
Iowa,Keokuk County,2,625,333,292
Iowa,Keokuk County,3,681,374,307
Iowa,Keokuk County,4,624,323,301
Iowa,Keokuk County,5,531,277,254
Iowa,Keokuk County,6,458,241,217
Iowa,Keokuk County,7,595,311,284
Iowa,Keokuk County,8,542,280,262
Iowa,Keokuk County,9,560,290,270
Iowa,Keokuk County,10,563,293,270
Iowa,Keokuk County,11,825,398,427
Iowa,Keokuk County,12,826,434,392
Iowa,Keokuk County,13,699,369,330
Iowa,Keokuk County,14,553,267,286
Iowa,Keokuk County,15,464,228,236
Iowa,Keokuk County,16,356,151,205
Iowa,Keokuk County,17,337,144,193
Iowa,Keokuk County,18,344,114,230
Iowa,Kossuth County,0,15222,7647,7575
Iowa,Kossuth County,1,842,471,371
Iowa,Kossuth County,2,940,511,429
Iowa,Kossuth County,3,952,462,490
Iowa,Kossuth County,4,943,486,457
Iowa,Kossuth County,5,769,387,382
Iowa,Kossuth County,6,700,375,325
Iowa,Kossuth County,7,802,408,394
Iowa,Kossuth County,8,722,370,352
Iowa,Kossuth County,9,721,371,350
Iowa,Kossuth County,10,860,420,440
Iowa,Kossuth County,11,1174,617,557
Iowa,Kossuth County,12,1304,683,621
Iowa,Kossuth County,13,1071,548,523
Iowa,Kossuth County,14,856,423,433
Iowa,Kossuth County,15,692,305,387
Iowa,Kossuth County,16,708,336,372
Iowa,Kossuth County,17,524,232,292
Iowa,Kossuth County,18,642,242,400
Iowa,Lee County,0,35286,17624,17662
Iowa,Lee County,1,2171,1069,1102
Iowa,Lee County,2,2026,1043,983
Iowa,Lee County,3,2059,1034,1025
Iowa,Lee County,4,2090,1065,1025
Iowa,Lee County,5,2096,1102,994
Iowa,Lee County,6,2018,1087,931
Iowa,Lee County,7,2121,1138,983
Iowa,Lee County,8,1886,984,902
Iowa,Lee County,9,2045,1051,994
Iowa,Lee County,10,2179,1132,1047
Iowa,Lee County,11,2705,1358,1347
Iowa,Lee County,12,2785,1442,1343
Iowa,Lee County,13,2529,1265,1264
Iowa,Lee County,14,2132,1042,1090
Iowa,Lee County,15,1566,699,867
Iowa,Lee County,16,1047,477,570
Iowa,Lee County,17,860,318,542
Iowa,Lee County,18,971,318,653
Iowa,Linn County,0,217751,107471,110280
Iowa,Linn County,1,13804,7063,6741
Iowa,Linn County,2,14296,7240,7056
Iowa,Linn County,3,14769,7515,7254
Iowa,Linn County,4,14459,7395,7064
Iowa,Linn County,5,15278,7626,7652
Iowa,Linn County,6,14291,7261,7030
Iowa,Linn County,7,15289,7805,7484
Iowa,Linn County,8,14126,7074,7052
Iowa,Linn County,9,13706,6841,6865
Iowa,Linn County,10,14203,7164,7039
Iowa,Linn County,11,15422,7697,7725
Iowa,Linn County,12,14413,7080,7333
Iowa,Linn County,13,12525,6071,6454
Iowa,Linn County,14,9977,4724,5253
Iowa,Linn County,15,7114,3306,3808
Iowa,Linn County,16,5590,2457,3133
Iowa,Linn County,17,4011,1656,2355
Iowa,Linn County,18,4478,1496,2982
Iowa,Louisa County,0,11161,5662,5499
Iowa,Louisa County,1,587,252,335
Iowa,Louisa County,2,686,374,312
Iowa,Louisa County,3,800,436,364
Iowa,Louisa County,4,790,413,377
Iowa,Louisa County,5,636,329,307
Iowa,Louisa County,6,535,274,261
Iowa,Louisa County,7,724,389,335
Iowa,Louisa County,8,679,336,343
Iowa,Louisa County,9,632,350,282
Iowa,Louisa County,10,742,380,362
Iowa,Louisa County,11,968,497,471
Iowa,Louisa County,12,799,408,391
Iowa,Louisa County,13,728,366,362
Iowa,Louisa County,14,560,304,256
Iowa,Louisa County,15,448,210,238
Iowa,Louisa County,16,333,158,175
Iowa,Louisa County,17,243,91,152
Iowa,Louisa County,18,271,95,176
Iowa,Lucas County,0,8701,4387,4314
Iowa,Lucas County,1,485,245,240
Iowa,Lucas County,2,552,295,257
Iowa,Lucas County,3,601,325,276
Iowa,Lucas County,4,576,308,268
Iowa,Lucas County,5,467,246,221
Iowa,Lucas County,6,383,188,195
Iowa,Lucas County,7,393,206,187
Iowa,Lucas County,8,439,224,215
Iowa,Lucas County,9,441,225,216
Iowa,Lucas County,10,546,281,265
Iowa,Lucas County,11,667,337,330
Iowa,Lucas County,12,673,330,343
Iowa,Lucas County,13,647,338,309
Iowa,Lucas County,14,499,245,254
Iowa,Lucas County,15,426,218,208
Iowa,Lucas County,16,344,162,182
Iowa,Lucas County,17,255,99,156
Iowa,Lucas County,18,307,115,192
Iowa,Lyon County,0,11683,5870,5813
Iowa,Lyon County,1,853,429,424
Iowa,Lyon County,2,993,521,472
Iowa,Lyon County,3,904,487,417
Iowa,Lyon County,4,767,418,349
Iowa,Lyon County,5,612,328,284
Iowa,Lyon County,6,554,272,282
Iowa,Lyon County,7,708,364,344
Iowa,Lyon County,8,733,371,362
Iowa,Lyon County,9,638,336,302
Iowa,Lyon County,10,656,328,328
Iowa,Lyon County,11,770,403,367
Iowa,Lyon County,12,791,402,389
Iowa,Lyon County,13,724,365,359
Iowa,Lyon County,14,543,261,282
Iowa,Lyon County,15,380,177,203
Iowa,Lyon County,16,361,143,218
Iowa,Lyon County,17,325,139,186
Iowa,Lyon County,18,371,126,245
Iowa,Madison County,0,15609,7777,7832
Iowa,Madison County,1,912,466,446
Iowa,Madison County,2,1163,621,542
Iowa,Madison County,3,1198,611,587
Iowa,Madison County,4,1116,581,535
Iowa,Madison County,5,672,356,316
Iowa,Madison County,6,688,328,360
Iowa,Madison County,7,867,437,430
Iowa,Madison County,8,973,480,493
Iowa,Madison County,9,1086,540,546
Iowa,Madison County,10,1090,542,548
Iowa,Madison County,11,1163,582,581
Iowa,Madison County,12,1134,562,572
Iowa,Madison County,13,1010,517,493
Iowa,Madison County,14,788,396,392
Iowa,Madison County,15,600,284,316
Iowa,Madison County,16,438,211,227
Iowa,Madison County,17,333,141,192
Iowa,Madison County,18,378,122,256
Iowa,Mahaska County,0,22370,11271,11099
Iowa,Mahaska County,1,1363,712,651
Iowa,Mahaska County,2,1499,815,684
Iowa,Mahaska County,3,1517,808,709
Iowa,Mahaska County,4,1568,829,739
Iowa,Mahaska County,5,1518,821,697
Iowa,Mahaska County,6,1283,649,634
Iowa,Mahaska County,7,1330,689,641
Iowa,Mahaska County,8,1317,652,665
Iowa,Mahaska County,9,1243,628,615
Iowa,Mahaska County,10,1327,666,661
Iowa,Mahaska County,11,1563,799,764
Iowa,Mahaska County,12,1588,816,772
Iowa,Mahaska County,13,1473,756,717
Iowa,Mahaska County,14,1086,520,566
Iowa,Mahaska County,15,852,381,471
Iowa,Mahaska County,16,676,331,345
Iowa,Mahaska County,17,492,183,309
Iowa,Mahaska County,18,675,216,459
Iowa,Marion County,0,33365,16663,16702
Iowa,Marion County,1,2026,1022,1004
Iowa,Marion County,2,2317,1216,1101
Iowa,Marion County,3,2316,1231,1085
Iowa,Marion County,4,2541,1257,1284
Iowa,Marion County,5,2419,1240,1179
Iowa,Marion County,6,1691,888,803
Iowa,Marion County,7,1920,964,956
Iowa,Marion County,8,1911,992,919
Iowa,Marion County,9,1931,971,960
Iowa,Marion County,10,2029,1019,1010
Iowa,Marion County,11,2405,1223,1182
Iowa,Marion County,12,2308,1174,1134
Iowa,Marion County,13,2065,1035,1030
Iowa,Marion County,14,1610,782,828
Iowa,Marion County,15,1279,603,676
Iowa,Marion County,16,1009,446,563
Iowa,Marion County,17,795,341,454
Iowa,Marion County,18,793,259,534
Iowa,Marshall County,0,40866,20620,20246
Iowa,Marshall County,1,2868,1457,1411
Iowa,Marshall County,2,2910,1513,1397
Iowa,Marshall County,3,2806,1436,1370
Iowa,Marshall County,4,2637,1400,1237
Iowa,Marshall County,5,2515,1351,1164
Iowa,Marshall County,6,2345,1245,1100
Iowa,Marshall County,7,2428,1275,1153
Iowa,Marshall County,8,2162,1107,1055
Iowa,Marshall County,9,2265,1120,1145
Iowa,Marshall County,10,2411,1235,1176
Iowa,Marshall County,11,2792,1449,1343
Iowa,Marshall County,12,2859,1400,1459
Iowa,Marshall County,13,2728,1406,1322
Iowa,Marshall County,14,2104,1023,1081
Iowa,Marshall County,15,1629,768,861
Iowa,Marshall County,16,1238,592,646
Iowa,Marshall County,17,991,401,590
Iowa,Marshall County,18,1178,442,736
Iowa,Mills County,0,14831,7430,7401
Iowa,Mills County,1,845,411,434
Iowa,Mills County,2,1006,504,502
Iowa,Mills County,3,1041,538,503
Iowa,Mills County,4,1061,551,510
Iowa,Mills County,5,676,352,324
Iowa,Mills County,6,630,329,301
Iowa,Mills County,7,791,405,386
Iowa,Mills County,8,851,419,432
Iowa,Mills County,9,993,503,490
Iowa,Mills County,10,998,496,502
Iowa,Mills County,11,1222,609,613
Iowa,Mills County,12,1241,627,614
Iowa,Mills County,13,1132,572,560
Iowa,Mills County,14,891,444,447
Iowa,Mills County,15,520,277,243
Iowa,Mills County,16,393,181,212
Iowa,Mills County,17,270,124,146
Iowa,Mills County,18,270,88,182
Iowa,Mitchell County,0,10779,5334,5445
Iowa,Mitchell County,1,606,336,270
Iowa,Mitchell County,2,714,387,327
Iowa,Mitchell County,3,767,369,398
Iowa,Mitchell County,4,737,374,363
Iowa,Mitchell County,5,576,302,274
Iowa,Mitchell County,6,481,247,234
Iowa,Mitchell County,7,542,264,278
Iowa,Mitchell County,8,521,270,251
Iowa,Mitchell County,9,533,269,264
Iowa,Mitchell County,10,633,312,321
Iowa,Mitchell County,11,872,443,429
Iowa,Mitchell County,12,797,417,380
Iowa,Mitchell County,13,679,348,331
Iowa,Mitchell County,14,546,277,269
Iowa,Mitchell County,15,484,224,260
Iowa,Mitchell County,16,432,179,253
Iowa,Mitchell County,17,351,145,206
Iowa,Mitchell County,18,508,171,337
Iowa,Monona County,0,8996,4440,4556
Iowa,Monona County,1,457,229,228
Iowa,Monona County,2,530,285,245
Iowa,Monona County,3,562,289,273
Iowa,Monona County,4,571,304,267
Iowa,Monona County,5,444,243,201
Iowa,Monona County,6,347,184,163
Iowa,Monona County,7,443,219,224
Iowa,Monona County,8,427,209,218
Iowa,Monona County,9,457,232,225
Iowa,Monona County,10,483,233,250
Iowa,Monona County,11,684,345,339
Iowa,Monona County,12,739,373,366
Iowa,Monona County,13,643,337,306
Iowa,Monona County,14,539,274,265
Iowa,Monona County,15,520,248,272
Iowa,Monona County,16,413,186,227
Iowa,Monona County,17,328,131,197
Iowa,Monona County,18,409,119,290
Iowa,Monroe County,0,8001,4016,3985
Iowa,Monroe County,1,443,243,200
Iowa,Monroe County,2,562,278,284
Iowa,Monroe County,3,560,299,261
Iowa,Monroe County,4,492,269,223
Iowa,Monroe County,5,436,230,206
Iowa,Monroe County,6,376,198,178
Iowa,Monroe County,7,449,225,224
Iowa,Monroe County,8,462,218,244
Iowa,Monroe County,9,475,242,233
Iowa,Monroe County,10,498,252,246
Iowa,Monroe County,11,596,296,300
Iowa,Monroe County,12,584,297,287
Iowa,Monroe County,13,545,292,253
Iowa,Monroe County,14,456,215,241
Iowa,Monroe County,15,344,163,181
Iowa,Monroe County,16,286,134,152
Iowa,Monroe County,17,204,91,113
Iowa,Monroe County,18,233,74,159
Iowa,Montgomery County,0,10421,5101,5320
Iowa,Montgomery County,1,593,305,288
Iowa,Montgomery County,2,650,348,302
Iowa,Montgomery County,3,672,345,327
Iowa,Montgomery County,4,684,337,347
Iowa,Montgomery County,5,524,250,274
Iowa,Montgomery County,6,446,233,213
Iowa,Montgomery County,7,511,262,249
Iowa,Montgomery County,8,534,273,261
Iowa,Montgomery County,9,619,307,312
Iowa,Montgomery County,10,630,301,329
Iowa,Montgomery County,11,790,385,405
Iowa,Montgomery County,12,845,421,424
Iowa,Montgomery County,13,755,395,360
Iowa,Montgomery County,14,601,307,294
Iowa,Montgomery County,15,479,217,262
Iowa,Montgomery County,16,342,145,197
Iowa,Montgomery County,17,352,147,205
Iowa,Montgomery County,18,394,123,271
Iowa,Muscatine County,0,42903,21361,21542
Iowa,Muscatine County,1,2882,1455,1427
Iowa,Muscatine County,2,3121,1558,1563
Iowa,Muscatine County,3,3098,1603,1495
Iowa,Muscatine County,4,2813,1476,1337
Iowa,Muscatine County,5,2697,1365,1332
Iowa,Muscatine County,6,2504,1317,1187
Iowa,Muscatine County,7,2696,1373,1323
Iowa,Muscatine County,8,2572,1290,1282
Iowa,Muscatine County,9,2569,1268,1301
Iowa,Muscatine County,10,2764,1383,1381
Iowa,Muscatine County,11,3068,1542,1526
Iowa,Muscatine County,12,3040,1552,1488
Iowa,Muscatine County,13,2631,1317,1314
Iowa,Muscatine County,14,2122,1038,1084
Iowa,Muscatine County,15,1511,690,821
Iowa,Muscatine County,16,1087,500,587
Iowa,Muscatine County,17,769,314,455
Iowa,Muscatine County,18,959,320,639
Iowa,Osceola County,0,6218,3146,3072
Iowa,Osceola County,1,371,193,178
Iowa,Osceola County,2,432,229,203
Iowa,Osceola County,3,395,219,176
Iowa,Osceola County,4,379,202,177
Iowa,Osceola County,5,304,165,139
Iowa,Osceola County,6,290,152,138
Iowa,Osceola County,7,333,181,152
Iowa,Osceola County,8,321,157,164
Iowa,Osceola County,9,356,181,175
Iowa,Osceola County,10,362,182,180
Iowa,Osceola County,11,476,245,231
Iowa,Osceola County,12,558,288,270
Iowa,Osceola County,13,384,196,188
Iowa,Osceola County,14,315,165,150
Iowa,Osceola County,15,266,113,153
Iowa,Osceola County,16,245,101,144
Iowa,Osceola County,17,206,99,107
Iowa,Osceola County,18,225,78,147
Iowa,Page County,0,15496,8091,7405
Iowa,Page County,1,871,445,426
Iowa,Page County,2,812,438,374
Iowa,Page County,3,787,411,376
Iowa,Page County,4,1040,589,451
Iowa,Page County,5,857,496,361
Iowa,Page County,6,813,480,333
Iowa,Page County,7,904,506,398
Iowa,Page County,8,923,538,385
Iowa,Page County,9,956,548,408
Iowa,Page County,10,871,493,378
Iowa,Page County,11,1122,584,538
Iowa,Page County,12,1197,588,609
Iowa,Page County,13,1124,578,546
Iowa,Page County,14,916,459,457
Iowa,Page County,15,696,322,374
Iowa,Page County,16,576,253,323
Iowa,Page County,17,442,164,278
Iowa,Page County,18,589,199,390
Iowa,Palo Alto County,0,9099,4526,4573
Iowa,Palo Alto County,1,533,254,279
Iowa,Palo Alto County,2,597,306,291
Iowa,Palo Alto County,3,559,302,257
Iowa,Palo Alto County,4,581,326,255
Iowa,Palo Alto County,5,560,300,260
Iowa,Palo Alto County,6,466,254,212
Iowa,Palo Alto County,7,495,248,247
Iowa,Palo Alto County,8,442,225,217
Iowa,Palo Alto County,9,479,239,240
Iowa,Palo Alto County,10,472,227,245
Iowa,Palo Alto County,11,659,356,303
Iowa,Palo Alto County,12,697,344,353
Iowa,Palo Alto County,13,609,311,298
Iowa,Palo Alto County,14,513,255,258
Iowa,Palo Alto County,15,368,178,190
Iowa,Palo Alto County,16,371,151,220
Iowa,Palo Alto County,17,319,129,190
Iowa,Palo Alto County,18,379,121,258
Iowa,Plymouth County,0,24874,12359,12515
Iowa,Plymouth County,1,1460,740,720
Iowa,Plymouth County,2,1790,894,896
Iowa,Plymouth County,3,1809,955,854
Iowa,Plymouth County,4,1757,898,859
Iowa,Plymouth County,5,1278,640,638
Iowa,Plymouth County,6,1115,573,542
Iowa,Plymouth County,7,1390,695,695
Iowa,Plymouth County,8,1451,733,718
Iowa,Plymouth County,9,1456,734,722
Iowa,Plymouth County,10,1569,830,739
Iowa,Plymouth County,11,1852,906,946
Iowa,Plymouth County,12,1933,967,966
Iowa,Plymouth County,13,1627,845,782
Iowa,Plymouth County,14,1270,622,648
Iowa,Plymouth County,15,989,467,522
Iowa,Plymouth County,16,745,334,411
Iowa,Plymouth County,17,681,289,392
Iowa,Plymouth County,18,702,237,465
Iowa,Pocahontas County,0,7138,3558,3580
Iowa,Pocahontas County,1,406,206,200
Iowa,Pocahontas County,2,473,230,243
Iowa,Pocahontas County,3,460,247,213
Iowa,Pocahontas County,4,415,210,205
Iowa,Pocahontas County,5,368,190,178
Iowa,Pocahontas County,6,291,152,139
Iowa,Pocahontas County,7,338,170,168
Iowa,Pocahontas County,8,349,185,164
Iowa,Pocahontas County,9,320,163,157
Iowa,Pocahontas County,10,403,200,203
Iowa,Pocahontas County,11,596,288,308
Iowa,Pocahontas County,12,617,341,276
Iowa,Pocahontas County,13,507,250,257
Iowa,Pocahontas County,14,392,209,183
Iowa,Pocahontas County,15,352,164,188
Iowa,Pocahontas County,16,323,151,172
Iowa,Pocahontas County,17,223,85,138
Iowa,Pocahontas County,18,305,117,188
Iowa,Polk County,0,459862,226262,233600
Iowa,Polk County,1,33264,17044,16220
Iowa,Polk County,2,33063,16856,16207
Iowa,Polk County,3,31477,16068,15409
Iowa,Polk County,4,29185,14888,14297
Iowa,Polk County,5,30214,14747,15467
Iowa,Polk County,6,35783,17701,18082
Iowa,Polk County,7,36641,18468,18173
Iowa,Polk County,8,31588,15909,15679
Iowa,Polk County,9,30356,15248,15108
Iowa,Polk County,10,30051,15104,14947
Iowa,Polk County,11,31478,15565,15913
Iowa,Polk County,12,28555,13838,14717
Iowa,Polk County,13,24482,11729,12753
Iowa,Polk County,14,18585,8717,9868
Iowa,Polk County,15,12430,5630,6800
Iowa,Polk County,16,8754,3808,4946
Iowa,Polk County,17,6502,2559,3943
Iowa,Polk County,18,7454,2383,5071
Iowa,Pottawattamie County,0,93128,45758,47370
Iowa,Pottawattamie County,1,6039,3080,2959
Iowa,Pottawattamie County,2,6120,3103,3017
Iowa,Pottawattamie County,3,6227,3210,3017
Iowa,Pottawattamie County,4,6264,3213,3051
Iowa,Pottawattamie County,5,5781,2952,2829
Iowa,Pottawattamie County,6,5693,2798,2895
Iowa,Pottawattamie County,7,5861,2945,2916
Iowa,Pottawattamie County,8,5534,2831,2703
Iowa,Pottawattamie County,9,5434,2718,2716
Iowa,Pottawattamie County,10,5710,2892,2818
Iowa,Pottawattamie County,11,6998,3398,3600
Iowa,Pottawattamie County,12,6850,3365,3485
Iowa,Pottawattamie County,13,6016,2944,3072
Iowa,Pottawattamie County,14,4667,2216,2451
Iowa,Pottawattamie County,15,3408,1542,1866
Iowa,Pottawattamie County,16,2477,1062,1415
Iowa,Pottawattamie County,17,1931,785,1146
Iowa,Pottawattamie County,18,2118,704,1414
Iowa,Poweshiek County,0,18668,9124,9544
Iowa,Poweshiek County,1,965,507,458
Iowa,Poweshiek County,2,1059,525,534
Iowa,Poweshiek County,3,1088,578,510
Iowa,Poweshiek County,4,1623,818,805
Iowa,Poweshiek County,5,1757,848,909
Iowa,Poweshiek County,6,883,432,451
Iowa,Poweshiek County,7,929,458,471
Iowa,Poweshiek County,8,899,472,427
Iowa,Poweshiek County,9,935,467,468
Iowa,Poweshiek County,10,1077,550,527
Iowa,Poweshiek County,11,1308,646,662
Iowa,Poweshiek County,12,1362,667,695
Iowa,Poweshiek County,13,1207,593,614
Iowa,Poweshiek County,14,1010,502,508
Iowa,Poweshiek County,15,808,364,444
Iowa,Poweshiek County,16,633,278,355
Iowa,Poweshiek County,17,509,223,286
Iowa,Poweshiek County,18,616,196,420
Iowa,Ringgold County,0,5051,2483,2568
Iowa,Ringgold County,1,293,160,133
Iowa,Ringgold County,2,336,186,150
Iowa,Ringgold County,3,346,182,164
Iowa,Ringgold County,4,306,164,142
Iowa,Ringgold County,5,224,102,122
Iowa,Ringgold County,6,245,121,124
Iowa,Ringgold County,7,241,125,116
Iowa,Ringgold County,8,242,128,114
Iowa,Ringgold County,9,228,122,106
Iowa,Ringgold County,10,275,132,143
Iowa,Ringgold County,11,341,160,181
Iowa,Ringgold County,12,362,189,173
Iowa,Ringgold County,13,334,169,165
Iowa,Ringgold County,14,333,161,172
Iowa,Ringgold County,15,271,140,131
Iowa,Ringgold County,16,216,90,126
Iowa,Ringgold County,17,193,73,120
Iowa,Ringgold County,18,265,79,186
Iowa,Sac County,0,10035,4926,5109
Iowa,Sac County,1,545,306,239
Iowa,Sac County,2,648,337,311
Iowa,Sac County,3,635,310,325
Iowa,Sac County,4,606,297,309
Iowa,Sac County,5,502,260,242
Iowa,Sac County,6,457,235,222
Iowa,Sac County,7,489,253,236
Iowa,Sac County,8,484,247,237
Iowa,Sac County,9,515,254,261
Iowa,Sac County,10,581,284,297
Iowa,Sac County,11,770,390,380
Iowa,Sac County,12,825,429,396
Iowa,Sac County,13,745,382,363
Iowa,Sac County,14,548,262,286
Iowa,Sac County,15,434,212,222
Iowa,Sac County,16,412,186,226
Iowa,Sac County,17,358,143,215
Iowa,Sac County,18,481,139,342
Iowa,Scott County,0,171387,84062,87325
Iowa,Scott County,1,11252,5764,5488
Iowa,Scott County,2,11643,5847,5796
Iowa,Scott County,3,11553,5868,5685
Iowa,Scott County,4,11080,5703,5377
Iowa,Scott County,5,10532,5133,5399
Iowa,Scott County,6,11529,5682,5847
Iowa,Scott County,7,11961,5960,6001
Iowa,Scott County,8,10819,5429,5390
Iowa,Scott County,9,10649,5353,5296
Iowa,Scott County,10,11021,5548,5473
Iowa,Scott County,11,12176,5954,6222
Iowa,Scott County,12,12043,5889,6154
Iowa,Scott County,13,10487,5151,5336
Iowa,Scott County,14,8290,3991,4299
Iowa,Scott County,15,5600,2609,2991
Iowa,Scott County,16,4146,1812,2334
Iowa,Scott County,17,3045,1234,1811
Iowa,Scott County,18,3561,1135,2426
Iowa,Shelby County,0,11948,5881,6067
Iowa,Shelby County,1,671,338,333
Iowa,Shelby County,2,707,368,339
Iowa,Shelby County,3,843,445,398
Iowa,Shelby County,4,767,391,376
Iowa,Shelby County,5,595,297,298
Iowa,Shelby County,6,476,233,243
Iowa,Shelby County,7,520,271,249
Iowa,Shelby County,8,578,262,316
Iowa,Shelby County,9,631,334,297
Iowa,Shelby County,10,746,365,381
Iowa,Shelby County,11,993,485,508
Iowa,Shelby County,12,952,509,443
Iowa,Shelby County,13,792,393,399
Iowa,Shelby County,14,705,342,363
Iowa,Shelby County,15,528,261,267
Iowa,Shelby County,16,488,224,264
Iowa,Shelby County,17,414,162,252
Iowa,Shelby County,18,542,201,341
Iowa,Sioux County,0,34681,17421,17260
Iowa,Sioux County,1,2574,1400,1174
Iowa,Sioux County,2,2726,1339,1387
Iowa,Sioux County,3,2581,1327,1254
Iowa,Sioux County,4,3015,1464,1551
Iowa,Sioux County,5,3249,1725,1524
Iowa,Sioux County,6,1868,968,900
Iowa,Sioux County,7,2151,1132,1019
Iowa,Sioux County,8,1927,1006,921
Iowa,Sioux County,9,1680,846,834
Iowa,Sioux County,10,1799,928,871
Iowa,Sioux County,11,2072,1097,975
Iowa,Sioux County,12,2125,1055,1070
Iowa,Sioux County,13,1879,949,930
Iowa,Sioux County,14,1288,643,645
Iowa,Sioux County,15,1096,490,606
Iowa,Sioux County,16,916,413,503
Iowa,Sioux County,17,763,297,466
Iowa,Sioux County,18,972,342,630
Iowa,Story County,0,94073,48866,45207
Iowa,Story County,1,4574,2363,2211
Iowa,Story County,2,4547,2319,2228
Iowa,Story County,3,4418,2312,2106
Iowa,Story County,4,10724,5568,5156
Iowa,Story County,5,20675,11661,9014
Iowa,Story County,6,6963,3909,3054
Iowa,Story County,7,5520,2895,2625
Iowa,Story County,8,4685,2468,2217
Iowa,Story County,9,4074,2154,1920
Iowa,Story County,10,4170,2095,2075
Iowa,Story County,11,4494,2173,2321
Iowa,Story County,12,4686,2298,2388
Iowa,Story County,13,4485,2194,2291
Iowa,Story County,14,3042,1502,1540
Iowa,Story County,15,2298,1079,1219
Iowa,Story County,16,1782,805,977
Iowa,Story County,17,1304,537,767
Iowa,Story County,18,1632,534,1098
Iowa,Tama County,0,17451,8563,8888
Iowa,Tama County,1,1040,477,563
Iowa,Tama County,2,1132,536,596
Iowa,Tama County,3,1262,674,588
Iowa,Tama County,4,1207,615,592
Iowa,Tama County,5,936,475,461
Iowa,Tama County,6,796,400,396
Iowa,Tama County,7,906,454,452
Iowa,Tama County,8,937,461,476
Iowa,Tama County,9,975,495,480
Iowa,Tama County,10,1144,571,573
Iowa,Tama County,11,1245,608,637
Iowa,Tama County,12,1365,695,670
Iowa,Tama County,13,1162,594,568
Iowa,Tama County,14,932,468,464
Iowa,Tama County,15,733,351,382
Iowa,Tama County,16,621,291,330
Iowa,Tama County,17,487,214,273
Iowa,Tama County,18,571,184,387
Iowa,Taylor County,0,6143,3113,3030
Iowa,Taylor County,1,389,235,154
Iowa,Taylor County,2,397,205,192
Iowa,Taylor County,3,368,197,171
Iowa,Taylor County,4,396,209,187
Iowa,Taylor County,5,289,144,145
Iowa,Taylor County,6,321,157,164
Iowa,Taylor County,7,396,221,175
Iowa,Taylor County,8,287,139,148
Iowa,Taylor County,9,312,153,159
Iowa,Taylor County,10,352,194,158
Iowa,Taylor County,11,465,221,244
Iowa,Taylor County,12,429,212,217
Iowa,Taylor County,13,448,228,220
Iowa,Taylor County,14,363,185,178
Iowa,Taylor County,15,276,135,141
Iowa,Taylor County,16,237,105,132
Iowa,Taylor County,17,174,72,102
Iowa,Taylor County,18,244,101,143
Iowa,Union County,0,12516,6096,6420
Iowa,Union County,1,763,365,398
Iowa,Union County,2,850,460,390
Iowa,Union County,3,786,399,387
Iowa,Union County,4,837,411,426
Iowa,Union County,5,772,396,376
Iowa,Union County,6,647,325,322
Iowa,Union County,7,772,372,400
Iowa,Union County,8,687,344,343
Iowa,Union County,9,709,343,366
Iowa,Union County,10,695,349,346
Iowa,Union County,11,905,452,453
Iowa,Union County,12,894,430,464
Iowa,Union County,13,829,401,428
Iowa,Union County,14,698,341,357
Iowa,Union County,15,542,247,295
Iowa,Union County,16,423,212,211
Iowa,Union County,17,339,122,217
Iowa,Union County,18,368,127,241
Iowa,Van Buren County,0,7468,3792,3676
Iowa,Van Buren County,1,497,279,218
Iowa,Van Buren County,2,470,249,221
Iowa,Van Buren County,3,487,267,220
Iowa,Van Buren County,4,428,222,206
Iowa,Van Buren County,5,360,182,178
Iowa,Van Buren County,6,324,154,170
Iowa,Van Buren County,7,417,214,203
Iowa,Van Buren County,8,380,200,180
Iowa,Van Buren County,9,421,219,202
Iowa,Van Buren County,10,431,215,216
Iowa,Van Buren County,11,557,278,279
Iowa,Van Buren County,12,575,298,277
Iowa,Van Buren County,13,570,287,283
Iowa,Van Buren County,14,449,226,223
Iowa,Van Buren County,15,367,181,186
Iowa,Van Buren County,16,304,135,169
Iowa,Van Buren County,17,196,97,99
Iowa,Van Buren County,18,235,89,146
Iowa,Wapello County,0,35212,17408,17804
Iowa,Wapello County,1,2119,1134,985
Iowa,Wapello County,2,2293,1144,1149
Iowa,Wapello County,3,2205,1112,1093
Iowa,Wapello County,4,2203,1141,1062
Iowa,Wapello County,5,2301,1196,1105
Iowa,Wapello County,6,2214,1143,1071
Iowa,Wapello County,7,2179,1139,1040
Iowa,Wapello County,8,1989,1003,986
Iowa,Wapello County,9,2058,1083,975
Iowa,Wapello County,10,2132,1060,1072
Iowa,Wapello County,11,2544,1238,1306
Iowa,Wapello County,12,2641,1273,1368
Iowa,Wapello County,13,2350,1160,1190
Iowa,Wapello County,14,1810,864,946
Iowa,Wapello County,15,1345,613,732
Iowa,Wapello County,16,1046,454,592
Iowa,Wapello County,17,840,334,506
Iowa,Wapello County,18,943,317,626
Iowa,Warren County,0,47956,23605,24351
Iowa,Warren County,1,2857,1514,1343
Iowa,Warren County,2,3399,1760,1639
Iowa,Warren County,3,3585,1865,1720
Iowa,Warren County,4,3742,1886,1856
Iowa,Warren County,5,3072,1527,1545
Iowa,Warren County,6,2327,1118,1209
Iowa,Warren County,7,2845,1388,1457
Iowa,Warren County,8,2904,1467,1437
Iowa,Warren County,9,3157,1529,1628
Iowa,Warren County,10,3229,1601,1628
Iowa,Warren County,11,3651,1772,1879
Iowa,Warren County,12,3215,1564,1651
Iowa,Warren County,13,2847,1442,1405
Iowa,Warren County,14,2364,1133,1231
Iowa,Warren County,15,1700,826,874
Iowa,Warren County,16,1219,519,700
Iowa,Warren County,17,945,417,528
Iowa,Warren County,18,898,277,621
Iowa,Washington County,0,22070,10865,11205
Iowa,Washington County,1,1458,755,703
Iowa,Washington County,2,1489,739,750
Iowa,Washington County,3,1588,845,743
Iowa,Washington County,4,1422,701,721
Iowa,Washington County,5,1177,626,551
Iowa,Washington County,6,1104,536,568
Iowa,Washington County,7,1275,637,638
Iowa,Washington County,8,1232,616,616
Iowa,Washington County,9,1220,594,626
Iowa,Washington County,10,1433,716,717
Iowa,Washington County,11,1597,800,797
Iowa,Washington County,12,1562,785,777
Iowa,Washington County,13,1434,702,732
Iowa,Washington County,14,1201,595,606
Iowa,Washington County,15,871,415,456
Iowa,Washington County,16,706,339,367
Iowa,Washington County,17,589,242,347
Iowa,Washington County,18,712,222,490
Iowa,Wayne County,0,6395,3093,3302
Iowa,Wayne County,1,446,209,237
Iowa,Wayne County,2,423,197,226
Iowa,Wayne County,3,446,212,234
Iowa,Wayne County,4,357,172,185
Iowa,Wayne County,5,342,170,172
Iowa,Wayne County,6,321,146,175
Iowa,Wayne County,7,337,181,156
Iowa,Wayne County,8,268,139,129
Iowa,Wayne County,9,319,162,157
Iowa,Wayne County,10,331,184,147
Iowa,Wayne County,11,489,247,242
Iowa,Wayne County,12,497,270,227
Iowa,Wayne County,13,390,203,187
Iowa,Wayne County,14,345,177,168
Iowa,Wayne County,15,361,146,215
Iowa,Wayne County,16,257,112,145
Iowa,Wayne County,17,220,86,134
Iowa,Wayne County,18,246,80,166
Iowa,Webster County,0,36955,19161,17794
Iowa,Webster County,1,2143,1110,1033
Iowa,Webster County,2,2124,1102,1022
Iowa,Webster County,3,2248,1211,1037
Iowa,Webster County,4,2753,1545,1208
Iowa,Webster County,5,2946,1817,1129
Iowa,Webster County,6,2279,1346,933
Iowa,Webster County,7,2228,1211,1017
Iowa,Webster County,8,1928,1006,922
Iowa,Webster County,9,1896,961,935
Iowa,Webster County,10,2127,1128,999
Iowa,Webster County,11,2655,1330,1325
Iowa,Webster County,12,2815,1417,1398
Iowa,Webster County,13,2442,1189,1253
Iowa,Webster County,14,1879,894,985
Iowa,Webster County,15,1376,640,736
Iowa,Webster County,16,1154,506,648
Iowa,Webster County,17,974,411,563
Iowa,Webster County,18,988,337,651
Iowa,Winnebago County,0,10559,5130,5429
Iowa,Winnebago County,1,551,232,319
Iowa,Winnebago County,2,632,301,331
Iowa,Winnebago County,3,667,320,347
Iowa,Winnebago County,4,711,394,317
Iowa,Winnebago County,5,658,368,290
Iowa,Winnebago County,6,551,258,293
Iowa,Winnebago County,7,559,303,256
Iowa,Winnebago County,8,507,252,255
Iowa,Winnebago County,9,591,286,305
Iowa,Winnebago County,10,574,295,279
Iowa,Winnebago County,11,765,384,381
Iowa,Winnebago County,12,841,418,423
Iowa,Winnebago County,13,795,418,377
Iowa,Winnebago County,14,545,276,269
Iowa,Winnebago County,15,457,201,256
Iowa,Winnebago County,16,383,160,223
Iowa,Winnebago County,17,334,135,199
Iowa,Winnebago County,18,438,129,309
Iowa,Winneshiek County,0,20768,10276,10492
Iowa,Winneshiek County,1,894,450,444
Iowa,Winneshiek County,2,1152,573,579
Iowa,Winneshiek County,3,1156,613,543
Iowa,Winneshiek County,4,1953,929,1024
Iowa,Winneshiek County,5,2177,1057,1120
Iowa,Winneshiek County,6,984,522,462
Iowa,Winneshiek County,7,1029,524,505
Iowa,Winneshiek County,8,979,509,470
Iowa,Winneshiek County,9,983,494,489
Iowa,Winneshiek County,10,1211,624,587
Iowa,Winneshiek County,11,1494,739,755
Iowa,Winneshiek County,12,1631,878,753
Iowa,Winneshiek County,13,1358,675,683
Iowa,Winneshiek County,14,1050,522,528
Iowa,Winneshiek County,15,807,382,425
Iowa,Winneshiek County,16,693,313,380
Iowa,Winneshiek County,17,530,226,304
Iowa,Winneshiek County,18,687,246,441
Iowa,Woodbury County,0,102271,50666,51605
Iowa,Woodbury County,1,7508,3868,3640
Iowa,Woodbury County,2,7651,3933,3718
Iowa,Woodbury County,3,7252,3703,3549
Iowa,Woodbury County,4,7264,3726,3538
Iowa,Woodbury County,5,7364,3781,3583
Iowa,Woodbury County,6,6625,3355,3270
Iowa,Woodbury County,7,6656,3380,3276
Iowa,Woodbury County,8,6074,3046,3028
Iowa,Woodbury County,9,6151,3041,3110
Iowa,Woodbury County,10,6059,3022,3037
Iowa,Woodbury County,11,6914,3481,3433
Iowa,Woodbury County,12,6605,3241,3364
Iowa,Woodbury County,13,6034,2973,3061
Iowa,Woodbury County,14,4514,2145,2369
Iowa,Woodbury County,15,3236,1513,1723
Iowa,Woodbury County,16,2429,1070,1359
Iowa,Woodbury County,17,1863,694,1169
Iowa,Woodbury County,18,2072,694,1378
Iowa,Worth County,0,7624,3799,3825
Iowa,Worth County,1,390,193,197
Iowa,Worth County,2,444,224,220
Iowa,Worth County,3,479,229,250
Iowa,Worth County,4,530,266,264
Iowa,Worth County,5,418,221,197
Iowa,Worth County,6,320,156,164
Iowa,Worth County,7,444,242,202
Iowa,Worth County,8,379,196,183
Iowa,Worth County,9,458,221,237
Iowa,Worth County,10,472,239,233
Iowa,Worth County,11,628,339,289
Iowa,Worth County,12,618,325,293
Iowa,Worth County,13,533,261,272
Iowa,Worth County,14,439,225,214
Iowa,Worth County,15,354,180,174
Iowa,Worth County,16,268,132,136
Iowa,Worth County,17,201,74,127
Iowa,Worth County,18,249,76,173
Iowa,Wright County,0,12840,6477,6363
Iowa,Wright County,1,734,391,343
Iowa,Wright County,2,852,429,423
Iowa,Wright County,3,874,444,430
Iowa,Wright County,4,757,399,358
Iowa,Wright County,5,642,348,294
Iowa,Wright County,6,599,320,279
Iowa,Wright County,7,682,363,319
Iowa,Wright County,8,681,328,353
Iowa,Wright County,9,701,373,328
Iowa,Wright County,10,721,388,333
Iowa,Wright County,11,912,455,457
Iowa,Wright County,12,1029,531,498
Iowa,Wright County,13,916,479,437
Iowa,Wright County,14,692,336,356
Iowa,Wright County,15,569,268,301
Iowa,Wright County,16,492,238,254
Iowa,Wright County,17,449,195,254
Iowa,Wright County,18,538,192,346
Kansas,Allen County,0,12909,6312,6597
Kansas,Allen County,1,776,385,391
Kansas,Allen County,2,842,419,423
Kansas,Allen County,3,886,452,434
Kansas,Allen County,4,929,495,434
Kansas,Allen County,5,784,421,363
Kansas,Allen County,6,640,325,315
Kansas,Allen County,7,778,367,411
Kansas,Allen County,8,705,356,349
Kansas,Allen County,9,728,389,339
Kansas,Allen County,10,704,340,364
Kansas,Allen County,11,904,449,455
Kansas,Allen County,12,911,427,484
Kansas,Allen County,13,874,405,469
Kansas,Allen County,14,681,321,360
Kansas,Allen County,15,546,265,281
Kansas,Allen County,16,450,199,251
Kansas,Allen County,17,340,145,195
Kansas,Allen County,18,431,152,279
Kansas,Anderson County,0,7883,3896,3987
Kansas,Anderson County,1,489,239,250
Kansas,Anderson County,2,586,305,281
Kansas,Anderson County,3,570,286,284
Kansas,Anderson County,4,513,270,243
Kansas,Anderson County,5,416,219,197
Kansas,Anderson County,6,365,176,189
Kansas,Anderson County,7,441,221,220
Kansas,Anderson County,8,412,201,211
Kansas,Anderson County,9,407,202,205
Kansas,Anderson County,10,457,217,240
Kansas,Anderson County,11,558,298,260
Kansas,Anderson County,12,544,255,289
Kansas,Anderson County,13,498,273,225
Kansas,Anderson County,14,448,218,230
Kansas,Anderson County,15,411,187,224
Kansas,Anderson County,16,324,157,167
Kansas,Anderson County,17,199,76,123
Kansas,Anderson County,18,245,96,149
Kansas,Atchison County,0,16513,8035,8478
Kansas,Atchison County,1,1050,543,507
Kansas,Atchison County,2,1057,545,512
Kansas,Atchison County,3,1102,582,520
Kansas,Atchison County,4,1489,733,756
Kansas,Atchison County,5,1483,679,804
Kansas,Atchison County,6,951,484,467
Kansas,Atchison County,7,877,437,440
Kansas,Atchison County,8,821,426,395
Kansas,Atchison County,9,882,441,441
Kansas,Atchison County,10,958,468,490
Kansas,Atchison County,11,1097,554,543
Kansas,Atchison County,12,1171,564,607
Kansas,Atchison County,13,888,442,446
Kansas,Atchison County,14,775,357,418
Kansas,Atchison County,15,625,288,337
Kansas,Atchison County,16,489,199,290
Kansas,Atchison County,17,404,163,241
Kansas,Atchison County,18,394,130,264
Kansas,Barber County,0,4897,2508,2389
Kansas,Barber County,1,337,175,162
Kansas,Barber County,2,319,172,147
Kansas,Barber County,3,272,135,137
Kansas,Barber County,4,271,147,124
Kansas,Barber County,5,273,153,120
Kansas,Barber County,6,291,151,140
Kansas,Barber County,7,277,154,123
Kansas,Barber County,8,216,103,113
Kansas,Barber County,9,243,123,120
Kansas,Barber County,10,242,121,121
Kansas,Barber County,11,382,208,174
Kansas,Barber County,12,416,211,205
Kansas,Barber County,13,363,191,172
Kansas,Barber County,14,312,157,155
Kansas,Barber County,15,229,117,112
Kansas,Barber County,16,166,69,97
Kansas,Barber County,17,137,60,77
Kansas,Barber County,18,151,61,90
Kansas,Barton County,0,27385,13553,13832
Kansas,Barton County,1,1896,951,945
Kansas,Barton County,2,1904,950,954
Kansas,Barton County,3,1809,943,866
Kansas,Barton County,4,1879,981,898
Kansas,Barton County,5,1750,913,837
Kansas,Barton County,6,1563,801,762
Kansas,Barton County,7,1711,878,833
Kansas,Barton County,8,1423,761,662
Kansas,Barton County,9,1363,646,717
Kansas,Barton County,10,1486,726,760
Kansas,Barton County,11,2030,992,1038
Kansas,Barton County,12,2077,1026,1051
Kansas,Barton County,13,1752,876,876
Kansas,Barton County,14,1330,677,653
Kansas,Barton County,15,1030,491,539
Kansas,Barton County,16,849,376,473
Kansas,Barton County,17,733,285,448
Kansas,Barton County,18,800,280,520
Kansas,Bourbon County,0,14772,7296,7476
Kansas,Bourbon County,1,1001,524,477
Kansas,Bourbon County,2,1047,511,536
Kansas,Bourbon County,3,1051,564,487
Kansas,Bourbon County,4,1048,566,482
Kansas,Bourbon County,5,996,567,429
Kansas,Bourbon County,6,806,423,383
Kansas,Bourbon County,7,849,412,437
Kansas,Bourbon County,8,820,426,394
Kansas,Bourbon County,9,745,355,390
Kansas,Bourbon County,10,703,346,357
Kansas,Bourbon County,11,1001,493,508
Kansas,Bourbon County,12,981,469,512
Kansas,Bourbon County,13,990,452,538
Kansas,Bourbon County,14,808,402,406
Kansas,Bourbon County,15,629,311,318
Kansas,Bourbon County,16,448,183,265
Kansas,Bourbon County,17,380,132,248
Kansas,Bourbon County,18,469,160,309
Kansas,Brown County,0,9815,4789,5026
Kansas,Brown County,1,684,353,331
Kansas,Brown County,2,712,358,354
Kansas,Brown County,3,699,346,353
Kansas,Brown County,4,607,314,293
Kansas,Brown County,5,530,285,245
Kansas,Brown County,6,486,239,247
Kansas,Brown County,7,564,284,280
Kansas,Brown County,8,504,267,237
Kansas,Brown County,9,484,220,264
Kansas,Brown County,10,548,289,259
Kansas,Brown County,11,697,332,365
Kansas,Brown County,12,765,353,412
Kansas,Brown County,13,671,336,335
Kansas,Brown County,14,564,270,294
Kansas,Brown County,15,434,214,220
Kansas,Brown County,16,299,123,176
Kansas,Brown County,17,263,110,153
Kansas,Brown County,18,304,96,208
Kansas,Butler County,0,66227,33258,32969
Kansas,Butler County,1,3942,2006,1936
Kansas,Butler County,2,4756,2383,2373
Kansas,Butler County,3,5232,2688,2544
Kansas,Butler County,4,5175,2667,2508
Kansas,Butler County,5,4152,2309,1843
Kansas,Butler County,6,3730,1970,1760
Kansas,Butler County,7,3979,2043,1936
Kansas,Butler County,8,4103,2082,2021
Kansas,Butler County,9,4061,2020,2041
Kansas,Butler County,10,4251,2151,2100
Kansas,Butler County,11,4867,2400,2467
Kansas,Butler County,12,4841,2464,2377
Kansas,Butler County,13,3854,1907,1947
Kansas,Butler County,14,2992,1524,1468
Kansas,Butler County,15,2051,973,1078
Kansas,Butler County,16,1643,717,926
Kansas,Butler County,17,1250,511,739
Kansas,Butler County,18,1348,443,905
Kansas,Chase County,0,2692,1358,1334
Kansas,Chase County,1,120,60,60
Kansas,Chase County,2,160,78,82
Kansas,Chase County,3,172,76,96
Kansas,Chase County,4,177,92,85
Kansas,Chase County,5,147,88,59
Kansas,Chase County,6,121,73,48
Kansas,Chase County,7,131,73,58
Kansas,Chase County,8,134,75,59
Kansas,Chase County,9,160,84,76
Kansas,Chase County,10,158,74,84
Kansas,Chase County,11,199,104,95
Kansas,Chase County,12,194,89,105
Kansas,Chase County,13,197,109,88
Kansas,Chase County,14,198,97,101
Kansas,Chase County,15,152,79,73
Kansas,Chase County,16,96,48,48
Kansas,Chase County,17,85,29,56
Kansas,Chase County,18,91,30,61
Kansas,Chautauqua County,0,3481,1801,1680
Kansas,Chautauqua County,1,190,114,76
Kansas,Chautauqua County,2,201,112,89
Kansas,Chautauqua County,3,195,99,96
Kansas,Chautauqua County,4,197,107,90
Kansas,Chautauqua County,5,175,96,79
Kansas,Chautauqua County,6,168,93,75
Kansas,Chautauqua County,7,193,95,98
Kansas,Chautauqua County,8,153,84,69
Kansas,Chautauqua County,9,153,71,82
Kansas,Chautauqua County,10,176,93,83
Kansas,Chautauqua County,11,266,143,123
Kansas,Chautauqua County,12,269,133,136
Kansas,Chautauqua County,13,246,116,130
Kansas,Chautauqua County,14,250,122,128
Kansas,Chautauqua County,15,215,110,105
Kansas,Chautauqua County,16,186,100,86
Kansas,Chautauqua County,17,115,59,56
Kansas,Chautauqua County,18,133,54,79
Kansas,Cherokee County,0,20787,10304,10483
Kansas,Cherokee County,1,1188,625,563
Kansas,Cherokee County,2,1419,708,711
Kansas,Cherokee County,3,1526,801,725
Kansas,Cherokee County,4,1409,713,696
Kansas,Cherokee County,5,1066,554,512
Kansas,Cherokee County,6,1078,550,528
Kansas,Cherokee County,7,1214,621,593
Kansas,Cherokee County,8,1147,554,593
Kansas,Cherokee County,9,1261,626,635
Kansas,Cherokee County,10,1390,696,694
Kansas,Cherokee County,11,1578,793,785
Kansas,Cherokee County,12,1516,747,769
Kansas,Cherokee County,13,1322,644,678
Kansas,Cherokee County,14,1212,587,625
Kansas,Cherokee County,15,933,436,497
Kansas,Cherokee County,16,672,322,350
Kansas,Cherokee County,17,423,173,250
Kansas,Cherokee County,18,433,154,279
Kansas,Cheyenne County,0,2693,1325,1368
Kansas,Cheyenne County,1,136,62,74
Kansas,Cheyenne County,2,145,71,74
Kansas,Cheyenne County,3,177,102,75
Kansas,Cheyenne County,4,152,87,65
Kansas,Cheyenne County,5,119,73,46
Kansas,Cheyenne County,6,112,54,58
Kansas,Cheyenne County,7,144,70,74
Kansas,Cheyenne County,8,132,63,69
Kansas,Cheyenne County,9,126,69,57
Kansas,Cheyenne County,10,129,63,66
Kansas,Cheyenne County,11,178,84,94
Kansas,Cheyenne County,12,242,122,120
Kansas,Cheyenne County,13,187,91,96
Kansas,Cheyenne County,14,191,101,90
Kansas,Cheyenne County,15,137,60,77
Kansas,Cheyenne County,16,115,54,61
Kansas,Cheyenne County,17,118,44,74
Kansas,Cheyenne County,18,153,55,98
Kansas,Clark County,0,2144,1051,1093
Kansas,Clark County,1,158,85,73
Kansas,Clark County,2,154,93,61
Kansas,Clark County,3,164,76,88
Kansas,Clark County,4,161,81,80
Kansas,Clark County,5,92,59,33
Kansas,Clark County,6,96,47,49
Kansas,Clark County,7,101,50,51
Kansas,Clark County,8,121,66,55
Kansas,Clark County,9,111,48,63
Kansas,Clark County,10,112,53,59
Kansas,Clark County,11,165,82,83
Kansas,Clark County,12,137,64,73
Kansas,Clark County,13,125,59,66
Kansas,Clark County,14,107,52,55
Kansas,Clark County,15,92,41,51
Kansas,Clark County,16,87,42,45
Kansas,Clark County,17,73,27,46
Kansas,Clark County,18,88,26,62
Kansas,Clay County,0,8317,4135,4182
Kansas,Clay County,1,536,274,262
Kansas,Clay County,2,546,276,270
Kansas,Clay County,3,511,263,248
Kansas,Clay County,4,517,271,246
Kansas,Clay County,5,387,202,185
Kansas,Clay County,6,418,232,186
Kansas,Clay County,7,481,243,238
Kansas,Clay County,8,491,251,240
Kansas,Clay County,9,463,246,217
Kansas,Clay County,10,460,229,231
Kansas,Clay County,11,542,260,282
Kansas,Clay County,12,581,293,288
Kansas,Clay County,13,563,277,286
Kansas,Clay County,14,526,255,271
Kansas,Clay County,15,398,192,206
Kansas,Clay County,16,309,142,167
Kansas,Clay County,17,241,90,151
Kansas,Clay County,18,347,139,208
Kansas,Cloud County,0,9385,4620,4765
Kansas,Cloud County,1,622,333,289
Kansas,Cloud County,2,586,314,272
Kansas,Cloud County,3,588,304,284
Kansas,Cloud County,4,680,343,337
Kansas,Cloud County,5,631,347,284
Kansas,Cloud County,6,517,265,252
Kansas,Cloud County,7,546,285,261
Kansas,Cloud County,8,445,228,217
Kansas,Cloud County,9,435,219,216
Kansas,Cloud County,10,531,254,277
Kansas,Cloud County,11,618,317,301
Kansas,Cloud County,12,627,332,295
Kansas,Cloud County,13,581,273,308
Kansas,Cloud County,14,535,261,274
Kansas,Cloud County,15,419,192,227
Kansas,Cloud County,16,352,149,203
Kansas,Cloud County,17,287,96,191
Kansas,Cloud County,18,385,108,277
Kansas,Coffey County,0,8433,4188,4245
Kansas,Coffey County,1,397,225,172
Kansas,Coffey County,2,521,266,255
Kansas,Coffey County,3,575,287,288
Kansas,Coffey County,4,591,308,283
Kansas,Coffey County,5,421,226,195
Kansas,Coffey County,6,420,215,205
Kansas,Coffey County,7,465,227,238
Kansas,Coffey County,8,424,210,214
Kansas,Coffey County,9,483,232,251
Kansas,Coffey County,10,534,265,269
Kansas,Coffey County,11,676,329,347
Kansas,Coffey County,12,691,354,337
Kansas,Coffey County,13,604,303,301
Kansas,Coffey County,14,502,252,250
Kansas,Coffey County,15,417,200,217
Kansas,Coffey County,16,288,134,154
Kansas,Coffey County,17,203,83,120
Kansas,Coffey County,18,221,72,149
Kansas,Comanche County,0,1954,956,998
Kansas,Comanche County,1,148,81,67
Kansas,Comanche County,2,130,62,68
Kansas,Comanche County,3,144,68,76
Kansas,Comanche County,4,125,55,70
Kansas,Comanche County,5,73,36,37
Kansas,Comanche County,6,88,45,43
Kansas,Comanche County,7,97,41,56
Kansas,Comanche County,8,103,54,49
Kansas,Comanche County,9,107,57,50
Kansas,Comanche County,10,82,39,43
Kansas,Comanche County,11,133,71,62
Kansas,Comanche County,12,147,72,75
Kansas,Comanche County,13,129,62,67
Kansas,Comanche County,14,126,58,68
Kansas,Comanche County,15,113,48,65
Kansas,Comanche County,16,83,45,38
Kansas,Comanche County,17,67,36,31
Kansas,Comanche County,18,59,26,33
Kansas,Cowley County,0,35963,18027,17936
Kansas,Cowley County,1,2360,1214,1146
Kansas,Cowley County,2,2374,1207,1167
Kansas,Cowley County,3,2440,1260,1180
Kansas,Cowley County,4,2625,1314,1311
Kansas,Cowley County,5,2584,1364,1220
Kansas,Cowley County,6,2168,1121,1047
Kansas,Cowley County,7,2092,1067,1025
Kansas,Cowley County,8,1959,1034,925
Kansas,Cowley County,9,2027,1059,968
Kansas,Cowley County,10,2079,1075,1004
Kansas,Cowley County,11,2480,1252,1228
Kansas,Cowley County,12,2445,1237,1208
Kansas,Cowley County,13,2207,1092,1115
Kansas,Cowley County,14,1853,887,966
Kansas,Cowley County,15,1437,702,735
Kansas,Cowley County,16,1071,484,587
Kansas,Cowley County,17,800,316,484
Kansas,Cowley County,18,962,342,620
Kansas,Crawford County,0,39290,19690,19600
Kansas,Crawford County,1,2422,1272,1150
Kansas,Crawford County,2,2352,1202,1150
Kansas,Crawford County,3,2376,1250,1126
Kansas,Crawford County,4,3146,1619,1527
Kansas,Crawford County,5,5490,2923,2567
Kansas,Crawford County,6,2410,1364,1046
Kansas,Crawford County,7,2456,1228,1228
Kansas,Crawford County,8,2019,1041,978
Kansas,Crawford County,9,2023,989,1034
Kansas,Crawford County,10,2033,1055,978
Kansas,Crawford County,11,2348,1174,1174
Kansas,Crawford County,12,2322,1112,1210
Kansas,Crawford County,13,2096,1017,1079
Kansas,Crawford County,14,1750,856,894
Kansas,Crawford County,15,1329,594,735
Kansas,Crawford County,16,991,427,564
Kansas,Crawford County,17,754,287,467
Kansas,Crawford County,18,973,280,693
Kansas,Decatur County,0,2908,1471,1437
Kansas,Decatur County,1,187,104,83
Kansas,Decatur County,2,143,82,61
Kansas,Decatur County,3,157,72,85
Kansas,Decatur County,4,154,78,76
Kansas,Decatur County,5,111,60,51
Kansas,Decatur County,6,146,75,71
Kansas,Decatur County,7,142,81,61
Kansas,Decatur County,8,124,65,59
Kansas,Decatur County,9,104,53,51
Kansas,Decatur County,10,159,84,75
Kansas,Decatur County,11,205,109,96
Kansas,Decatur County,12,256,134,122
Kansas,Decatur County,13,232,119,113
Kansas,Decatur County,14,190,99,91
Kansas,Decatur County,15,157,81,76
Kansas,Decatur County,16,139,71,68
Kansas,Decatur County,17,131,52,79
Kansas,Decatur County,18,171,52,119
Kansas,Dickinson County,0,19394,9680,9714
Kansas,Dickinson County,1,1228,637,591
Kansas,Dickinson County,2,1275,662,613
Kansas,Dickinson County,3,1344,677,667
Kansas,Dickinson County,4,1289,686,603
Kansas,Dickinson County,5,1045,547,498
Kansas,Dickinson County,6,1028,502,526
Kansas,Dickinson County,7,1145,604,541
Kansas,Dickinson County,8,1106,560,546
Kansas,Dickinson County,9,1120,561,559
Kansas,Dickinson County,10,1145,581,564
Kansas,Dickinson County,11,1429,691,738
Kansas,Dickinson County,12,1454,746,708
Kansas,Dickinson County,13,1208,620,588
Kansas,Dickinson County,14,963,472,491
Kansas,Dickinson County,15,797,395,402
Kansas,Dickinson County,16,661,304,357
Kansas,Dickinson County,17,500,202,298
Kansas,Dickinson County,18,657,233,424
Kansas,Doniphan County,0,7874,3981,3893
Kansas,Doniphan County,1,448,234,214
Kansas,Doniphan County,2,471,210,261
Kansas,Doniphan County,3,495,267,228
Kansas,Doniphan County,4,698,376,322
Kansas,Doniphan County,5,571,330,241
Kansas,Doniphan County,6,423,205,218
Kansas,Doniphan County,7,462,238,224
Kansas,Doniphan County,8,425,222,203
Kansas,Doniphan County,9,444,223,221
Kansas,Doniphan County,10,446,206,240
Kansas,Doniphan County,11,506,257,249
Kansas,Doniphan County,12,600,320,280
Kansas,Doniphan County,13,510,265,245
Kansas,Doniphan County,14,432,222,210
Kansas,Doniphan County,15,309,146,163
Kansas,Doniphan County,16,234,116,118
Kansas,Doniphan County,17,173,63,110
Kansas,Doniphan County,18,227,81,146
Kansas,Douglas County,0,116585,58214,58371
Kansas,Douglas County,1,6106,3091,3015
Kansas,Douglas County,2,6298,3293,3005
Kansas,Douglas County,3,6215,3206,3009
Kansas,Douglas County,4,10524,5118,5406
Kansas,Douglas County,5,21073,10785,10288
Kansas,Douglas County,6,9468,5101,4367
Kansas,Douglas County,7,8341,4356,3985
Kansas,Douglas County,8,6945,3606,3339
Kansas,Douglas County,9,6090,2993,3097
Kansas,Douglas County,10,5630,2814,2816
Kansas,Douglas County,11,6241,2989,3252
Kansas,Douglas County,12,6031,2820,3211
Kansas,Douglas County,13,5605,2713,2892
Kansas,Douglas County,14,4147,2006,2141
Kansas,Douglas County,15,2743,1267,1476
Kansas,Douglas County,16,1927,895,1032
Kansas,Douglas County,17,1403,587,816
Kansas,Douglas County,18,1798,574,1224
Kansas,Edwards County,0,3030,1506,1524
Kansas,Edwards County,1,199,95,104
Kansas,Edwards County,2,179,96,83
Kansas,Edwards County,3,207,96,111
Kansas,Edwards County,4,191,92,99
Kansas,Edwards County,5,157,77,80
Kansas,Edwards County,6,120,56,64
Kansas,Edwards County,7,171,87,84
Kansas,Edwards County,8,141,75,66
Kansas,Edwards County,9,177,87,90
Kansas,Edwards County,10,190,107,83
Kansas,Edwards County,11,226,113,113
Kansas,Edwards County,12,271,141,130
Kansas,Edwards County,13,217,116,101
Kansas,Edwards County,14,170,79,91
Kansas,Edwards County,15,116,65,51
Kansas,Edwards County,16,126,57,69
Kansas,Edwards County,17,93,40,53
Kansas,Edwards County,18,79,27,52
Kansas,Elk County,0,2694,1336,1358
Kansas,Elk County,1,111,61,50
Kansas,Elk County,2,180,92,88
Kansas,Elk County,3,154,74,80
Kansas,Elk County,4,155,81,74
Kansas,Elk County,5,124,67,57
Kansas,Elk County,6,112,62,50
Kansas,Elk County,7,118,59,59
Kansas,Elk County,8,104,49,55
Kansas,Elk County,9,133,73,60
Kansas,Elk County,10,155,67,88
Kansas,Elk County,11,186,90,96
Kansas,Elk County,12,212,105,107
Kansas,Elk County,13,216,109,107
Kansas,Elk County,14,222,109,113
Kansas,Elk County,15,166,79,87
Kansas,Elk County,16,147,76,71
Kansas,Elk County,17,107,50,57
Kansas,Elk County,18,92,33,59
Kansas,Ellis County,0,29013,14581,14432
Kansas,Ellis County,1,1997,1066,931
Kansas,Ellis County,2,1792,902,890
Kansas,Ellis County,3,1681,886,795
Kansas,Ellis County,4,2014,1009,1005
Kansas,Ellis County,5,3897,1942,1955
Kansas,Ellis County,6,2213,1213,1000
Kansas,Ellis County,7,1906,1004,902
Kansas,Ellis County,8,1521,783,738
Kansas,Ellis County,9,1382,731,651
Kansas,Ellis County,10,1398,684,714
Kansas,Ellis County,11,1714,837,877
Kansas,Ellis County,12,1849,929,920
Kansas,Ellis County,13,1647,828,819
Kansas,Ellis County,14,1125,568,557
Kansas,Ellis County,15,820,361,459
Kansas,Ellis County,16,671,287,384
Kansas,Ellis County,17,674,281,393
Kansas,Ellis County,18,712,270,442
Kansas,Ellsworth County,0,6392,3655,2737
Kansas,Ellsworth County,1,322,170,152
Kansas,Ellsworth County,2,323,173,150
Kansas,Ellsworth County,3,304,167,137
Kansas,Ellsworth County,4,317,182,135
Kansas,Ellsworth County,5,458,327,131
Kansas,Ellsworth County,6,432,315,117
Kansas,Ellsworth County,7,437,280,157
Kansas,Ellsworth County,8,353,214,139
Kansas,Ellsworth County,9,363,241,122
Kansas,Ellsworth County,10,404,249,155
Kansas,Ellsworth County,11,468,270,198
Kansas,Ellsworth County,12,508,256,252
Kansas,Ellsworth County,13,459,237,222
Kansas,Ellsworth County,14,340,180,160
Kansas,Ellsworth County,15,297,140,157
Kansas,Ellsworth County,16,197,95,102
Kansas,Ellsworth County,17,179,75,104
Kansas,Ellsworth County,18,231,84,147
Kansas,Finney County,0,37184,18972,18212
Kansas,Finney County,1,3545,1908,1637
Kansas,Finney County,2,3273,1692,1581
Kansas,Finney County,3,2903,1499,1404
Kansas,Finney County,4,3067,1592,1475
Kansas,Finney County,5,2829,1541,1288
Kansas,Finney County,6,2686,1363,1323
Kansas,Finney County,7,2474,1216,1258
Kansas,Finney County,8,2201,1144,1057
Kansas,Finney County,9,2123,1032,1091
Kansas,Finney County,10,2302,1171,1131
Kansas,Finney County,11,2421,1225,1196
Kansas,Finney County,12,2115,1065,1050
Kansas,Finney County,13,1736,882,854
Kansas,Finney County,14,1207,613,594
Kansas,Finney County,15,833,398,435
Kansas,Finney County,16,549,266,283
Kansas,Finney County,17,451,189,262
Kansas,Finney County,18,469,176,293
Kansas,Ford County,0,34795,17987,16808
Kansas,Ford County,1,3347,1694,1653
Kansas,Ford County,2,2989,1628,1361
Kansas,Ford County,3,2695,1396,1299
Kansas,Ford County,4,2561,1354,1207
Kansas,Ford County,5,2623,1406,1217
Kansas,Ford County,6,2576,1343,1233
Kansas,Ford County,7,2424,1324,1100
Kansas,Ford County,8,2185,1120,1065
Kansas,Ford County,9,2132,1104,1028
Kansas,Ford County,10,2070,1129,941
Kansas,Ford County,11,2126,1102,1024
Kansas,Ford County,12,1947,1002,945
Kansas,Ford County,13,1497,778,719
Kansas,Ford County,14,1136,564,572
Kansas,Ford County,15,755,349,406
Kansas,Ford County,16,605,269,336
Kansas,Ford County,17,504,207,297
Kansas,Ford County,18,623,218,405
Kansas,Franklin County,0,25611,12733,12878
Kansas,Franklin County,1,1610,801,809
Kansas,Franklin County,2,1781,932,849
Kansas,Franklin County,3,1890,987,903
Kansas,Franklin County,4,1823,960,863
Kansas,Franklin County,5,1603,820,783
Kansas,Franklin County,6,1465,730,735
Kansas,Franklin County,7,1535,757,778
Kansas,Franklin County,8,1404,722,682
Kansas,Franklin County,9,1486,737,749
Kansas,Franklin County,10,1564,773,791
Kansas,Franklin County,11,2040,1008,1032
Kansas,Franklin County,12,1900,971,929
Kansas,Franklin County,13,1564,757,807
Kansas,Franklin County,14,1247,623,624
Kansas,Franklin County,15,1007,476,531
Kansas,Franklin County,16,705,319,386
Kansas,Franklin County,17,480,198,282
Kansas,Franklin County,18,507,162,345
Kansas,Geary County,0,36713,19519,17194
Kansas,Geary County,1,4175,2149,2026
Kansas,Geary County,2,3262,1712,1550
Kansas,Geary County,3,2433,1271,1162
Kansas,Geary County,4,2124,1187,937
Kansas,Geary County,5,5349,3329,2020
Kansas,Geary County,6,4271,2345,1926
Kansas,Geary County,7,3304,1781,1523
Kansas,Geary County,8,2297,1185,1112
Kansas,Geary County,9,1786,943,843
Kansas,Geary County,10,1353,670,683
Kansas,Geary County,11,1335,664,671
Kansas,Geary County,12,1245,605,640
Kansas,Geary County,13,988,483,505
Kansas,Geary County,14,903,413,490
Kansas,Geary County,15,644,308,336
Kansas,Geary County,16,529,224,305
Kansas,Geary County,17,361,130,231
Kansas,Geary County,18,354,120,234
Kansas,Gove County,0,2727,1390,1337
Kansas,Gove County,1,185,114,71
Kansas,Gove County,2,191,100,91
Kansas,Gove County,3,176,89,87
Kansas,Gove County,4,151,70,81
Kansas,Gove County,5,145,75,70
Kansas,Gove County,6,128,73,55
Kansas,Gove County,7,151,80,71
Kansas,Gove County,8,135,72,63
Kansas,Gove County,9,122,64,58
Kansas,Gove County,10,115,61,54
Kansas,Gove County,11,192,101,91
Kansas,Gove County,12,220,114,106
Kansas,Gove County,13,182,96,86
Kansas,Gove County,14,175,88,87
Kansas,Gove County,15,107,45,62
Kansas,Gove County,16,126,62,64
Kansas,Gove County,17,103,46,57
Kansas,Gove County,18,123,40,83
Kansas,Graham County,0,2566,1273,1293
Kansas,Graham County,1,169,91,78
Kansas,Graham County,2,147,80,67
Kansas,Graham County,3,125,65,60
Kansas,Graham County,4,121,51,70
Kansas,Graham County,5,109,65,44
Kansas,Graham County,6,116,53,63
Kansas,Graham County,7,129,66,63
Kansas,Graham County,8,126,66,60
Kansas,Graham County,9,94,42,52
Kansas,Graham County,10,130,81,49
Kansas,Graham County,11,214,100,114
Kansas,Graham County,12,233,120,113
Kansas,Graham County,13,202,98,104
Kansas,Graham County,14,141,63,78
Kansas,Graham County,15,155,78,77
Kansas,Graham County,16,144,70,74
Kansas,Graham County,17,118,44,74
Kansas,Graham County,18,93,40,53
Kansas,Grant County,0,7816,3976,3840
Kansas,Grant County,1,645,344,301
Kansas,Grant County,2,722,357,365
Kansas,Grant County,3,713,384,329
Kansas,Grant County,4,653,335,318
Kansas,Grant County,5,470,252,218
Kansas,Grant County,6,428,236,192
Kansas,Grant County,7,474,223,251
Kansas,Grant County,8,541,282,259
Kansas,Grant County,9,445,221,224
Kansas,Grant County,10,436,231,205
Kansas,Grant County,11,509,263,246
Kansas,Grant County,12,478,252,226
Kansas,Grant County,13,429,214,215
Kansas,Grant County,14,298,147,151
Kansas,Grant County,15,190,90,100
Kansas,Grant County,16,160,71,89
Kansas,Grant County,17,128,39,89
Kansas,Grant County,18,97,35,62
Kansas,Gray County,0,6082,3026,3056
Kansas,Gray County,1,456,250,206
Kansas,Gray County,2,509,254,255
Kansas,Gray County,3,519,262,257
Kansas,Gray County,4,470,215,255
Kansas,Gray County,5,313,157,156
Kansas,Gray County,6,330,155,175
Kansas,Gray County,7,363,170,193
Kansas,Gray County,8,380,200,180
Kansas,Gray County,9,345,180,165
Kansas,Gray County,10,367,191,176
Kansas,Gray County,11,435,215,220
Kansas,Gray County,12,376,194,182
Kansas,Gray County,13,344,186,158
Kansas,Gray County,14,280,133,147
Kansas,Gray County,15,206,98,108
Kansas,Gray County,16,150,73,77
Kansas,Gray County,17,119,47,72
Kansas,Gray County,18,120,46,74
Kansas,Greeley County,0,1301,639,662
Kansas,Greeley County,1,100,46,54
Kansas,Greeley County,2,91,42,49
Kansas,Greeley County,3,81,45,36
Kansas,Greeley County,4,63,29,34
Kansas,Greeley County,5,68,30,38
Kansas,Greeley County,6,77,31,46
Kansas,Greeley County,7,79,45,34
Kansas,Greeley County,8,68,36,32
Kansas,Greeley County,9,49,28,21
Kansas,Greeley County,10,59,27,32
Kansas,Greeley County,11,105,59,46
Kansas,Greeley County,12,110,54,56
Kansas,Greeley County,13,79,41,38
Kansas,Greeley County,14,67,37,30
Kansas,Greeley County,15,45,18,27
Kansas,Greeley County,16,51,24,27
Kansas,Greeley County,17,48,20,28
Kansas,Greeley County,18,61,27,34
Kansas,Greenwood County,0,6328,3154,3174
Kansas,Greenwood County,1,320,157,163
Kansas,Greenwood County,2,384,189,195
Kansas,Greenwood County,3,409,218,191
Kansas,Greenwood County,4,368,196,172
Kansas,Greenwood County,5,262,141,121
Kansas,Greenwood County,6,278,140,138
Kansas,Greenwood County,7,291,141,150
Kansas,Greenwood County,8,316,154,162
Kansas,Greenwood County,9,318,164,154
Kansas,Greenwood County,10,386,196,190
Kansas,Greenwood County,11,477,244,233
Kansas,Greenwood County,12,521,252,269
Kansas,Greenwood County,13,506,254,252
Kansas,Greenwood County,14,449,229,220
Kansas,Greenwood County,15,339,168,171
Kansas,Greenwood County,16,252,138,114
Kansas,Greenwood County,17,211,87,124
Kansas,Greenwood County,18,241,86,155
Kansas,Hamilton County,0,2603,1338,1265
Kansas,Hamilton County,1,219,119,100
Kansas,Hamilton County,2,220,129,91
Kansas,Hamilton County,3,220,116,104
Kansas,Hamilton County,4,167,86,81
Kansas,Hamilton County,5,148,78,70
Kansas,Hamilton County,6,165,76,89
Kansas,Hamilton County,7,173,80,93
Kansas,Hamilton County,8,170,94,76
Kansas,Hamilton County,9,150,75,75
Kansas,Hamilton County,10,141,75,66
Kansas,Hamilton County,11,210,107,103
Kansas,Hamilton County,12,161,79,82
Kansas,Hamilton County,13,148,75,73
Kansas,Hamilton County,14,100,54,46
Kansas,Hamilton County,15,79,39,40
Kansas,Hamilton County,16,50,27,23
Kansas,Hamilton County,17,51,22,29
Kansas,Hamilton County,18,31,7,24
Kansas,Harper County,0,5818,2931,2887
Kansas,Harper County,1,400,228,172
Kansas,Harper County,2,408,211,197
Kansas,Harper County,3,372,213,159
Kansas,Harper County,4,322,142,180
Kansas,Harper County,5,299,163,136
Kansas,Harper County,6,303,157,146
Kansas,Harper County,7,336,174,162
Kansas,Harper County,8,321,185,136
Kansas,Harper County,9,270,143,127
Kansas,Harper County,10,321,164,157
Kansas,Harper County,11,356,185,171
Kansas,Harper County,12,416,201,215
Kansas,Harper County,13,429,228,201
Kansas,Harper County,14,348,151,197
Kansas,Harper County,15,284,122,162
Kansas,Harper County,16,254,126,128
Kansas,Harper County,17,193,85,108
Kansas,Harper County,18,186,53,133
Kansas,Harvey County,0,34820,17106,17714
Kansas,Harvey County,1,2389,1211,1178
Kansas,Harvey County,2,2393,1199,1194
Kansas,Harvey County,3,2494,1298,1196
Kansas,Harvey County,4,2595,1366,1229
Kansas,Harvey County,5,2228,1167,1061
Kansas,Harvey County,6,1824,906,918
Kansas,Harvey County,7,1999,1007,992
Kansas,Harvey County,8,2035,1019,1016
Kansas,Harvey County,9,1826,897,929
Kansas,Harvey County,10,1922,918,1004
Kansas,Harvey County,11,2309,1107,1202
Kansas,Harvey County,12,2442,1229,1213
Kansas,Harvey County,13,2117,1033,1084
Kansas,Harvey County,14,1706,848,858
Kansas,Harvey County,15,1274,578,696
Kansas,Harvey County,16,1125,483,642
Kansas,Harvey County,17,976,422,554
Kansas,Harvey County,18,1166,418,748
Kansas,Haskell County,0,4106,2044,2062
Kansas,Haskell County,1,312,158,154
Kansas,Haskell County,2,337,174,163
Kansas,Haskell County,3,332,171,161
Kansas,Haskell County,4,329,164,165
Kansas,Haskell County,5,276,147,129
Kansas,Haskell County,6,227,111,116
Kansas,Haskell County,7,243,128,115
Kansas,Haskell County,8,238,126,112
Kansas,Haskell County,9,253,111,142
Kansas,Haskell County,10,225,111,114
Kansas,Haskell County,11,272,128,144
Kansas,Haskell County,12,298,154,144
Kansas,Haskell County,13,269,138,131
Kansas,Haskell County,14,163,85,78
Kansas,Haskell County,15,101,47,54
Kansas,Haskell County,16,90,38,52
Kansas,Haskell County,17,78,32,46
Kansas,Haskell County,18,63,21,42
Kansas,Hodgeman County,0,1916,947,969
Kansas,Hodgeman County,1,141,65,76
Kansas,Hodgeman County,2,100,44,56
Kansas,Hodgeman County,3,119,59,60
Kansas,Hodgeman County,4,120,56,64
Kansas,Hodgeman County,5,94,43,51
Kansas,Hodgeman County,6,77,40,37
Kansas,Hodgeman County,7,100,53,47
Kansas,Hodgeman County,8,80,47,33
Kansas,Hodgeman County,9,88,43,45
Kansas,Hodgeman County,10,102,51,51
Kansas,Hodgeman County,11,151,70,81
Kansas,Hodgeman County,12,178,99,79
Kansas,Hodgeman County,13,121,67,54
Kansas,Hodgeman County,14,94,49,45
Kansas,Hodgeman County,15,98,44,54
Kansas,Hodgeman County,16,98,41,57
Kansas,Hodgeman County,17,89,46,43
Kansas,Hodgeman County,18,66,30,36
Kansas,Jackson County,0,13539,6842,6697
Kansas,Jackson County,1,879,463,416
Kansas,Jackson County,2,956,502,454
Kansas,Jackson County,3,1044,570,474
Kansas,Jackson County,4,955,512,443
Kansas,Jackson County,5,693,369,324
Kansas,Jackson County,6,688,342,346
Kansas,Jackson County,7,734,378,356
Kansas,Jackson County,8,709,356,353
Kansas,Jackson County,9,823,413,410
Kansas,Jackson County,10,909,446,463
Kansas,Jackson County,11,1012,523,489
Kansas,Jackson County,12,961,472,489
Kansas,Jackson County,13,851,419,432
Kansas,Jackson County,14,749,358,391
Kansas,Jackson County,15,598,290,308
Kansas,Jackson County,16,378,170,208
Kansas,Jackson County,17,296,137,159
Kansas,Jackson County,18,304,122,182
Kansas,Jefferson County,0,18855,9532,9323
Kansas,Jefferson County,1,995,507,488
Kansas,Jefferson County,2,1206,613,593
Kansas,Jefferson County,3,1366,710,656
Kansas,Jefferson County,4,1303,707,596
Kansas,Jefferson County,5,880,478,402
Kansas,Jefferson County,6,908,436,472
Kansas,Jefferson County,7,986,491,495
Kansas,Jefferson County,8,1004,524,480
Kansas,Jefferson County,9,1093,527,566
Kansas,Jefferson County,10,1322,653,669
Kansas,Jefferson County,11,1684,830,854
Kansas,Jefferson County,12,1532,788,744
Kansas,Jefferson County,13,1326,683,643
Kansas,Jefferson County,14,1072,551,521
Kansas,Jefferson County,15,776,394,382
Kansas,Jefferson County,16,589,281,308
Kansas,Jefferson County,17,384,192,192
Kansas,Jefferson County,18,429,167,262
Kansas,Jewell County,0,3043,1559,1484
Kansas,Jewell County,1,141,72,69
Kansas,Jewell County,2,175,91,84
Kansas,Jewell County,3,166,89,77
Kansas,Jewell County,4,174,95,79
Kansas,Jewell County,5,124,66,58
Kansas,Jewell County,6,144,84,60
Kansas,Jewell County,7,128,69,59
Kansas,Jewell County,8,129,76,53
Kansas,Jewell County,9,117,59,58
Kansas,Jewell County,10,151,75,76
Kansas,Jewell County,11,220,104,116
Kansas,Jewell County,12,261,133,128
Kansas,Jewell County,13,281,151,130
Kansas,Jewell County,14,206,110,96
Kansas,Jewell County,15,191,103,88
Kansas,Jewell County,16,152,66,86
Kansas,Jewell County,17,149,64,85
Kansas,Jewell County,18,134,52,82
Kansas,Johnson County,0,574272,281327,292945
Kansas,Johnson County,1,38480,19668,18812
Kansas,Johnson County,2,40966,21054,19912
Kansas,Johnson County,3,41746,21341,20405
Kansas,Johnson County,4,37091,19115,17976
Kansas,Johnson County,5,32057,16241,15816
Kansas,Johnson County,6,37408,18517,18891
Kansas,Johnson County,7,43186,21481,21705
Kansas,Johnson County,8,40037,19915,20122
Kansas,Johnson County,9,39722,19737,19985
Kansas,Johnson County,10,38716,19056,19660
Kansas,Johnson County,11,41213,19948,21265
Kansas,Johnson County,12,38128,18115,20013
Kansas,Johnson County,13,32841,15442,17399
Kansas,Johnson County,14,25358,12061,13297
Kansas,Johnson County,15,16292,7413,8879
Kansas,Johnson County,16,11372,4960,6412
Kansas,Johnson County,17,8675,3556,5119
Kansas,Johnson County,18,10984,3707,7277
Kansas,Kearny County,0,3915,1969,1946
Kansas,Kearny County,1,316,149,167
Kansas,Kearny County,2,326,173,153
Kansas,Kearny County,3,304,157,147
Kansas,Kearny County,4,303,168,135
Kansas,Kearny County,5,266,153,113
Kansas,Kearny County,6,248,126,122
Kansas,Kearny County,7,226,119,107
Kansas,Kearny County,8,220,109,111
Kansas,Kearny County,9,198,104,94
Kansas,Kearny County,10,232,104,128
Kansas,Kearny County,11,273,131,142
Kansas,Kearny County,12,239,132,107
Kansas,Kearny County,13,212,109,103
Kansas,Kearny County,14,165,79,86
Kansas,Kearny County,15,126,53,73
Kansas,Kearny County,16,110,52,58
Kansas,Kearny County,17,71,27,44
Kansas,Kearny County,18,80,24,56
Kansas,Kingman County,0,7698,3864,3834
Kansas,Kingman County,1,419,229,190
Kansas,Kingman County,2,453,242,211
Kansas,Kingman County,3,486,243,243
Kansas,Kingman County,4,502,256,246
Kansas,Kingman County,5,408,226,182
Kansas,Kingman County,6,398,207,191
Kansas,Kingman County,7,412,205,207
Kansas,Kingman County,8,366,183,183
Kansas,Kingman County,9,386,198,188
Kansas,Kingman County,10,430,206,224
Kansas,Kingman County,11,631,315,316
Kansas,Kingman County,12,653,326,327
Kansas,Kingman County,13,491,270,221
Kansas,Kingman County,14,452,224,228
Kansas,Kingman County,15,351,186,165
Kansas,Kingman County,16,321,134,187
Kansas,Kingman County,17,250,103,147
Kansas,Kingman County,18,289,111,178
Kansas,Kiowa County,0,2513,1250,1263
Kansas,Kiowa County,1,164,87,77
Kansas,Kiowa County,2,141,65,76
Kansas,Kiowa County,3,133,59,74
Kansas,Kiowa County,4,204,99,105
Kansas,Kiowa County,5,216,116,100
Kansas,Kiowa County,6,130,69,61
Kansas,Kiowa County,7,115,60,55
Kansas,Kiowa County,8,114,62,52
Kansas,Kiowa County,9,137,66,71
Kansas,Kiowa County,10,134,58,76
Kansas,Kiowa County,11,174,98,76
Kansas,Kiowa County,12,192,97,95
Kansas,Kiowa County,13,185,101,84
Kansas,Kiowa County,14,120,56,64
Kansas,Kiowa County,15,93,40,53
Kansas,Kiowa County,16,93,41,52
Kansas,Kiowa County,17,68,29,39
Kansas,Kiowa County,18,100,47,53
Kansas,Labette County,0,20960,10385,10575
Kansas,Labette County,1,1350,666,684
Kansas,Labette County,2,1383,683,700
Kansas,Labette County,3,1350,718,632
Kansas,Labette County,4,1363,742,621
Kansas,Labette County,5,1312,699,613
Kansas,Labette County,6,1197,633,564
Kansas,Labette County,7,1160,576,584
Kansas,Labette County,8,1066,542,524
Kansas,Labette County,9,1225,626,599
Kansas,Labette County,10,1293,618,675
Kansas,Labette County,11,1601,834,767
Kansas,Labette County,12,1555,770,785
Kansas,Labette County,13,1312,621,691
Kansas,Labette County,14,1183,581,602
Kansas,Labette County,15,915,434,481
Kansas,Labette County,16,651,296,355
Kansas,Labette County,17,446,161,285
Kansas,Labette County,18,598,185,413
Kansas,Lane County,0,1687,839,848
Kansas,Lane County,1,94,67,27
Kansas,Lane County,2,85,42,43
Kansas,Lane County,3,107,51,56
Kansas,Lane County,4,119,57,62
Kansas,Lane County,5,76,42,34
Kansas,Lane County,6,74,35,39
Kansas,Lane County,7,60,32,28
Kansas,Lane County,8,77,33,44
Kansas,Lane County,9,93,51,42
Kansas,Lane County,10,112,57,55
Kansas,Lane County,11,119,66,53
Kansas,Lane County,12,146,74,72
Kansas,Lane County,13,128,69,59
Kansas,Lane County,14,120,54,66
Kansas,Lane County,15,76,36,40
Kansas,Lane County,16,88,41,47
Kansas,Lane County,17,66,25,41
Kansas,Lane County,18,47,7,40
Kansas,Leavenworth County,0,78797,42003,36794
Kansas,Leavenworth County,1,5170,2606,2564
Kansas,Leavenworth County,2,5464,2810,2654
Kansas,Leavenworth County,3,5327,2718,2609
Kansas,Leavenworth County,4,4901,2574,2327
Kansas,Leavenworth County,5,4797,2790,2007
Kansas,Leavenworth County,6,4921,3026,1895
Kansas,Leavenworth County,7,6019,3455,2564
Kansas,Leavenworth County,8,5847,3367,2480
Kansas,Leavenworth County,9,5539,3105,2434
Kansas,Leavenworth County,10,5162,2906,2256
Kansas,Leavenworth County,11,5803,3095,2708
Kansas,Leavenworth County,12,5343,2792,2551
Kansas,Leavenworth County,13,4535,2285,2250
Kansas,Leavenworth County,14,3496,1733,1763
Kansas,Leavenworth County,15,2420,1151,1269
Kansas,Leavenworth County,16,1689,741,948
Kansas,Leavenworth County,17,1158,467,691
Kansas,Leavenworth County,18,1206,382,824
Kansas,Lincoln County,0,3167,1584,1583
Kansas,Lincoln County,1,199,106,93
Kansas,Lincoln County,2,211,107,104
Kansas,Lincoln County,3,223,108,115
Kansas,Lincoln County,4,206,115,91
Kansas,Lincoln County,5,129,69,60
Kansas,Lincoln County,6,102,55,47
Kansas,Lincoln County,7,183,89,94
Kansas,Lincoln County,8,148,75,73
Kansas,Lincoln County,9,160,89,71
Kansas,Lincoln County,10,176,90,86
Kansas,Lincoln County,11,227,105,122
Kansas,Lincoln County,12,297,146,151
Kansas,Lincoln County,13,250,137,113
Kansas,Lincoln County,14,192,105,87
Kansas,Lincoln County,15,122,48,74
Kansas,Lincoln County,16,109,59,50
Kansas,Lincoln County,17,106,50,56
Kansas,Lincoln County,18,127,31,96
Kansas,Linn County,0,9502,4707,4795
Kansas,Linn County,1,476,208,268
Kansas,Linn County,2,638,306,332
Kansas,Linn County,3,678,338,340
Kansas,Linn County,4,613,299,314
Kansas,Linn County,5,427,218,209
Kansas,Linn County,6,444,225,219
Kansas,Linn County,7,505,257,248
Kansas,Linn County,8,531,263,268
Kansas,Linn County,9,544,274,270
Kansas,Linn County,10,556,277,279
Kansas,Linn County,11,751,389,362
Kansas,Linn County,12,661,351,310
Kansas,Linn County,13,696,348,348
Kansas,Linn County,14,682,324,358
Kansas,Linn County,15,504,261,243
Kansas,Linn County,16,327,160,167
Kansas,Linn County,17,234,113,121
Kansas,Linn County,18,235,96,139
Kansas,Logan County,0,2794,1420,1374
Kansas,Logan County,1,166,81,85
Kansas,Logan County,2,165,85,80
Kansas,Logan County,3,181,89,92
Kansas,Logan County,4,166,100,66
Kansas,Logan County,5,162,86,76
Kansas,Logan County,6,160,87,73
Kansas,Logan County,7,187,101,86
Kansas,Logan County,8,153,78,75
Kansas,Logan County,9,133,74,59
Kansas,Logan County,10,125,65,60
Kansas,Logan County,11,226,110,116
Kansas,Logan County,12,230,119,111
Kansas,Logan County,13,190,108,82
Kansas,Logan County,14,130,69,61
Kansas,Logan County,15,115,51,64
Kansas,Logan County,16,105,46,59
Kansas,Logan County,17,75,29,46
Kansas,Logan County,18,125,42,83
Kansas,Lyon County,0,33212,16226,16986
Kansas,Lyon County,1,2019,1006,1013
Kansas,Lyon County,2,2154,1093,1061
Kansas,Lyon County,3,2099,1068,1031
Kansas,Lyon County,4,2619,1249,1370
Kansas,Lyon County,5,4416,2029,2387
Kansas,Lyon County,6,2194,1171,1023
Kansas,Lyon County,7,2003,1026,977
Kansas,Lyon County,8,1687,845,842
Kansas,Lyon County,9,1676,873,803
Kansas,Lyon County,10,1732,861,871
Kansas,Lyon County,11,2055,1005,1050
Kansas,Lyon County,12,2162,1099,1063
Kansas,Lyon County,13,1845,926,919
Kansas,Lyon County,14,1406,708,698
Kansas,Lyon County,15,1058,470,588
Kansas,Lyon County,16,724,319,405
Kansas,Lyon County,17,632,241,391
Kansas,Lyon County,18,731,237,494
Kansas,McPherson County,0,29241,14423,14818
Kansas,McPherson County,1,1821,950,871
Kansas,McPherson County,2,1844,978,866
Kansas,McPherson County,3,1990,990,1000
Kansas,McPherson County,4,1910,958,952
Kansas,McPherson County,5,1858,1001,857
Kansas,McPherson County,6,1589,841,748
Kansas,McPherson County,7,1758,844,914
Kansas,McPherson County,8,1607,811,796
Kansas,McPherson County,9,1508,784,724
Kansas,McPherson County,10,1550,770,780
Kansas,McPherson County,11,2156,1054,1102
Kansas,McPherson County,12,2168,1081,1087
Kansas,McPherson County,13,1915,949,966
Kansas,McPherson County,14,1486,733,753
Kansas,McPherson County,15,1180,556,624
Kansas,McPherson County,16,932,416,516
Kansas,McPherson County,17,796,304,492
Kansas,McPherson County,18,1173,403,770
Kansas,Marion County,0,12208,6104,6104
Kansas,Marion County,1,612,307,305
Kansas,Marion County,2,728,380,348
Kansas,Marion County,3,796,413,383
Kansas,Marion County,4,898,469,429
Kansas,Marion County,5,807,434,373
Kansas,Marion County,6,548,279,269
Kansas,Marion County,7,567,288,279
Kansas,Marion County,8,579,290,289
Kansas,Marion County,9,548,277,271
Kansas,Marion County,10,699,361,338
Kansas,Marion County,11,919,456,463
Kansas,Marion County,12,974,515,459
Kansas,Marion County,13,815,418,397
Kansas,Marion County,14,753,368,385
Kansas,Marion County,15,595,288,307
Kansas,Marion County,16,477,224,253
Kansas,Marion County,17,370,159,211
Kansas,Marion County,18,523,178,345
Kansas,Marshall County,0,10006,4989,5017
Kansas,Marshall County,1,616,312,304
Kansas,Marshall County,2,671,331,340
Kansas,Marshall County,3,652,327,325
Kansas,Marshall County,4,566,296,270
Kansas,Marshall County,5,482,258,224
Kansas,Marshall County,6,501,247,254
Kansas,Marshall County,7,608,300,308
Kansas,Marshall County,8,520,279,241
Kansas,Marshall County,9,478,252,226
Kansas,Marshall County,10,513,259,254
Kansas,Marshall County,11,772,387,385
Kansas,Marshall County,12,846,431,415
Kansas,Marshall County,13,662,345,317
Kansas,Marshall County,14,522,267,255
Kansas,Marshall County,15,452,209,243
Kansas,Marshall County,16,383,175,208
Kansas,Marshall County,17,352,153,199
Kansas,Marshall County,18,410,161,249
Kansas,Meade County,0,4357,2223,2134
Kansas,Meade County,1,241,150,91
Kansas,Meade County,2,339,200,139
Kansas,Meade County,3,347,176,171
Kansas,Meade County,4,380,185,195
Kansas,Meade County,5,262,130,132
Kansas,Meade County,6,203,105,98
Kansas,Meade County,7,226,114,112
Kansas,Meade County,8,206,107,99
Kansas,Meade County,9,245,107,138
Kansas,Meade County,10,257,126,131
Kansas,Meade County,11,295,144,151
Kansas,Meade County,12,307,155,152
Kansas,Meade County,13,284,157,127
Kansas,Meade County,14,186,104,82
Kansas,Meade County,15,143,68,75
Kansas,Meade County,16,155,83,72
Kansas,Meade County,17,131,55,76
Kansas,Meade County,18,150,57,93
Kansas,Miami County,0,32822,16285,16537
Kansas,Miami County,1,2005,995,1010
Kansas,Miami County,2,2277,1153,1124
Kansas,Miami County,3,2622,1369,1253
Kansas,Miami County,4,2295,1168,1127
Kansas,Miami County,5,1617,866,751
Kansas,Miami County,6,1490,762,728
Kansas,Miami County,7,1866,922,944
Kansas,Miami County,8,1997,996,1001
Kansas,Miami County,9,2080,1023,1057
Kansas,Miami County,10,2382,1180,1202
Kansas,Miami County,11,2700,1332,1368
Kansas,Miami County,12,2509,1267,1242
Kansas,Miami County,13,1978,988,990
Kansas,Miami County,14,1590,772,818
Kansas,Miami County,15,1233,602,631
Kansas,Miami County,16,872,391,481
Kansas,Miami County,17,639,271,368
Kansas,Miami County,18,670,228,442
Kansas,Mitchell County,0,6284,3215,3069
Kansas,Mitchell County,1,384,212,172
Kansas,Mitchell County,2,369,187,182
Kansas,Mitchell County,3,378,189,189
Kansas,Mitchell County,4,488,301,187
Kansas,Mitchell County,5,374,215,159
Kansas,Mitchell County,6,263,130,133
Kansas,Mitchell County,7,365,197,168
Kansas,Mitchell County,8,284,141,143
Kansas,Mitchell County,9,307,157,150
Kansas,Mitchell County,10,306,153,153
Kansas,Mitchell County,11,451,250,201
Kansas,Mitchell County,12,462,220,242
Kansas,Mitchell County,13,441,223,218
Kansas,Mitchell County,14,400,210,190
Kansas,Mitchell County,15,284,137,147
Kansas,Mitchell County,16,245,113,132
Kansas,Mitchell County,17,220,100,120
Kansas,Mitchell County,18,263,80,183
Kansas,Montgomery County,0,34065,16783,17282
Kansas,Montgomery County,1,2350,1189,1161
Kansas,Montgomery County,2,2309,1179,1130
Kansas,Montgomery County,3,2204,1122,1082
Kansas,Montgomery County,4,2395,1319,1076
Kansas,Montgomery County,5,2158,1161,997
Kansas,Montgomery County,6,1961,986,975
Kansas,Montgomery County,7,2022,1016,1006
Kansas,Montgomery County,8,1752,873,879
Kansas,Montgomery County,9,1786,861,925
Kansas,Montgomery County,10,1948,965,983
Kansas,Montgomery County,11,2416,1178,1238
Kansas,Montgomery County,12,2442,1213,1229
Kansas,Montgomery County,13,2158,1076,1082
Kansas,Montgomery County,14,1814,845,969
Kansas,Montgomery County,15,1510,692,818
Kansas,Montgomery County,16,1084,490,594
Kansas,Montgomery County,17,803,306,497
Kansas,Montgomery County,18,953,312,641
Kansas,Morris County,0,5698,2821,2877
Kansas,Morris County,1,325,150,175
Kansas,Morris County,2,336,174,162
Kansas,Morris County,3,331,169,162
Kansas,Morris County,4,324,167,157
Kansas,Morris County,5,239,123,116
Kansas,Morris County,6,276,144,132
Kansas,Morris County,7,313,172,141
Kansas,Morris County,8,246,130,116
Kansas,Morris County,9,272,124,148
Kansas,Morris County,10,342,170,172
Kansas,Morris County,11,445,219,226
Kansas,Morris County,12,466,230,236
Kansas,Morris County,13,440,216,224
Kansas,Morris County,14,343,178,165
Kansas,Morris County,15,340,167,173
Kansas,Morris County,16,210,98,112
Kansas,Morris County,17,217,95,122
Kansas,Morris County,18,233,95,138
Kansas,Morton County,0,3110,1579,1531
Kansas,Morton County,1,216,134,82
Kansas,Morton County,2,207,106,101
Kansas,Morton County,3,230,110,120
Kansas,Morton County,4,230,116,114
Kansas,Morton County,5,157,97,60
Kansas,Morton County,6,136,68,68
Kansas,Morton County,7,182,81,101
Kansas,Morton County,8,178,90,88
Kansas,Morton County,9,192,97,95
Kansas,Morton County,10,166,96,70
Kansas,Morton County,11,251,139,112
Kansas,Morton County,12,212,102,110
Kansas,Morton County,13,186,96,90
Kansas,Morton County,14,145,69,76
Kansas,Morton County,15,125,56,69
Kansas,Morton County,16,111,56,55
Kansas,Morton County,17,75,25,50
Kansas,Morton County,18,111,41,70
Kansas,Nemaha County,0,10148,5149,4999
Kansas,Nemaha County,1,706,354,352
Kansas,Nemaha County,2,660,363,297
Kansas,Nemaha County,3,739,378,361
Kansas,Nemaha County,4,721,386,335
Kansas,Nemaha County,5,558,317,241
Kansas,Nemaha County,6,484,257,227
Kansas,Nemaha County,7,566,296,270
Kansas,Nemaha County,8,486,249,237
Kansas,Nemaha County,9,538,279,259
Kansas,Nemaha County,10,568,285,283
Kansas,Nemaha County,11,784,405,379
Kansas,Nemaha County,12,702,374,328
Kansas,Nemaha County,13,596,316,280
Kansas,Nemaha County,14,479,240,239
Kansas,Nemaha County,15,385,182,203
Kansas,Nemaha County,16,353,157,196
Kansas,Nemaha County,17,341,127,214
Kansas,Nemaha County,18,482,184,298
Kansas,Neosho County,0,16416,8158,8258
Kansas,Neosho County,1,1170,587,583
Kansas,Neosho County,2,1151,594,557
Kansas,Neosho County,3,1072,531,541
Kansas,Neosho County,4,1156,606,550
Kansas,Neosho County,5,991,533,458
Kansas,Neosho County,6,867,432,435
Kansas,Neosho County,7,905,451,454
Kansas,Neosho County,8,900,453,447
Kansas,Neosho County,9,868,445,423
Kansas,Neosho County,10,964,487,477
Kansas,Neosho County,11,1152,587,565
Kansas,Neosho County,12,1193,620,573
Kansas,Neosho County,13,1012,512,500
Kansas,Neosho County,14,850,407,443
Kansas,Neosho County,15,697,304,393
Kansas,Neosho County,16,567,258,309
Kansas,Neosho County,17,411,169,242
Kansas,Neosho County,18,490,182,308
Kansas,Ness County,0,3105,1529,1576
Kansas,Ness County,1,182,72,110
Kansas,Ness County,2,190,89,101
Kansas,Ness County,3,215,113,102
Kansas,Ness County,4,197,106,91
Kansas,Ness County,5,115,59,56
Kansas,Ness County,6,126,59,67
Kansas,Ness County,7,182,106,76
Kansas,Ness County,8,131,74,57
Kansas,Ness County,9,140,74,66
Kansas,Ness County,10,136,66,70
Kansas,Ness County,11,280,142,138
Kansas,Ness County,12,243,122,121
Kansas,Ness County,13,229,114,115
Kansas,Ness County,14,150,86,64
Kansas,Ness County,15,172,71,101
Kansas,Ness County,16,149,73,76
Kansas,Ness County,17,122,54,68
Kansas,Ness County,18,146,49,97
Kansas,Norton County,0,5560,3092,2468
Kansas,Norton County,1,289,139,150
Kansas,Norton County,2,288,151,137
Kansas,Norton County,3,291,142,149
Kansas,Norton County,4,298,165,133
Kansas,Norton County,5,355,236,119
Kansas,Norton County,6,394,257,137
Kansas,Norton County,7,345,232,113
Kansas,Norton County,8,333,217,116
Kansas,Norton County,9,346,207,139
Kansas,Norton County,10,367,235,132
Kansas,Norton County,11,445,245,200
Kansas,Norton County,12,405,215,190
Kansas,Norton County,13,325,179,146
Kansas,Norton County,14,296,134,162
Kansas,Norton County,15,234,107,127
Kansas,Norton County,16,196,96,100
Kansas,Norton County,17,143,68,75
Kansas,Norton County,18,210,67,143
Kansas,Osage County,0,15936,7971,7965
Kansas,Osage County,1,898,440,458
Kansas,Osage County,2,1062,581,481
Kansas,Osage County,3,1097,563,534
Kansas,Osage County,4,1113,598,515
Kansas,Osage County,5,817,427,390
Kansas,Osage County,6,735,363,372
Kansas,Osage County,7,842,440,402
Kansas,Osage County,8,825,398,427
Kansas,Osage County,9,968,451,517
Kansas,Osage County,10,915,470,445
Kansas,Osage County,11,1328,644,684
Kansas,Osage County,12,1282,647,635
Kansas,Osage County,13,1110,558,552
Kansas,Osage County,14,943,492,451
Kansas,Osage County,15,727,346,381
Kansas,Osage County,16,509,235,274
Kansas,Osage County,17,370,188,182
Kansas,Osage County,18,395,130,265
Kansas,Osborne County,0,3756,1893,1863
Kansas,Osborne County,1,204,114,90
Kansas,Osborne County,2,222,107,115
Kansas,Osborne County,3,205,104,101
Kansas,Osborne County,4,226,118,108
Kansas,Osborne County,5,190,111,79
Kansas,Osborne County,6,185,100,85
Kansas,Osborne County,7,193,104,89
Kansas,Osborne County,8,172,94,78
Kansas,Osborne County,9,139,69,70
Kansas,Osborne County,10,216,108,108
Kansas,Osborne County,11,285,131,154
Kansas,Osborne County,12,320,175,145
Kansas,Osborne County,13,266,151,115
Kansas,Osborne County,14,198,101,97
Kansas,Osborne County,15,208,93,115
Kansas,Osborne County,16,177,83,94
Kansas,Osborne County,17,165,66,99
Kansas,Osborne County,18,185,64,121
Kansas,Ottawa County,0,6065,3159,2906
Kansas,Ottawa County,1,356,200,156
Kansas,Ottawa County,2,404,223,181
Kansas,Ottawa County,3,423,241,182
Kansas,Ottawa County,4,428,229,199
Kansas,Ottawa County,5,295,177,118
Kansas,Ottawa County,6,271,149,122
Kansas,Ottawa County,7,344,182,162
Kansas,Ottawa County,8,352,185,167
Kansas,Ottawa County,9,352,173,179
Kansas,Ottawa County,10,342,168,174
Kansas,Ottawa County,11,503,250,253
Kansas,Ottawa County,12,459,232,227
Kansas,Ottawa County,13,444,220,224
Kansas,Ottawa County,14,303,157,146
Kansas,Ottawa County,15,269,120,149
Kansas,Ottawa County,16,225,115,110
Kansas,Ottawa County,17,167,84,83
Kansas,Ottawa County,18,128,54,74
Kansas,Pawnee County,0,6916,3848,3068
Kansas,Pawnee County,1,338,159,179
Kansas,Pawnee County,2,323,166,157
Kansas,Pawnee County,3,353,192,161
Kansas,Pawnee County,4,508,344,164
Kansas,Pawnee County,5,381,224,157
Kansas,Pawnee County,6,428,261,167
Kansas,Pawnee County,7,454,276,178
Kansas,Pawnee County,8,416,242,174
Kansas,Pawnee County,9,387,245,142
Kansas,Pawnee County,10,406,264,142
Kansas,Pawnee County,11,563,318,245
Kansas,Pawnee County,12,537,287,250
Kansas,Pawnee County,13,507,285,222
Kansas,Pawnee County,14,387,195,192
Kansas,Pawnee County,15,282,123,159
Kansas,Pawnee County,16,238,111,127
Kansas,Pawnee County,17,201,80,121
Kansas,Pawnee County,18,207,76,131
Kansas,Phillips County,0,5533,2727,2806
Kansas,Phillips County,1,362,184,178
Kansas,Phillips County,2,342,171,171
Kansas,Phillips County,3,389,192,197
Kansas,Phillips County,4,344,169,175
Kansas,Phillips County,5,274,132,142
Kansas,Phillips County,6,258,132,126
Kansas,Phillips County,7,319,163,156
Kansas,Phillips County,8,260,142,118
Kansas,Phillips County,9,266,127,139
Kansas,Phillips County,10,290,152,138
Kansas,Phillips County,11,412,191,221
Kansas,Phillips County,12,410,225,185
Kansas,Phillips County,13,424,209,215
Kansas,Phillips County,14,353,191,162
Kansas,Phillips County,15,255,124,131
Kansas,Phillips County,16,216,104,112
Kansas,Phillips County,17,178,66,112
Kansas,Phillips County,18,181,53,128
Kansas,Pottawatomie County,0,22897,11411,11486
Kansas,Pottawatomie County,1,1870,948,922
Kansas,Pottawatomie County,2,1913,1002,911
Kansas,Pottawatomie County,3,1833,909,924
Kansas,Pottawatomie County,4,1701,890,811
Kansas,Pottawatomie County,5,1281,674,607
Kansas,Pottawatomie County,6,1296,644,652
Kansas,Pottawatomie County,7,1711,853,858
Kansas,Pottawatomie County,8,1444,767,677
Kansas,Pottawatomie County,9,1263,630,633
Kansas,Pottawatomie County,10,1259,614,645
Kansas,Pottawatomie County,11,1569,781,788
Kansas,Pottawatomie County,12,1502,716,786
Kansas,Pottawatomie County,13,1238,628,610
Kansas,Pottawatomie County,14,959,484,475
Kansas,Pottawatomie County,15,699,341,358
Kansas,Pottawatomie County,16,510,229,281
Kansas,Pottawatomie County,17,431,170,261
Kansas,Pottawatomie County,18,418,131,287
Kansas,Pratt County,0,9850,4920,4930
Kansas,Pratt County,1,706,360,346
Kansas,Pratt County,2,662,327,335
Kansas,Pratt County,3,651,351,300
Kansas,Pratt County,4,734,408,326
Kansas,Pratt County,5,678,369,309
Kansas,Pratt County,6,534,285,249
Kansas,Pratt County,7,598,305,293
Kansas,Pratt County,8,516,253,263
Kansas,Pratt County,9,471,231,240
Kansas,Pratt County,10,476,237,239
Kansas,Pratt County,11,654,319,335
Kansas,Pratt County,12,734,357,377
Kansas,Pratt County,13,675,345,330
Kansas,Pratt County,14,432,210,222
Kansas,Pratt County,15,379,184,195
Kansas,Pratt County,16,328,153,175
Kansas,Pratt County,17,278,107,171
Kansas,Pratt County,18,344,119,225
Kansas,Rawlins County,0,2584,1323,1261
Kansas,Rawlins County,1,147,90,57
Kansas,Rawlins County,2,156,74,82
Kansas,Rawlins County,3,129,62,67
Kansas,Rawlins County,4,139,69,70
Kansas,Rawlins County,5,110,64,46
Kansas,Rawlins County,6,110,62,48
Kansas,Rawlins County,7,147,73,74
Kansas,Rawlins County,8,111,61,50
Kansas,Rawlins County,9,100,58,42
Kansas,Rawlins County,10,120,57,63
Kansas,Rawlins County,11,181,96,85
Kansas,Rawlins County,12,222,118,104
Kansas,Rawlins County,13,225,117,108
Kansas,Rawlins County,14,165,86,79
Kansas,Rawlins County,15,149,77,72
Kansas,Rawlins County,16,121,61,60
Kansas,Rawlins County,17,116,46,70
Kansas,Rawlins County,18,136,52,84
Kansas,Reno County,0,63794,32135,31659
Kansas,Reno County,1,3858,1953,1905
Kansas,Reno County,2,4189,2169,2020
Kansas,Reno County,3,4188,2124,2064
Kansas,Reno County,4,4096,2151,1945
Kansas,Reno County,5,4240,2318,1922
Kansas,Reno County,6,3872,2166,1706
Kansas,Reno County,7,4050,2188,1862
Kansas,Reno County,8,3510,1889,1621
Kansas,Reno County,9,3476,1823,1653
Kansas,Reno County,10,3615,1845,1770
Kansas,Reno County,11,4443,2206,2237
Kansas,Reno County,12,4618,2328,2290
Kansas,Reno County,13,4138,1996,2142
Kansas,Reno County,14,3287,1542,1745
Kansas,Reno County,15,2536,1166,1370
Kansas,Reno County,16,2045,933,1112
Kansas,Reno County,17,1647,666,981
Kansas,Reno County,18,1986,672,1314
Kansas,Republic County,0,4803,2352,2451
Kansas,Republic County,1,262,126,136
Kansas,Republic County,2,249,113,136
Kansas,Republic County,3,249,124,125
Kansas,Republic County,4,256,133,123
Kansas,Republic County,5,207,111,96
Kansas,Republic County,6,191,94,97
Kansas,Republic County,7,256,150,106
Kansas,Republic County,8,169,79,90
Kansas,Republic County,9,209,98,111
Kansas,Republic County,10,256,128,128
Kansas,Republic County,11,372,184,188
Kansas,Republic County,12,420,227,193
Kansas,Republic County,13,392,203,189
Kansas,Republic County,14,325,164,161
Kansas,Republic County,15,263,135,128
Kansas,Republic County,16,244,103,141
Kansas,Republic County,17,218,83,135
Kansas,Republic County,18,265,97,168
Kansas,Rice County,0,10015,5025,4990
Kansas,Rice County,1,668,316,352
Kansas,Rice County,2,651,321,330
Kansas,Rice County,3,663,347,316
Kansas,Rice County,4,786,425,361
Kansas,Rice County,5,817,440,377
Kansas,Rice County,6,581,324,257
Kansas,Rice County,7,556,292,264
Kansas,Rice County,8,477,253,224
Kansas,Rice County,9,531,278,253
Kansas,Rice County,10,494,249,245
Kansas,Rice County,11,681,336,345
Kansas,Rice County,12,714,374,340
Kansas,Rice County,13,642,319,323
Kansas,Rice County,14,477,229,248
Kansas,Rice County,15,414,188,226
Kansas,Rice County,16,328,137,191
Kansas,Rice County,17,258,110,148
Kansas,Rice County,18,277,87,190
Kansas,Riley County,0,75194,40181,35013
Kansas,Riley County,1,5211,2799,2412
Kansas,Riley County,2,3479,1829,1650
Kansas,Riley County,3,2884,1480,1404
Kansas,Riley County,4,7078,3653,3425
Kansas,Riley County,5,19046,10963,8083
Kansas,Riley County,6,8616,5098,3518
Kansas,Riley County,7,5610,3080,2530
Kansas,Riley County,8,3848,2056,1792
Kansas,Riley County,9,2795,1410,1385
Kansas,Riley County,10,2351,1170,1181
Kansas,Riley County,11,2761,1337,1424
Kansas,Riley County,12,2936,1383,1553
Kansas,Riley County,13,2615,1290,1325
Kansas,Riley County,14,1942,935,1007
Kansas,Riley County,15,1282,600,682
Kansas,Riley County,16,908,408,500
Kansas,Riley County,17,791,310,481
Kansas,Riley County,18,1041,380,661
Kansas,Rooks County,0,5155,2530,2625
Kansas,Rooks County,1,325,156,169
Kansas,Rooks County,2,332,164,168
Kansas,Rooks County,3,332,152,180
Kansas,Rooks County,4,308,163,145
Kansas,Rooks County,5,268,143,125
Kansas,Rooks County,6,263,120,143
Kansas,Rooks County,7,304,159,145
Kansas,Rooks County,8,263,133,130
Kansas,Rooks County,9,273,157,116
Kansas,Rooks County,10,281,140,141
Kansas,Rooks County,11,368,186,182
Kansas,Rooks County,12,437,218,219
Kansas,Rooks County,13,341,173,168
Kansas,Rooks County,14,297,148,149
Kansas,Rooks County,15,206,86,120
Kansas,Rooks County,16,215,102,113
Kansas,Rooks County,17,157,67,90
Kansas,Rooks County,18,185,63,122
Kansas,Rush County,0,3197,1585,1612
Kansas,Rush County,1,136,71,65
Kansas,Rush County,2,175,79,96
Kansas,Rush County,3,197,98,99
Kansas,Rush County,4,173,96,77
Kansas,Rush County,5,165,83,82
Kansas,Rush County,6,143,71,72
Kansas,Rush County,7,149,71,78
Kansas,Rush County,8,151,72,79
Kansas,Rush County,9,152,81,71
Kansas,Rush County,10,187,97,90
Kansas,Rush County,11,245,133,112
Kansas,Rush County,12,277,141,136
Kansas,Rush County,13,273,132,141
Kansas,Rush County,14,205,104,101
Kansas,Rush County,15,152,80,72
Kansas,Rush County,16,135,62,73
Kansas,Rush County,17,130,63,67
Kansas,Rush County,18,152,51,101
Kansas,Russell County,0,6956,3485,3471
Kansas,Russell County,1,440,251,189
Kansas,Russell County,2,403,208,195
Kansas,Russell County,3,404,208,196
Kansas,Russell County,4,384,195,189
Kansas,Russell County,5,366,194,172
Kansas,Russell County,6,335,194,141
Kansas,Russell County,7,393,209,184
Kansas,Russell County,8,345,175,170
Kansas,Russell County,9,363,187,176
Kansas,Russell County,10,379,190,189
Kansas,Russell County,11,524,251,273
Kansas,Russell County,12,558,264,294
Kansas,Russell County,13,502,256,246
Kansas,Russell County,14,410,203,207
Kansas,Russell County,15,357,164,193
Kansas,Russell County,16,266,123,143
Kansas,Russell County,17,260,121,139
Kansas,Russell County,18,267,92,175
Kansas,Saline County,0,55755,27721,28034
Kansas,Saline County,1,3794,1881,1913
Kansas,Saline County,2,3744,1905,1839
Kansas,Saline County,3,3573,1835,1738
Kansas,Saline County,4,3843,2091,1752
Kansas,Saline County,5,3756,1992,1764
Kansas,Saline County,6,3580,1843,1737
Kansas,Saline County,7,3495,1808,1687
Kansas,Saline County,8,3209,1601,1608
Kansas,Saline County,9,3221,1582,1639
Kansas,Saline County,10,3442,1756,1686
Kansas,Saline County,11,4059,2051,2008
Kansas,Saline County,12,3895,1925,1970
Kansas,Saline County,13,3386,1647,1739
Kansas,Saline County,14,2694,1302,1392
Kansas,Saline County,15,1963,892,1071
Kansas,Saline County,16,1600,674,926
Kansas,Saline County,17,1119,470,649
Kansas,Saline County,18,1382,466,916
Kansas,Scott County,0,5080,2563,2517
Kansas,Scott County,1,327,162,165
Kansas,Scott County,2,402,207,195
Kansas,Scott County,3,393,174,219
Kansas,Scott County,4,333,179,154
Kansas,Scott County,5,260,157,103
Kansas,Scott County,6,249,144,105
Kansas,Scott County,7,279,147,132
Kansas,Scott County,8,278,150,128
Kansas,Scott County,9,305,153,152
Kansas,Scott County,10,326,178,148
Kansas,Scott County,11,345,156,189
Kansas,Scott County,12,334,164,170
Kansas,Scott County,13,345,183,162
Kansas,Scott County,14,243,127,116
Kansas,Scott County,15,199,90,109
Kansas,Scott County,16,170,86,84
Kansas,Scott County,17,119,56,63
Kansas,Scott County,18,173,50,123
Kansas,Sedgwick County,0,508803,252194,256609
Kansas,Sedgwick County,1,38510,19915,18595
Kansas,Sedgwick County,2,38062,19250,18812
Kansas,Sedgwick County,3,36655,18755,17900
Kansas,Sedgwick County,4,33973,17578,16395
Kansas,Sedgwick County,5,36314,18682,17632
Kansas,Sedgwick County,6,37054,18465,18589
Kansas,Sedgwick County,7,36034,18133,17901
Kansas,Sedgwick County,8,31033,15454,15579
Kansas,Sedgwick County,9,30072,15142,14930
Kansas,Sedgwick County,10,29574,14795,14779
Kansas,Sedgwick County,11,34154,16803,17351
Kansas,Sedgwick County,12,33866,16588,17278
Kansas,Sedgwick County,13,28420,13860,14560
Kansas,Sedgwick County,14,21753,10418,11335
Kansas,Sedgwick County,15,14695,6727,7968
Kansas,Sedgwick County,16,10956,4806,6150
Kansas,Sedgwick County,17,8721,3666,5055
Kansas,Sedgwick County,18,8957,3157,5800
Kansas,Seward County,0,23465,12076,11389
Kansas,Seward County,1,2307,1181,1126
Kansas,Seward County,2,2130,1118,1012
Kansas,Seward County,3,1867,940,927
Kansas,Seward County,4,1835,967,868
Kansas,Seward County,5,1937,1090,847
Kansas,Seward County,6,1839,950,889
Kansas,Seward County,7,1664,881,783
Kansas,Seward County,8,1440,757,683
Kansas,Seward County,9,1445,751,694
Kansas,Seward County,10,1429,754,675
Kansas,Seward County,11,1379,712,667
Kansas,Seward County,12,1185,622,563
Kansas,Seward County,13,933,469,464
Kansas,Seward County,14,665,330,335
Kansas,Seward County,15,483,234,249
Kansas,Seward County,16,348,145,203
Kansas,Seward County,17,293,102,191
Kansas,Seward County,18,286,73,213
Kansas,Shawnee County,0,178406,86464,91942
Kansas,Shawnee County,1,11906,6096,5810
Kansas,Shawnee County,2,12048,6092,5956
Kansas,Shawnee County,3,12118,6263,5855
Kansas,Shawnee County,4,11479,5856,5623
Kansas,Shawnee County,5,11100,5565,5535
Kansas,Shawnee County,6,11245,5380,5865
Kansas,Shawnee County,7,11769,5806,5963
Kansas,Shawnee County,8,10291,5031,5260
Kansas,Shawnee County,9,10120,4987,5133
Kansas,Shawnee County,10,10688,5266,5422
Kansas,Shawnee County,11,12386,5903,6483
Kansas,Shawnee County,12,12764,6061,6703
Kansas,Shawnee County,13,11804,5613,6191
Kansas,Shawnee County,14,9141,4408,4733
Kansas,Shawnee County,15,6597,3006,3591
Kansas,Shawnee County,16,4959,2171,2788
Kansas,Shawnee County,17,3710,1559,2151
Kansas,Shawnee County,18,4281,1401,2880
Kansas,Sheridan County,0,2539,1299,1240
Kansas,Sheridan County,1,122,71,51
Kansas,Sheridan County,2,179,96,83
Kansas,Sheridan County,3,196,103,93
Kansas,Sheridan County,4,140,68,72
Kansas,Sheridan County,5,115,67,48
Kansas,Sheridan County,6,125,67,58
Kansas,Sheridan County,7,113,65,48
Kansas,Sheridan County,8,129,53,76
Kansas,Sheridan County,9,125,73,52
Kansas,Sheridan County,10,120,60,60
Kansas,Sheridan County,11,204,110,94
Kansas,Sheridan County,12,213,112,101
Kansas,Sheridan County,13,181,93,88
Kansas,Sheridan County,14,140,74,66
Kansas,Sheridan County,15,115,56,59
Kansas,Sheridan County,16,106,49,57
Kansas,Sheridan County,17,105,42,63
Kansas,Sheridan County,18,111,40,71
Kansas,Sherman County,0,6110,3058,3052
Kansas,Sherman County,1,427,234,193
Kansas,Sherman County,2,397,189,208
Kansas,Sherman County,3,388,207,181
Kansas,Sherman County,4,400,213,187
Kansas,Sherman County,5,387,235,152
Kansas,Sherman County,6,384,192,192
Kansas,Sherman County,7,377,187,190
Kansas,Sherman County,8,313,153,160
Kansas,Sherman County,9,304,138,166
Kansas,Sherman County,10,333,174,159
Kansas,Sherman County,11,422,206,216
Kansas,Sherman County,12,459,235,224
Kansas,Sherman County,13,399,203,196
Kansas,Sherman County,14,313,155,158
Kansas,Sherman County,15,244,107,137
Kansas,Sherman County,16,212,99,113
Kansas,Sherman County,17,165,76,89
Kansas,Sherman County,18,186,55,131
Kansas,Smith County,0,3769,1879,1890
Kansas,Smith County,1,197,101,96
Kansas,Smith County,2,194,95,99
Kansas,Smith County,3,216,111,105
Kansas,Smith County,4,217,113,104
Kansas,Smith County,5,173,97,76
Kansas,Smith County,6,136,64,72
Kansas,Smith County,7,187,94,93
Kansas,Smith County,8,175,93,82
Kansas,Smith County,9,157,78,79
Kansas,Smith County,10,187,89,98
Kansas,Smith County,11,325,168,157
Kansas,Smith County,12,317,162,155
Kansas,Smith County,13,298,160,138
Kansas,Smith County,14,256,134,122
Kansas,Smith County,15,175,85,90
Kansas,Smith County,16,184,79,105
Kansas,Smith County,17,162,71,91
Kansas,Smith County,18,213,85,128
Kansas,Stafford County,0,4297,2189,2108
Kansas,Stafford County,1,227,103,124
Kansas,Stafford County,2,277,152,125
Kansas,Stafford County,3,314,190,124
Kansas,Stafford County,4,313,180,133
Kansas,Stafford County,5,213,103,110
Kansas,Stafford County,6,210,110,100
Kansas,Stafford County,7,208,114,94
Kansas,Stafford County,8,198,96,102
Kansas,Stafford County,9,205,95,110
Kansas,Stafford County,10,250,127,123
Kansas,Stafford County,11,365,191,174
Kansas,Stafford County,12,349,183,166
Kansas,Stafford County,13,288,146,142
Kansas,Stafford County,14,211,106,105
Kansas,Stafford County,15,203,102,101
Kansas,Stafford County,16,145,61,84
Kansas,Stafford County,17,162,71,91
Kansas,Stafford County,18,159,59,100
Kansas,Stanton County,0,2111,1062,1049
Kansas,Stanton County,1,167,75,92
Kansas,Stanton County,2,161,77,84
Kansas,Stanton County,3,164,87,77
Kansas,Stanton County,4,146,81,65
Kansas,Stanton County,5,104,47,57
Kansas,Stanton County,6,111,69,42
Kansas,Stanton County,7,118,55,63
Kansas,Stanton County,8,139,71,68
Kansas,Stanton County,9,121,55,66
Kansas,Stanton County,10,121,67,54
Kansas,Stanton County,11,143,73,70
Kansas,Stanton County,12,150,77,73
Kansas,Stanton County,13,116,65,51
Kansas,Stanton County,14,81,35,46
Kansas,Stanton County,15,72,36,36
Kansas,Stanton County,16,85,38,47
Kansas,Stanton County,17,47,24,23
Kansas,Stanton County,18,65,30,35
Kansas,Stevens County,0,5801,2898,2903
Kansas,Stevens County,1,454,238,216
Kansas,Stevens County,2,568,251,317
Kansas,Stevens County,3,481,232,249
Kansas,Stevens County,4,447,255,192
Kansas,Stevens County,5,334,170,164
Kansas,Stevens County,6,281,141,140
Kansas,Stevens County,7,361,159,202
Kansas,Stevens County,8,343,193,150
Kansas,Stevens County,9,345,176,169
Kansas,Stevens County,10,371,205,166
Kansas,Stevens County,11,376,203,173
Kansas,Stevens County,12,369,185,184
Kansas,Stevens County,13,303,160,143
Kansas,Stevens County,14,208,97,111
Kansas,Stevens County,15,173,88,85
Kansas,Stevens County,16,127,54,73
Kansas,Stevens County,17,106,40,66
Kansas,Stevens County,18,154,51,103
Kansas,Sumner County,0,23528,11740,11788
Kansas,Sumner County,1,1552,759,793
Kansas,Sumner County,2,1573,798,775
Kansas,Sumner County,3,1722,847,875
Kansas,Sumner County,4,1578,816,762
Kansas,Sumner County,5,1307,683,624
Kansas,Sumner County,6,1268,683,585
Kansas,Sumner County,7,1350,717,633
Kansas,Sumner County,8,1279,659,620
Kansas,Sumner County,9,1247,635,612
Kansas,Sumner County,10,1365,676,689
Kansas,Sumner County,11,1753,871,882
Kansas,Sumner County,12,1922,982,940
Kansas,Sumner County,13,1587,819,768
Kansas,Sumner County,14,1219,587,632
Kansas,Sumner County,15,920,449,471
Kansas,Sumner County,16,709,322,387
Kansas,Sumner County,17,582,248,334
Kansas,Sumner County,18,595,189,406
Kansas,Thomas County,0,7891,3885,4006
Kansas,Thomas County,1,572,298,274
Kansas,Thomas County,2,486,249,237
Kansas,Thomas County,3,450,219,231
Kansas,Thomas County,4,692,332,360
Kansas,Thomas County,5,717,335,382
Kansas,Thomas County,6,525,277,248
Kansas,Thomas County,7,476,253,223
Kansas,Thomas County,8,400,216,184
Kansas,Thomas County,9,389,190,199
Kansas,Thomas County,10,362,181,181
Kansas,Thomas County,11,557,269,288
Kansas,Thomas County,12,546,264,282
Kansas,Thomas County,13,499,263,236
Kansas,Thomas County,14,331,171,160
Kansas,Thomas County,15,266,125,141
Kansas,Thomas County,16,211,96,115
Kansas,Thomas County,17,186,65,121
Kansas,Thomas County,18,226,82,144
Kansas,Trego County,0,2902,1434,1468
Kansas,Trego County,1,129,59,70
Kansas,Trego County,2,136,74,62
Kansas,Trego County,3,153,77,76
Kansas,Trego County,4,156,75,81
Kansas,Trego County,5,135,68,67
Kansas,Trego County,6,147,78,69
Kansas,Trego County,7,150,67,83
Kansas,Trego County,8,132,66,66
Kansas,Trego County,9,159,92,67
Kansas,Trego County,10,153,71,82
Kansas,Trego County,11,244,120,124
Kansas,Trego County,12,264,136,128
Kansas,Trego County,13,243,117,126
Kansas,Trego County,14,179,97,82
Kansas,Trego County,15,152,78,74
Kansas,Trego County,16,130,59,71
Kansas,Trego County,17,115,48,67
Kansas,Trego County,18,125,52,73
Kansas,Wabaunsee County,0,7022,3559,3463
Kansas,Wabaunsee County,1,527,267,260
Kansas,Wabaunsee County,2,442,219,223
Kansas,Wabaunsee County,3,492,249,243
Kansas,Wabaunsee County,4,444,235,209
Kansas,Wabaunsee County,5,327,161,166
Kansas,Wabaunsee County,6,335,189,146
Kansas,Wabaunsee County,7,368,181,187
Kansas,Wabaunsee County,8,382,199,183
Kansas,Wabaunsee County,9,387,193,194
Kansas,Wabaunsee County,10,402,206,196
Kansas,Wabaunsee County,11,579,293,286
Kansas,Wabaunsee County,12,599,314,285
Kansas,Wabaunsee County,13,506,262,244
Kansas,Wabaunsee County,14,381,205,176
Kansas,Wabaunsee County,15,315,150,165
Kansas,Wabaunsee County,16,231,116,115
Kansas,Wabaunsee County,17,163,70,93
Kansas,Wabaunsee County,18,142,50,92
Kansas,Wallace County,0,1506,741,765
Kansas,Wallace County,1,87,39,48
Kansas,Wallace County,2,100,43,57
Kansas,Wallace County,3,115,52,63
Kansas,Wallace County,4,106,57,49
Kansas,Wallace County,5,81,38,43
Kansas,Wallace County,6,63,37,26
Kansas,Wallace County,7,76,38,38
Kansas,Wallace County,8,75,39,36
Kansas,Wallace County,9,64,31,33
Kansas,Wallace County,10,73,33,40
Kansas,Wallace County,11,119,55,64
Kansas,Wallace County,12,118,72,46
Kansas,Wallace County,13,106,52,54
Kansas,Wallace County,14,81,48,33
Kansas,Wallace County,15,55,32,23
Kansas,Wallace County,16,64,25,39
Kansas,Wallace County,17,54,23,31
Kansas,Wallace County,18,69,27,42
Kansas,Washington County,0,5598,2822,2776
Kansas,Washington County,1,310,165,145
Kansas,Washington County,2,347,175,172
Kansas,Washington County,3,351,184,167
Kansas,Washington County,4,374,205,169
Kansas,Washington County,5,287,160,127
Kansas,Washington County,6,227,116,111
Kansas,Washington County,7,320,170,150
Kansas,Washington County,8,265,144,121
Kansas,Washington County,9,277,145,132
Kansas,Washington County,10,312,157,155
Kansas,Washington County,11,429,224,205
Kansas,Washington County,12,419,208,211
Kansas,Washington County,13,360,181,179
Kansas,Washington County,14,335,176,159
Kansas,Washington County,15,296,137,159
Kansas,Washington County,16,234,100,134
Kansas,Washington County,17,212,79,133
Kansas,Washington County,18,243,96,147
Kansas,Wichita County,0,2176,1128,1048
Kansas,Wichita County,1,167,87,80
Kansas,Wichita County,2,150,71,79
Kansas,Wichita County,3,159,76,83
Kansas,Wichita County,4,153,93,60
Kansas,Wichita County,5,110,64,46
Kansas,Wichita County,6,101,50,51
Kansas,Wichita County,7,113,53,60
Kansas,Wichita County,8,127,72,55
Kansas,Wichita County,9,121,69,52
Kansas,Wichita County,10,117,64,53
Kansas,Wichita County,11,147,76,71
Kansas,Wichita County,12,169,99,70
Kansas,Wichita County,13,150,72,78
Kansas,Wichita County,14,97,54,43
Kansas,Wichita County,15,84,40,44
Kansas,Wichita County,16,76,35,41
Kansas,Wichita County,17,55,24,31
Kansas,Wichita County,18,80,29,51
Kansas,Wilson County,0,9028,4456,4572
Kansas,Wilson County,1,526,290,236
Kansas,Wilson County,2,582,284,298
Kansas,Wilson County,3,645,332,313
Kansas,Wilson County,4,599,310,289
Kansas,Wilson County,5,458,251,207
Kansas,Wilson County,6,429,213,216
Kansas,Wilson County,7,517,239,278
Kansas,Wilson County,8,469,243,226
Kansas,Wilson County,9,490,249,241
Kansas,Wilson County,10,485,233,252
Kansas,Wilson County,11,615,298,317
Kansas,Wilson County,12,731,364,367
Kansas,Wilson County,13,664,326,338
Kansas,Wilson County,14,554,278,276
Kansas,Wilson County,15,454,221,233
Kansas,Wilson County,16,328,154,174
Kansas,Wilson County,17,213,88,125
Kansas,Wilson County,18,269,83,186
Kansas,Woodson County,0,3157,1566,1591
Kansas,Woodson County,1,151,74,77
Kansas,Woodson County,2,183,93,90
Kansas,Woodson County,3,202,103,99
Kansas,Woodson County,4,185,93,92
Kansas,Woodson County,5,130,66,64
Kansas,Woodson County,6,166,77,89
Kansas,Woodson County,7,199,97,102
Kansas,Woodson County,8,147,82,65
Kansas,Woodson County,9,127,79,48
Kansas,Woodson County,10,184,85,99
Kansas,Woodson County,11,242,123,119
Kansas,Woodson County,12,269,132,137
Kansas,Woodson County,13,258,135,123
Kansas,Woodson County,14,210,103,107
Kansas,Woodson County,15,158,79,79
Kansas,Woodson County,16,97,41,56
Kansas,Woodson County,17,118,51,67
Kansas,Woodson County,18,131,53,78
Kansas,Wyandotte County,0,161636,79658,81978
Kansas,Wyandotte County,1,13519,6891,6628
Kansas,Wyandotte County,2,13561,6973,6588
Kansas,Wyandotte County,3,12038,6100,5938
Kansas,Wyandotte County,4,10439,5198,5241
Kansas,Wyandotte County,5,11039,5552,5487
Kansas,Wyandotte County,6,11753,5820,5933
Kansas,Wyandotte County,7,12570,6352,6218
Kansas,Wyandotte County,8,10390,5232,5158
Kansas,Wyandotte County,9,9797,4935,4862
Kansas,Wyandotte County,10,9255,4634,4621
Kansas,Wyandotte County,11,10669,5288,5381
Kansas,Wyandotte County,12,10149,4940,5209
Kansas,Wyandotte County,13,8288,3977,4311
Kansas,Wyandotte County,14,6158,2827,3331
Kansas,Wyandotte County,15,4339,1961,2378
Kansas,Wyandotte County,16,2983,1245,1738
Kansas,Wyandotte County,17,2233,887,1346
Kansas,Wyandotte County,18,2456,846,1610
Kentucky,Adair County,0,19204,9481,9723
Kentucky,Adair County,1,1061,568,493
Kentucky,Adair County,2,1105,578,527
Kentucky,Adair County,3,1148,576,572
Kentucky,Adair County,4,1603,836,767
Kentucky,Adair County,5,1670,828,842
Kentucky,Adair County,6,1116,557,559
Kentucky,Adair County,7,1040,504,536
Kentucky,Adair County,8,996,487,509
Kentucky,Adair County,9,1137,593,544
Kentucky,Adair County,10,1284,639,645
Kentucky,Adair County,11,1397,639,758
Kentucky,Adair County,12,1271,612,659
Kentucky,Adair County,13,1218,614,604
Kentucky,Adair County,14,1049,518,531
Kentucky,Adair County,15,795,394,401
Kentucky,Adair County,16,610,270,340
Kentucky,Adair County,17,367,150,217
Kentucky,Adair County,18,337,118,219
Kentucky,Allen County,0,20384,10066,10318
Kentucky,Allen County,1,1257,620,637
Kentucky,Allen County,2,1354,688,666
Kentucky,Allen County,3,1455,758,697
Kentucky,Allen County,4,1231,666,565
Kentucky,Allen County,5,1262,592,670
Kentucky,Allen County,6,1214,621,593
Kentucky,Allen County,7,1167,568,599
Kentucky,Allen County,8,1198,592,606
Kentucky,Allen County,9,1374,720,654
Kentucky,Allen County,10,1389,664,725
Kentucky,Allen County,11,1501,705,796
Kentucky,Allen County,12,1399,743,656
Kentucky,Allen County,13,1295,617,678
Kentucky,Allen County,14,1144,539,605
Kentucky,Allen County,15,857,420,437
Kentucky,Allen County,16,597,277,320
Kentucky,Allen County,17,389,175,214
Kentucky,Allen County,18,301,101,200
Kentucky,Anderson County,0,21888,10711,11177
Kentucky,Anderson County,1,1238,682,556
Kentucky,Anderson County,2,1510,792,718
Kentucky,Anderson County,3,1545,789,756
Kentucky,Anderson County,4,1439,740,699
Kentucky,Anderson County,5,1216,608,608
Kentucky,Anderson County,6,1184,576,608
Kentucky,Anderson County,7,1274,589,685
Kentucky,Anderson County,8,1421,702,719
Kentucky,Anderson County,9,1671,825,846
Kentucky,Anderson County,10,1637,809,828
Kentucky,Anderson County,11,1763,838,925
Kentucky,Anderson County,12,1507,755,752
Kentucky,Anderson County,13,1365,661,704
Kentucky,Anderson County,14,1111,519,592
Kentucky,Anderson County,15,777,366,411
Kentucky,Anderson County,16,513,226,287
Kentucky,Anderson County,17,341,140,201
Kentucky,Anderson County,18,376,94,282
Kentucky,Ballard County,0,8240,4065,4175
Kentucky,Ballard County,1,426,216,210
Kentucky,Ballard County,2,463,247,216
Kentucky,Ballard County,3,557,295,262
Kentucky,Ballard County,4,539,265,274
Kentucky,Ballard County,5,430,237,193
Kentucky,Ballard County,6,437,215,222
Kentucky,Ballard County,7,430,215,215
Kentucky,Ballard County,8,486,255,231
Kentucky,Ballard County,9,549,264,285
Kentucky,Ballard County,10,543,266,277
Kentucky,Ballard County,11,562,278,284
Kentucky,Ballard County,12,651,308,343
Kentucky,Ballard County,13,560,282,278
Kentucky,Ballard County,14,515,247,268
Kentucky,Ballard County,15,412,190,222
Kentucky,Ballard County,16,283,136,147
Kentucky,Ballard County,17,208,89,119
Kentucky,Ballard County,18,189,60,129
Kentucky,Barren County,0,43148,20943,22205
Kentucky,Barren County,1,2695,1384,1311
Kentucky,Barren County,2,2904,1469,1435
Kentucky,Barren County,3,2859,1417,1442
Kentucky,Barren County,4,2713,1400,1313
Kentucky,Barren County,5,2471,1251,1220
Kentucky,Barren County,6,2427,1201,1226
Kentucky,Barren County,7,2680,1336,1344
Kentucky,Barren County,8,2523,1223,1300
Kentucky,Barren County,9,2777,1417,1360
Kentucky,Barren County,10,2916,1418,1498
Kentucky,Barren County,11,3192,1553,1639
Kentucky,Barren County,12,3076,1495,1581
Kentucky,Barren County,13,2659,1278,1381
Kentucky,Barren County,14,2328,1142,1186
Kentucky,Barren County,15,1803,788,1015
Kentucky,Barren County,16,1241,542,699
Kentucky,Barren County,17,970,347,623
Kentucky,Barren County,18,914,282,632
Kentucky,Bath County,0,12206,6040,6166
Kentucky,Bath County,1,805,422,383
Kentucky,Bath County,2,862,444,418
Kentucky,Bath County,3,895,475,420
Kentucky,Bath County,4,795,421,374
Kentucky,Bath County,5,693,333,360
Kentucky,Bath County,6,597,291,306
Kentucky,Bath County,7,665,292,373
Kentucky,Bath County,8,770,400,370
Kentucky,Bath County,9,811,397,414
Kentucky,Bath County,10,832,406,426
Kentucky,Bath County,11,878,444,434
Kentucky,Bath County,12,856,429,427
Kentucky,Bath County,13,794,391,403
Kentucky,Bath County,14,665,318,347
Kentucky,Bath County,15,482,231,251
Kentucky,Bath County,16,384,180,204
Kentucky,Bath County,17,234,94,140
Kentucky,Bath County,18,188,72,116
Kentucky,Bell County,0,27778,13531,14247
Kentucky,Bell County,1,1788,909,879
Kentucky,Bell County,2,1588,785,803
Kentucky,Bell County,3,1606,846,760
Kentucky,Bell County,4,1583,820,763
Kentucky,Bell County,5,1856,958,898
Kentucky,Bell County,6,1635,793,842
Kentucky,Bell County,7,1625,849,776
Kentucky,Bell County,8,1648,796,852
Kentucky,Bell County,9,1882,946,936
Kentucky,Bell County,10,1872,902,970
Kentucky,Bell County,11,2082,1043,1039
Kentucky,Bell County,12,1983,971,1012
Kentucky,Bell County,13,1837,867,970
Kentucky,Bell County,14,1657,776,881
Kentucky,Bell County,15,1256,566,690
Kentucky,Bell County,16,798,341,457
Kentucky,Bell County,17,585,212,373
Kentucky,Bell County,18,497,151,346
Kentucky,Boone County,0,126413,62704,63709
Kentucky,Boone County,1,9084,4664,4420
Kentucky,Boone County,2,9576,4845,4731
Kentucky,Boone County,3,10148,5178,4970
Kentucky,Boone County,4,8553,4473,4080
Kentucky,Boone County,5,7194,3684,3510
Kentucky,Boone County,6,7464,3712,3752
Kentucky,Boone County,7,8546,4201,4345
Kentucky,Boone County,8,8714,4265,4449
Kentucky,Boone County,9,9395,4775,4620
Kentucky,Boone County,10,9358,4659,4699
Kentucky,Boone County,11,9168,4531,4637
Kentucky,Boone County,12,8254,4125,4129
Kentucky,Boone County,13,6811,3248,3563
Kentucky,Boone County,14,5428,2571,2857
Kentucky,Boone County,15,3515,1624,1891
Kentucky,Boone County,16,2334,1048,1286
Kentucky,Boone County,17,1521,652,869
Kentucky,Boone County,18,1350,449,901
Kentucky,Bourbon County,0,19972,9750,10222
Kentucky,Bourbon County,1,1135,594,541
Kentucky,Bourbon County,2,1275,633,642
Kentucky,Bourbon County,3,1313,663,650
Kentucky,Bourbon County,4,1261,664,597
Kentucky,Bourbon County,5,1187,628,559
Kentucky,Bourbon County,6,1038,519,519
Kentucky,Bourbon County,7,1088,537,551
Kentucky,Bourbon County,8,1155,580,575
Kentucky,Bourbon County,9,1367,646,721
Kentucky,Bourbon County,10,1370,660,710
Kentucky,Bourbon County,11,1564,775,789
Kentucky,Bourbon County,12,1437,689,748
Kentucky,Bourbon County,13,1278,606,672
Kentucky,Bourbon County,14,1151,570,581
Kentucky,Bourbon County,15,904,414,490
Kentucky,Bourbon County,16,613,268,345
Kentucky,Bourbon County,17,438,172,266
Kentucky,Bourbon County,18,398,132,266
Kentucky,Boyd County,0,48832,24290,24542
Kentucky,Boyd County,1,2827,1442,1385
Kentucky,Boyd County,2,2900,1443,1457
Kentucky,Boyd County,3,2835,1491,1344
Kentucky,Boyd County,4,2757,1384,1373
Kentucky,Boyd County,5,2708,1375,1333
Kentucky,Boyd County,6,2813,1462,1351
Kentucky,Boyd County,7,3117,1642,1475
Kentucky,Boyd County,8,3038,1651,1387
Kentucky,Boyd County,9,3241,1717,1524
Kentucky,Boyd County,10,3278,1706,1572
Kentucky,Boyd County,11,3564,1803,1761
Kentucky,Boyd County,12,3763,1830,1933
Kentucky,Boyd County,13,3255,1546,1709
Kentucky,Boyd County,14,2799,1364,1435
Kentucky,Boyd County,15,2104,994,1110
Kentucky,Boyd County,16,1604,666,938
Kentucky,Boyd County,17,1168,436,732
Kentucky,Boyd County,18,1061,338,723
Kentucky,Boyle County,0,29706,14860,14846
Kentucky,Boyle County,1,1551,825,726
Kentucky,Boyle County,2,1620,830,790
Kentucky,Boyle County,3,1804,927,877
Kentucky,Boyle County,4,2162,1044,1118
Kentucky,Boyle County,5,2502,1313,1189
Kentucky,Boyle County,6,1710,1046,664
Kentucky,Boyle County,7,1622,889,733
Kentucky,Boyle County,8,1654,854,800
Kentucky,Boyle County,9,1973,1073,900
Kentucky,Boyle County,10,2002,1018,984
Kentucky,Boyle County,11,2005,956,1049
Kentucky,Boyle County,12,1999,962,1037
Kentucky,Boyle County,13,1875,883,992
Kentucky,Boyle County,14,1656,785,871
Kentucky,Boyle County,15,1250,567,683
Kentucky,Boyle County,16,870,369,501
Kentucky,Boyle County,17,717,282,435
Kentucky,Boyle County,18,734,237,497
Kentucky,Bracken County,0,8406,4189,4217
Kentucky,Bracken County,1,535,276,259
Kentucky,Bracken County,2,582,307,275
Kentucky,Bracken County,3,579,297,282
Kentucky,Bracken County,4,515,264,251
Kentucky,Bracken County,5,467,220,247
Kentucky,Bracken County,6,475,239,236
Kentucky,Bracken County,7,482,246,236
Kentucky,Bracken County,8,482,243,239
Kentucky,Bracken County,9,550,276,274
Kentucky,Bracken County,10,588,294,294
Kentucky,Bracken County,11,685,328,357
Kentucky,Bracken County,12,600,318,282
Kentucky,Bracken County,13,569,289,280
Kentucky,Bracken County,14,444,213,231
Kentucky,Bracken County,15,332,168,164
Kentucky,Bracken County,16,245,110,135
Kentucky,Bracken County,17,160,62,98
Kentucky,Bracken County,18,116,39,77
Kentucky,Breathitt County,0,13409,6706,6703
Kentucky,Breathitt County,1,774,423,351
Kentucky,Breathitt County,2,776,399,377
Kentucky,Breathitt County,3,720,381,339
Kentucky,Breathitt County,4,850,467,383
Kentucky,Breathitt County,5,878,461,417
Kentucky,Breathitt County,6,759,386,373
Kentucky,Breathitt County,7,803,410,393
Kentucky,Breathitt County,8,874,438,436
Kentucky,Breathitt County,9,913,447,466
Kentucky,Breathitt County,10,960,463,497
Kentucky,Breathitt County,11,1055,540,515
Kentucky,Breathitt County,12,1047,508,539
Kentucky,Breathitt County,13,935,450,485
Kentucky,Breathitt County,14,758,383,375
Kentucky,Breathitt County,15,532,246,286
Kentucky,Breathitt County,16,372,150,222
Kentucky,Breathitt County,17,235,93,142
Kentucky,Breathitt County,18,168,61,107
Kentucky,Breckinridge County,0,19888,9947,9941
Kentucky,Breckinridge County,1,1122,602,520
Kentucky,Breckinridge County,2,1247,602,645
Kentucky,Breckinridge County,3,1362,738,624
Kentucky,Breckinridge County,4,1266,618,648
Kentucky,Breckinridge County,5,1076,577,499
Kentucky,Breckinridge County,6,974,522,452
Kentucky,Breckinridge County,7,1102,561,541
Kentucky,Breckinridge County,8,1090,544,546
Kentucky,Breckinridge County,9,1196,572,624
Kentucky,Breckinridge County,10,1342,661,681
Kentucky,Breckinridge County,11,1625,811,814
Kentucky,Breckinridge County,12,1538,778,760
Kentucky,Breckinridge County,13,1451,718,733
Kentucky,Breckinridge County,14,1248,628,620
Kentucky,Breckinridge County,15,900,434,466
Kentucky,Breckinridge County,16,635,304,331
Kentucky,Breckinridge County,17,394,154,240
Kentucky,Breckinridge County,18,320,123,197
Kentucky,Bullitt County,0,77955,38591,39364
Kentucky,Bullitt County,1,4053,2123,1930
Kentucky,Bullitt County,2,4985,2557,2428
Kentucky,Bullitt County,3,5547,2856,2691
Kentucky,Bullitt County,4,5134,2571,2563
Kentucky,Bullitt County,5,4886,2485,2401
Kentucky,Bullitt County,6,4671,2353,2318
Kentucky,Bullitt County,7,5008,2452,2556
Kentucky,Bullitt County,8,5065,2466,2599
Kentucky,Bullitt County,9,5672,2812,2860
Kentucky,Bullitt County,10,5765,2841,2924
Kentucky,Bullitt County,11,6269,3154,3115
Kentucky,Bullitt County,12,5649,2771,2878
Kentucky,Bullitt County,13,4646,2274,2372
Kentucky,Bullitt County,14,4024,1926,2098
Kentucky,Bullitt County,15,2853,1385,1468
Kentucky,Bullitt County,16,1775,787,988
Kentucky,Bullitt County,17,1131,469,662
Kentucky,Bullitt County,18,822,309,513
Kentucky,Butler County,0,12875,6365,6510
Kentucky,Butler County,1,746,355,391
Kentucky,Butler County,2,840,407,433
Kentucky,Butler County,3,836,422,414
Kentucky,Butler County,4,761,401,360
Kentucky,Butler County,5,667,342,325
Kentucky,Butler County,6,770,362,408
Kentucky,Butler County,7,859,441,418
Kentucky,Butler County,8,764,400,364
Kentucky,Butler County,9,848,456,392
Kentucky,Butler County,10,804,393,411
Kentucky,Butler County,11,950,483,467
Kentucky,Butler County,12,940,460,480
Kentucky,Butler County,13,840,412,428
Kentucky,Butler County,14,714,356,358
Kentucky,Butler County,15,604,306,298
Kentucky,Butler County,16,404,184,220
Kentucky,Butler County,17,260,103,157
Kentucky,Butler County,18,268,82,186
Kentucky,Caldwell County,0,12725,6157,6568
Kentucky,Caldwell County,1,751,392,359
Kentucky,Caldwell County,2,805,400,405
Kentucky,Caldwell County,3,780,389,391
Kentucky,Caldwell County,4,755,391,364
Kentucky,Caldwell County,5,738,383,355
Kentucky,Caldwell County,6,671,314,357
Kentucky,Caldwell County,7,650,317,333
Kentucky,Caldwell County,8,713,323,390
Kentucky,Caldwell County,9,873,445,428
Kentucky,Caldwell County,10,789,407,382
Kentucky,Caldwell County,11,900,452,448
Kentucky,Caldwell County,12,955,454,501
Kentucky,Caldwell County,13,895,427,468
Kentucky,Caldwell County,14,806,385,421
Kentucky,Caldwell County,15,613,272,341
Kentucky,Caldwell County,16,418,203,215
Kentucky,Caldwell County,17,330,116,214
Kentucky,Caldwell County,18,283,87,196
Kentucky,Calloway County,0,38282,18405,19877
Kentucky,Calloway County,1,1966,986,980
Kentucky,Calloway County,2,1922,962,960
Kentucky,Calloway County,3,1857,944,913
Kentucky,Calloway County,4,3348,1447,1901
Kentucky,Calloway County,5,5910,2824,3086
Kentucky,Calloway County,6,2466,1275,1191
Kentucky,Calloway County,7,2042,1055,987
Kentucky,Calloway County,8,1885,965,920
Kentucky,Calloway County,9,1988,985,1003
Kentucky,Calloway County,10,2068,1024,1044
Kentucky,Calloway County,11,2341,1147,1194
Kentucky,Calloway County,12,2273,1060,1213
Kentucky,Calloway County,13,2119,1000,1119
Kentucky,Calloway County,14,1973,950,1023
Kentucky,Calloway County,15,1608,731,877
Kentucky,Calloway County,16,1076,506,570
Kentucky,Calloway County,17,751,316,435
Kentucky,Calloway County,18,689,228,461
Kentucky,Campbell County,0,91833,45088,46745
Kentucky,Campbell County,1,5646,2953,2693
Kentucky,Campbell County,2,5503,2782,2721
Kentucky,Campbell County,3,5590,2863,2727
Kentucky,Campbell County,4,6327,3151,3176
Kentucky,Campbell County,5,6871,3475,3396
Kentucky,Campbell County,6,6765,3365,3400
Kentucky,Campbell County,7,6413,3263,3150
Kentucky,Campbell County,8,5434,2684,2750
Kentucky,Campbell County,9,5523,2770,2753
Kentucky,Campbell County,10,5979,2974,3005
Kentucky,Campbell County,11,6831,3353,3478
Kentucky,Campbell County,12,6720,3273,3447
Kentucky,Campbell County,13,5567,2703,2864
Kentucky,Campbell County,14,4280,2047,2233
Kentucky,Campbell County,15,2960,1331,1629
Kentucky,Campbell County,16,2169,888,1281
Kentucky,Campbell County,17,1641,689,952
Kentucky,Campbell County,18,1614,524,1090
Kentucky,Carlisle County,0,4978,2427,2551
Kentucky,Carlisle County,1,283,155,128
Kentucky,Carlisle County,2,328,161,167
Kentucky,Carlisle County,3,310,153,157
Kentucky,Carlisle County,4,288,143,145
Kentucky,Carlisle County,5,266,127,139
Kentucky,Carlisle County,6,275,134,141
Kentucky,Carlisle County,7,300,144,156
Kentucky,Carlisle County,8,279,152,127
Kentucky,Carlisle County,9,306,154,152
Kentucky,Carlisle County,10,319,147,172
Kentucky,Carlisle County,11,352,200,152
Kentucky,Carlisle County,12,352,172,180
Kentucky,Carlisle County,13,331,157,174
Kentucky,Carlisle County,14,286,139,147
Kentucky,Carlisle County,15,221,110,111
Kentucky,Carlisle County,16,189,88,101
Kentucky,Carlisle County,17,144,47,97
Kentucky,Carlisle County,18,149,44,105
Kentucky,Carroll County,0,10815,5403,5412
Kentucky,Carroll County,1,856,414,442
Kentucky,Carroll County,2,786,406,380
Kentucky,Carroll County,3,691,329,362
Kentucky,Carroll County,4,696,365,331
Kentucky,Carroll County,5,682,361,321
Kentucky,Carroll County,6,616,319,297
Kentucky,Carroll County,7,740,392,348
Kentucky,Carroll County,8,608,300,308
Kentucky,Carroll County,9,699,369,330
Kentucky,Carroll County,10,683,343,340
Kentucky,Carroll County,11,804,404,400
Kentucky,Carroll County,12,722,377,345
Kentucky,Carroll County,13,647,316,331
Kentucky,Carroll County,14,556,265,291
Kentucky,Carroll County,15,372,189,183
Kentucky,Carroll County,16,279,120,159
Kentucky,Carroll County,17,190,81,109
Kentucky,Carroll County,18,188,53,135
Kentucky,Carter County,0,27223,13424,13799
Kentucky,Carter County,1,1672,827,845
Kentucky,Carter County,2,1690,902,788
Kentucky,Carter County,3,1669,882,787
Kentucky,Carter County,4,1796,923,873
Kentucky,Carter County,5,1968,992,976
Kentucky,Carter County,6,1522,744,778
Kentucky,Carter County,7,1545,794,751
Kentucky,Carter County,8,1614,793,821
Kentucky,Carter County,9,1750,851,899
Kentucky,Carter County,10,1872,925,947
Kentucky,Carter County,11,1926,937,989
Kentucky,Carter County,12,1948,980,968
Kentucky,Carter County,13,1764,835,929
Kentucky,Carter County,14,1611,790,821
Kentucky,Carter County,15,1113,494,619
Kentucky,Carter County,16,853,380,473
Kentucky,Carter County,17,501,230,271
Kentucky,Carter County,18,409,145,264
Kentucky,Casey County,0,15891,7741,8150
Kentucky,Casey County,1,1029,491,538
Kentucky,Casey County,2,934,497,437
Kentucky,Casey County,3,1018,503,515
Kentucky,Casey County,4,936,463,473
Kentucky,Casey County,5,915,445,470
Kentucky,Casey County,6,892,434,458
Kentucky,Casey County,7,909,449,460
Kentucky,Casey County,8,927,464,463
Kentucky,Casey County,9,1038,520,518
Kentucky,Casey County,10,1049,546,503
Kentucky,Casey County,11,1102,554,548
Kentucky,Casey County,12,1101,548,553
Kentucky,Casey County,13,1054,511,543
Kentucky,Casey County,14,1038,491,547
Kentucky,Casey County,15,771,377,394
Kentucky,Casey County,16,506,230,276
Kentucky,Casey County,17,346,139,207
Kentucky,Casey County,18,326,79,247
Kentucky,Christian County,0,74250,39159,35091
Kentucky,Christian County,1,7275,3678,3597
Kentucky,Christian County,2,5853,3030,2823
Kentucky,Christian County,3,4929,2468,2461
Kentucky,Christian County,4,4614,2678,1936
Kentucky,Christian County,5,9447,6503,2944
Kentucky,Christian County,6,7100,4117,2983
Kentucky,Christian County,7,5502,2851,2651
Kentucky,Christian County,8,4221,2150,2071
Kentucky,Christian County,9,3534,1803,1731
Kentucky,Christian County,10,3395,1591,1804
Kentucky,Christian County,11,3550,1669,1881
Kentucky,Christian County,12,3475,1631,1844
Kentucky,Christian County,13,3108,1485,1623
Kentucky,Christian County,14,2581,1182,1399
Kentucky,Christian County,15,1990,853,1137
Kentucky,Christian County,16,1563,689,874
Kentucky,Christian County,17,1060,457,603
Kentucky,Christian County,18,1053,324,729
Kentucky,Clark County,0,35758,17360,18398
Kentucky,Clark County,1,2087,1026,1061
Kentucky,Clark County,2,2282,1198,1084
Kentucky,Clark County,3,2336,1223,1113
Kentucky,Clark County,4,2188,1123,1065
Kentucky,Clark County,5,2069,1043,1026
Kentucky,Clark County,6,1983,1007,976
Kentucky,Clark County,7,2080,997,1083
Kentucky,Clark County,8,2277,1090,1187
Kentucky,Clark County,9,2530,1256,1274
Kentucky,Clark County,10,2438,1181,1257
Kentucky,Clark County,11,2730,1325,1405
Kentucky,Clark County,12,2617,1266,1351
Kentucky,Clark County,13,2315,1085,1230
Kentucky,Clark County,14,2045,960,1085
Kentucky,Clark County,15,1438,671,767
Kentucky,Clark County,16,993,408,585
Kentucky,Clark County,17,722,283,439
Kentucky,Clark County,18,628,218,410
Kentucky,Clay County,0,21147,11218,9929
Kentucky,Clay County,1,1307,659,648
Kentucky,Clay County,2,1187,612,575
Kentucky,Clay County,3,1173,636,537
Kentucky,Clay County,4,1239,643,596
Kentucky,Clay County,5,1392,747,645
Kentucky,Clay County,6,1507,905,602
Kentucky,Clay County,7,1610,976,634
Kentucky,Clay County,8,1540,903,637
Kentucky,Clay County,9,1563,893,670
Kentucky,Clay County,10,1551,844,707
Kentucky,Clay County,11,1577,828,749
Kentucky,Clay County,12,1364,694,670
Kentucky,Clay County,13,1275,631,644
Kentucky,Clay County,14,1036,474,562
Kentucky,Clay County,15,723,329,394
Kentucky,Clay County,16,530,230,300
Kentucky,Clay County,17,317,135,182
Kentucky,Clay County,18,256,79,177
Kentucky,Clinton County,0,10165,5054,5111
Kentucky,Clinton County,1,573,275,298
Kentucky,Clinton County,2,616,320,296
Kentucky,Clinton County,3,671,342,329
Kentucky,Clinton County,4,648,354,294
Kentucky,Clinton County,5,585,295,290
Kentucky,Clinton County,6,533,283,250
Kentucky,Clinton County,7,568,263,305
Kentucky,Clinton County,8,577,282,295
Kentucky,Clinton County,9,627,328,299
Kentucky,Clinton County,10,743,357,386
Kentucky,Clinton County,11,739,393,346
Kentucky,Clinton County,12,776,380,396
Kentucky,Clinton County,13,664,334,330
Kentucky,Clinton County,14,629,316,313
Kentucky,Clinton County,15,480,226,254
Kentucky,Clinton County,16,353,154,199
Kentucky,Clinton County,17,238,102,136
Kentucky,Clinton County,18,145,50,95
Kentucky,Crittenden County,0,9224,4658,4566
Kentucky,Crittenden County,1,524,280,244
Kentucky,Crittenden County,2,605,314,291
Kentucky,Crittenden County,3,588,309,279
Kentucky,Crittenden County,4,547,280,267
Kentucky,Crittenden County,5,487,250,237
Kentucky,Crittenden County,6,468,253,215
Kentucky,Crittenden County,7,543,267,276
Kentucky,Crittenden County,8,569,304,265
Kentucky,Crittenden County,9,534,279,255
Kentucky,Crittenden County,10,582,300,282
Kentucky,Crittenden County,11,689,311,378
Kentucky,Crittenden County,12,662,354,308
Kentucky,Crittenden County,13,643,309,334
Kentucky,Crittenden County,14,561,294,267
Kentucky,Crittenden County,15,498,235,263
Kentucky,Crittenden County,16,306,153,153
Kentucky,Crittenden County,17,219,105,114
Kentucky,Crittenden County,18,199,61,138
Kentucky,Cumberland County,0,6745,3292,3453
Kentucky,Cumberland County,1,376,190,186
Kentucky,Cumberland County,2,408,224,184
Kentucky,Cumberland County,3,414,207,207
Kentucky,Cumberland County,4,386,203,183
Kentucky,Cumberland County,5,396,185,211
Kentucky,Cumberland County,6,319,155,164
Kentucky,Cumberland County,7,333,161,172
Kentucky,Cumberland County,8,336,159,177
Kentucky,Cumberland County,9,403,195,208
Kentucky,Cumberland County,10,436,195,241
Kentucky,Cumberland County,11,520,249,271
Kentucky,Cumberland County,12,546,300,246
Kentucky,Cumberland County,13,474,233,241
Kentucky,Cumberland County,14,424,211,213
Kentucky,Cumberland County,15,363,172,191
Kentucky,Cumberland County,16,268,127,141
Kentucky,Cumberland County,17,172,74,98
Kentucky,Cumberland County,18,171,52,119
Kentucky,Daviess County,0,98275,47630,50645
Kentucky,Daviess County,1,6521,3333,3188
Kentucky,Daviess County,2,6793,3449,3344
Kentucky,Daviess County,3,6650,3381,3269
Kentucky,Daviess County,4,6099,3099,3000
Kentucky,Daviess County,5,6106,2977,3129
Kentucky,Daviess County,6,5889,2912,2977
Kentucky,Daviess County,7,6206,3080,3126
Kentucky,Daviess County,8,5707,2871,2836
Kentucky,Daviess County,9,6089,2975,3114
Kentucky,Daviess County,10,6179,3074,3105
Kentucky,Daviess County,11,7233,3497,3736
Kentucky,Daviess County,12,7066,3394,3672
Kentucky,Daviess County,13,6011,2874,3137
Kentucky,Daviess County,14,5103,2374,2729
Kentucky,Daviess County,15,3554,1614,1940
Kentucky,Daviess County,16,2810,1232,1578
Kentucky,Daviess County,17,2098,814,1284
Kentucky,Daviess County,18,2161,680,1481
Kentucky,Edmonson County,0,12013,6025,5988
Kentucky,Edmonson County,1,556,288,268
Kentucky,Edmonson County,2,648,331,317
Kentucky,Edmonson County,3,680,330,350
Kentucky,Edmonson County,4,805,458,347
Kentucky,Edmonson County,5,741,414,327
Kentucky,Edmonson County,6,651,333,318
Kentucky,Edmonson County,7,692,324,368
Kentucky,Edmonson County,8,726,371,355
Kentucky,Edmonson County,9,771,373,398
Kentucky,Edmonson County,10,725,356,369
Kentucky,Edmonson County,11,956,488,468
Kentucky,Edmonson County,12,909,442,467
Kentucky,Edmonson County,13,838,431,407
Kentucky,Edmonson County,14,788,378,410
Kentucky,Edmonson County,15,619,289,330
Kentucky,Edmonson County,16,412,198,214
Kentucky,Edmonson County,17,262,138,124
Kentucky,Edmonson County,18,234,83,151
Kentucky,Elliott County,0,7672,4335,3337
Kentucky,Elliott County,1,341,177,164
Kentucky,Elliott County,2,417,210,207
Kentucky,Elliott County,3,430,222,208
Kentucky,Elliott County,4,387,226,161
Kentucky,Elliott County,5,462,301,161
Kentucky,Elliott County,6,523,354,169
Kentucky,Elliott County,7,513,337,176
Kentucky,Elliott County,8,523,303,220
Kentucky,Elliott County,9,572,371,201
Kentucky,Elliott County,10,540,329,211
Kentucky,Elliott County,11,505,286,219
Kentucky,Elliott County,12,550,284,266
Kentucky,Elliott County,13,503,277,226
Kentucky,Elliott County,14,475,244,231
Kentucky,Elliott County,15,366,175,191
Kentucky,Elliott County,16,281,130,151
Kentucky,Elliott County,17,169,72,97
Kentucky,Elliott County,18,115,37,78
Kentucky,Estill County,0,14447,7121,7326
Kentucky,Estill County,1,784,406,378
Kentucky,Estill County,2,893,434,459
Kentucky,Estill County,3,920,488,432
Kentucky,Estill County,4,835,427,408
Kentucky,Estill County,5,838,445,393
Kentucky,Estill County,6,742,371,371
Kentucky,Estill County,7,850,416,434
Kentucky,Estill County,8,882,456,426
Kentucky,Estill County,9,965,488,477
Kentucky,Estill County,10,1095,557,538
Kentucky,Estill County,11,1163,576,587
Kentucky,Estill County,12,1002,482,520
Kentucky,Estill County,13,1005,472,533
Kentucky,Estill County,14,862,402,460
Kentucky,Estill County,15,695,325,370
Kentucky,Estill County,16,452,206,246
Kentucky,Estill County,17,269,105,164
Kentucky,Estill County,18,195,65,130
Kentucky,Fayette County,0,310797,152661,158136
Kentucky,Fayette County,1,19401,10098,9303
Kentucky,Fayette County,2,18711,9501,9210
Kentucky,Fayette County,3,17446,8861,8585
Kentucky,Fayette County,4,20650,10260,10390
Kentucky,Fayette County,5,34319,17118,17201
Kentucky,Fayette County,6,24341,12369,11972
Kentucky,Fayette County,7,24100,12275,11825
Kentucky,Fayette County,8,21284,10932,10352
Kentucky,Fayette County,9,19864,10040,9824
Kentucky,Fayette County,10,18740,9452,9288
Kentucky,Fayette County,11,20052,9776,10276
Kentucky,Fayette County,12,19048,8989,10059
Kentucky,Fayette County,13,16562,7740,8822
Kentucky,Fayette County,14,12503,5723,6780
Kentucky,Fayette County,15,8510,3731,4779
Kentucky,Fayette County,16,6072,2589,3483
Kentucky,Fayette County,17,4299,1653,2646
Kentucky,Fayette County,18,4895,1554,3341
Kentucky,Fleming County,0,14545,7161,7384
Kentucky,Fleming County,1,1002,543,459
Kentucky,Fleming County,2,917,469,448
Kentucky,Fleming County,3,1034,523,511
Kentucky,Fleming County,4,901,459,442
Kentucky,Fleming County,5,829,407,422
Kentucky,Fleming County,6,782,369,413
Kentucky,Fleming County,7,820,392,428
Kentucky,Fleming County,8,898,456,442
Kentucky,Fleming County,9,931,461,470
Kentucky,Fleming County,10,1060,534,526
Kentucky,Fleming County,11,1032,510,522
Kentucky,Fleming County,12,1043,526,517
Kentucky,Fleming County,13,942,472,470
Kentucky,Fleming County,14,835,375,460
Kentucky,Fleming County,15,613,293,320
Kentucky,Fleming County,16,411,202,209
Kentucky,Fleming County,17,273,93,180
Kentucky,Fleming County,18,222,77,145
Kentucky,Floyd County,0,38108,18612,19496
Kentucky,Floyd County,1,2519,1321,1198
Kentucky,Floyd County,2,2298,1175,1123
Kentucky,Floyd County,3,2205,1185,1020
Kentucky,Floyd County,4,2214,1219,995
Kentucky,Floyd County,5,2372,1216,1156
Kentucky,Floyd County,6,2173,1032,1141
Kentucky,Floyd County,7,2319,1142,1177
Kentucky,Floyd County,8,2426,1189,1237
Kentucky,Floyd County,9,2543,1235,1308
Kentucky,Floyd County,10,2584,1278,1306
Kentucky,Floyd County,11,2759,1286,1473
Kentucky,Floyd County,12,2942,1384,1558
Kentucky,Floyd County,13,2655,1289,1366
Kentucky,Floyd County,14,2169,1008,1161
Kentucky,Floyd County,15,1572,703,869
Kentucky,Floyd County,16,1131,511,620
Kentucky,Floyd County,17,639,255,384
Kentucky,Floyd County,18,588,184,404
Kentucky,Franklin County,0,49880,24049,25831
Kentucky,Franklin County,1,2737,1413,1324
Kentucky,Franklin County,2,3027,1563,1464
Kentucky,Franklin County,3,2917,1462,1455
Kentucky,Franklin County,4,3259,1625,1634
Kentucky,Franklin County,5,3409,1666,1743
Kentucky,Franklin County,6,2970,1454,1516
Kentucky,Franklin County,7,3097,1524,1573
Kentucky,Franklin County,8,2891,1407,1484
Kentucky,Franklin County,9,3372,1633,1739
Kentucky,Franklin County,10,3366,1714,1652
Kentucky,Franklin County,11,3643,1740,1903
Kentucky,Franklin County,12,3639,1696,1943
Kentucky,Franklin County,13,3417,1616,1801
Kentucky,Franklin County,14,2840,1314,1526
Kentucky,Franklin County,15,1983,899,1084
Kentucky,Franklin County,16,1399,611,788
Kentucky,Franklin County,17,971,408,563
Kentucky,Franklin County,18,943,304,639
Kentucky,Fulton County,0,6265,3095,3170
Kentucky,Fulton County,1,401,208,193
Kentucky,Fulton County,2,365,186,179
Kentucky,Fulton County,3,344,173,171
Kentucky,Fulton County,4,314,164,150
Kentucky,Fulton County,5,398,225,173
Kentucky,Fulton County,6,401,216,185
Kentucky,Fulton County,7,409,225,184
Kentucky,Fulton County,8,316,165,151
Kentucky,Fulton County,9,334,183,151
Kentucky,Fulton County,10,428,200,228
Kentucky,Fulton County,11,415,182,233
Kentucky,Fulton County,12,487,250,237
Kentucky,Fulton County,13,439,209,230
Kentucky,Fulton County,14,388,167,221
Kentucky,Fulton County,15,282,129,153
Kentucky,Fulton County,16,224,90,134
Kentucky,Fulton County,17,158,66,92
Kentucky,Fulton County,18,162,57,105
Kentucky,Gallatin County,0,8589,4336,4253
Kentucky,Gallatin County,1,558,299,259
Kentucky,Gallatin County,2,601,294,307
Kentucky,Gallatin County,3,614,301,313
Kentucky,Gallatin County,4,651,356,295
Kentucky,Gallatin County,5,520,277,243
Kentucky,Gallatin County,6,488,246,242
Kentucky,Gallatin County,7,502,238,264
Kentucky,Gallatin County,8,520,255,265
Kentucky,Gallatin County,9,569,296,273
Kentucky,Gallatin County,10,656,325,331
Kentucky,Gallatin County,11,707,360,347
Kentucky,Gallatin County,12,644,333,311
Kentucky,Gallatin County,13,502,256,246
Kentucky,Gallatin County,14,417,207,210
Kentucky,Gallatin County,15,302,152,150
Kentucky,Gallatin County,16,156,86,70
Kentucky,Gallatin County,17,99,32,67
Kentucky,Gallatin County,18,83,23,60
Kentucky,Garrard County,0,16858,8295,8563
Kentucky,Garrard County,1,853,461,392
Kentucky,Garrard County,2,1097,558,539
Kentucky,Garrard County,3,1121,555,566
Kentucky,Garrard County,4,984,526,458
Kentucky,Garrard County,5,855,419,436
Kentucky,Garrard County,6,844,427,417
Kentucky,Garrard County,7,988,473,515
Kentucky,Garrard County,8,1027,517,510
Kentucky,Garrard County,9,1125,558,567
Kentucky,Garrard County,10,1246,615,631
Kentucky,Garrard County,11,1457,744,713
Kentucky,Garrard County,12,1326,649,677
Kentucky,Garrard County,13,1169,557,612
Kentucky,Garrard County,14,940,463,477
Kentucky,Garrard County,15,728,331,397
Kentucky,Garrard County,16,480,219,261
Kentucky,Garrard County,17,326,138,188
Kentucky,Garrard County,18,292,85,207
Kentucky,Grant County,0,24875,12422,12453
Kentucky,Grant County,1,1742,938,804
Kentucky,Grant County,2,1990,989,1001
Kentucky,Grant County,3,1923,955,968
Kentucky,Grant County,4,1737,910,827
Kentucky,Grant County,5,1556,803,753
Kentucky,Grant County,6,1456,763,693
Kentucky,Grant County,7,1548,757,791
Kentucky,Grant County,8,1570,783,787
Kentucky,Grant County,9,1748,861,887
Kentucky,Grant County,10,1728,874,854
Kentucky,Grant County,11,1807,902,905
Kentucky,Grant County,12,1633,792,841
Kentucky,Grant County,13,1315,644,671
Kentucky,Grant County,14,1129,560,569
Kentucky,Grant County,15,864,407,457
Kentucky,Grant County,16,561,272,289
Kentucky,Grant County,17,328,139,189
Kentucky,Grant County,18,240,73,167
Kentucky,Graves County,0,37618,18458,19160
Kentucky,Graves County,1,2450,1255,1195
Kentucky,Graves County,2,2488,1265,1223
Kentucky,Graves County,3,2603,1310,1293
Kentucky,Graves County,4,2467,1301,1166
Kentucky,Graves County,5,2230,1141,1089
Kentucky,Graves County,6,2111,1052,1059
Kentucky,Graves County,7,2233,1072,1161
Kentucky,Graves County,8,2220,1097,1123
Kentucky,Graves County,9,2351,1184,1167
Kentucky,Graves County,10,2368,1151,1217
Kentucky,Graves County,11,2698,1304,1394
Kentucky,Graves County,12,2527,1244,1283
Kentucky,Graves County,13,2395,1195,1200
Kentucky,Graves County,14,2033,983,1050
Kentucky,Graves County,15,1655,757,898
Kentucky,Graves County,16,1146,525,621
Kentucky,Graves County,17,813,344,469
Kentucky,Graves County,18,830,278,552
Kentucky,Grayson County,0,26194,13185,13009
Kentucky,Grayson County,1,1662,824,838
Kentucky,Grayson County,2,1721,910,811
Kentucky,Grayson County,3,1790,922,868
Kentucky,Grayson County,4,1652,882,770
Kentucky,Grayson County,5,1595,811,784
Kentucky,Grayson County,6,1438,739,699
Kentucky,Grayson County,7,1584,830,754
Kentucky,Grayson County,8,1652,847,805
Kentucky,Grayson County,9,1667,828,839
Kentucky,Grayson County,10,1663,884,779
Kentucky,Grayson County,11,1872,974,898
Kentucky,Grayson County,12,1880,925,955
Kentucky,Grayson County,13,1765,852,913
Kentucky,Grayson County,14,1420,713,707
Kentucky,Grayson County,15,1134,527,607
Kentucky,Grayson County,16,773,364,409
Kentucky,Grayson County,17,500,201,299
Kentucky,Grayson County,18,426,152,274
Kentucky,Green County,0,11043,5467,5576
Kentucky,Green County,1,550,286,264
Kentucky,Green County,2,652,318,334
Kentucky,Green County,3,705,391,314
Kentucky,Green County,4,639,341,298
Kentucky,Green County,5,584,293,291
Kentucky,Green County,6,532,271,261
Kentucky,Green County,7,621,295,326
Kentucky,Green County,8,642,308,334
Kentucky,Green County,9,712,367,345
Kentucky,Green County,10,740,351,389
Kentucky,Green County,11,894,459,435
Kentucky,Green County,12,858,443,415
Kentucky,Green County,13,751,358,393
Kentucky,Green County,14,714,350,364
Kentucky,Green County,15,531,248,283
Kentucky,Green County,16,393,179,214
Kentucky,Green County,17,291,129,162
Kentucky,Green County,18,234,80,154
Kentucky,Greenup County,0,36308,17598,18710
Kentucky,Greenup County,1,1953,1000,953
Kentucky,Greenup County,2,2231,1118,1113
Kentucky,Greenup County,3,2334,1230,1104
Kentucky,Greenup County,4,2130,1105,1025
Kentucky,Greenup County,5,2000,1073,927
Kentucky,Greenup County,6,1802,879,923
Kentucky,Greenup County,7,2063,1028,1035
Kentucky,Greenup County,8,2224,1103,1121
Kentucky,Greenup County,9,2338,1105,1233
Kentucky,Greenup County,10,2463,1185,1278
Kentucky,Greenup County,11,2611,1264,1347
Kentucky,Greenup County,12,2777,1324,1453
Kentucky,Greenup County,13,2455,1137,1318
Kentucky,Greenup County,14,2299,1072,1227
Kentucky,Greenup County,15,1712,796,916
Kentucky,Greenup County,16,1284,568,716
Kentucky,Greenup County,17,869,357,512
Kentucky,Greenup County,18,763,254,509
Kentucky,Hancock County,0,8753,4480,4273
Kentucky,Hancock County,1,556,308,248
Kentucky,Hancock County,2,605,336,269
Kentucky,Hancock County,3,698,367,331
Kentucky,Hancock County,4,553,287,266
Kentucky,Hancock County,5,527,268,259
Kentucky,Hancock County,6,416,226,190
Kentucky,Hancock County,7,463,211,252
Kentucky,Hancock County,8,562,286,276
Kentucky,Hancock County,9,575,296,279
Kentucky,Hancock County,10,596,311,285
Kentucky,Hancock County,11,666,333,333
Kentucky,Hancock County,12,598,315,283
Kentucky,Hancock County,13,525,278,247
Kentucky,Hancock County,14,510,247,263
Kentucky,Hancock County,15,388,187,201
Kentucky,Hancock County,16,248,126,122
Kentucky,Hancock County,17,140,61,79
Kentucky,Hancock County,18,127,37,90
Kentucky,Hardin County,0,108266,54018,54248
Kentucky,Hardin County,1,7373,3787,3586
Kentucky,Hardin County,2,7695,3904,3791
Kentucky,Hardin County,3,7476,3833,3643
Kentucky,Hardin County,4,7351,3923,3428
Kentucky,Hardin County,5,8365,4698,3667
Kentucky,Hardin County,6,7537,3957,3580
Kentucky,Hardin County,7,7143,3588,3555
Kentucky,Hardin County,8,6842,3408,3434
Kentucky,Hardin County,9,7154,3590,3564
Kentucky,Hardin County,10,7155,3557,3598
Kentucky,Hardin County,11,7993,3853,4140
Kentucky,Hardin County,12,7091,3380,3711
Kentucky,Hardin County,13,5768,2768,3000
Kentucky,Hardin County,14,4493,2096,2397
Kentucky,Hardin County,15,3332,1521,1811
Kentucky,Hardin County,16,2374,963,1411
Kentucky,Hardin County,17,1653,683,970
Kentucky,Hardin County,18,1471,509,962
Kentucky,Harlan County,0,28163,13707,14456
Kentucky,Harlan County,1,1978,1001,977
Kentucky,Harlan County,2,1781,925,856
Kentucky,Harlan County,3,1662,847,815
Kentucky,Harlan County,4,1536,784,752
Kentucky,Harlan County,5,1766,863,903
Kentucky,Harlan County,6,1735,859,876
Kentucky,Harlan County,7,1614,799,815
Kentucky,Harlan County,8,1625,796,829
Kentucky,Harlan County,9,1754,868,886
Kentucky,Harlan County,10,1901,945,956
Kentucky,Harlan County,11,1995,934,1061
Kentucky,Harlan County,12,2168,1034,1134
Kentucky,Harlan County,13,2058,1032,1026
Kentucky,Harlan County,14,1694,796,898
Kentucky,Harlan County,15,1066,506,560
Kentucky,Harlan County,16,805,352,453
Kentucky,Harlan County,17,529,209,320
Kentucky,Harlan County,18,496,157,339
Kentucky,Harrison County,0,18592,9119,9473
Kentucky,Harrison County,1,1075,528,547
Kentucky,Harrison County,2,1212,624,588
Kentucky,Harrison County,3,1264,675,589
Kentucky,Harrison County,4,1191,616,575
Kentucky,Harrison County,5,1088,560,528
Kentucky,Harrison County,6,907,428,479
Kentucky,Harrison County,7,993,504,489
Kentucky,Harrison County,8,1071,507,564
Kentucky,Harrison County,9,1258,633,625
Kentucky,Harrison County,10,1341,660,681
Kentucky,Harrison County,11,1468,740,728
Kentucky,Harrison County,12,1455,725,730
Kentucky,Harrison County,13,1207,572,635
Kentucky,Harrison County,14,1021,515,506
Kentucky,Harrison County,15,765,352,413
Kentucky,Harrison County,16,543,227,316
Kentucky,Harrison County,17,378,140,238
Kentucky,Harrison County,18,355,113,242
Kentucky,Hart County,0,18597,9192,9405
Kentucky,Hart County,1,1141,572,569
Kentucky,Hart County,2,1261,639,622
Kentucky,Hart County,3,1337,666,671
Kentucky,Hart County,4,1217,630,587
Kentucky,Hart County,5,1151,594,557
Kentucky,Hart County,6,976,519,457
Kentucky,Hart County,7,1032,500,532
Kentucky,Hart County,8,1019,517,502
Kentucky,Hart County,9,1118,564,554
Kentucky,Hart County,10,1301,640,661
Kentucky,Hart County,11,1511,745,766
Kentucky,Hart County,12,1358,699,659
Kentucky,Hart County,13,1155,567,588
Kentucky,Hart County,14,1008,464,544
Kentucky,Hart County,15,792,389,403
Kentucky,Hart County,16,543,258,285
Kentucky,Hart County,17,392,137,255
Kentucky,Hart County,18,285,92,193
Kentucky,Henderson County,0,46467,22535,23932
Kentucky,Henderson County,1,2947,1564,1383
Kentucky,Henderson County,2,3149,1576,1573
Kentucky,Henderson County,3,3018,1552,1466
Kentucky,Henderson County,4,2729,1406,1323
Kentucky,Henderson County,5,2690,1339,1351
Kentucky,Henderson County,6,2811,1356,1455
Kentucky,Henderson County,7,3036,1471,1565
Kentucky,Henderson County,8,2793,1354,1439
Kentucky,Henderson County,9,2899,1445,1454
Kentucky,Henderson County,10,2974,1471,1503
Kentucky,Henderson County,11,3470,1715,1755
Kentucky,Henderson County,12,3597,1692,1905
Kentucky,Henderson County,13,3080,1441,1639
Kentucky,Henderson County,14,2511,1175,1336
Kentucky,Henderson County,15,1775,833,942
Kentucky,Henderson County,16,1208,519,689
Kentucky,Henderson County,17,921,360,561
Kentucky,Henderson County,18,859,266,593
Kentucky,Henry County,0,15572,7693,7879
Kentucky,Henry County,1,909,493,416
Kentucky,Henry County,2,978,526,452
Kentucky,Henry County,3,1178,597,581
Kentucky,Henry County,4,1003,550,453
Kentucky,Henry County,5,865,440,425
Kentucky,Henry County,6,817,400,417
Kentucky,Henry County,7,886,424,462
Kentucky,Henry County,8,895,439,456
Kentucky,Henry County,9,1027,501,526
Kentucky,Henry County,10,1077,518,559
Kentucky,Henry County,11,1192,594,598
Kentucky,Henry County,12,1180,590,590
Kentucky,Henry County,13,1066,521,545
Kentucky,Henry County,14,902,427,475
Kentucky,Henry County,15,650,291,359
Kentucky,Henry County,16,433,205,228
Kentucky,Henry County,17,263,109,154
Kentucky,Henry County,18,251,68,183
Kentucky,Hickman County,0,4734,2242,2492
Kentucky,Hickman County,1,194,87,107
Kentucky,Hickman County,2,288,143,145
Kentucky,Hickman County,3,290,143,147
Kentucky,Hickman County,4,267,138,129
Kentucky,Hickman County,5,236,119,117
Kentucky,Hickman County,6,230,112,118
Kentucky,Hickman County,7,231,123,108
Kentucky,Hickman County,8,250,131,119
Kentucky,Hickman County,9,282,123,159
Kentucky,Hickman County,10,313,163,150
Kentucky,Hickman County,11,372,184,188
Kentucky,Hickman County,12,340,156,184
Kentucky,Hickman County,13,323,153,170
Kentucky,Hickman County,14,326,155,171
Kentucky,Hickman County,15,270,123,147
Kentucky,Hickman County,16,205,86,119
Kentucky,Hickman County,17,142,61,81
Kentucky,Hickman County,18,175,42,133
Kentucky,Hopkins County,0,46376,22635,23741
Kentucky,Hopkins County,1,2743,1377,1366
Kentucky,Hopkins County,2,3056,1605,1451
Kentucky,Hopkins County,3,2981,1586,1395
Kentucky,Hopkins County,4,2748,1341,1407
Kentucky,Hopkins County,5,2664,1348,1316
Kentucky,Hopkins County,6,2682,1379,1303
Kentucky,Hopkins County,7,2795,1360,1435
Kentucky,Hopkins County,8,2892,1455,1437
Kentucky,Hopkins County,9,2870,1453,1417
Kentucky,Hopkins County,10,3083,1507,1576
Kentucky,Hopkins County,11,3260,1535,1725
Kentucky,Hopkins County,12,3497,1694,1803
Kentucky,Hopkins County,13,3158,1520,1638
Kentucky,Hopkins County,14,2588,1236,1352
Kentucky,Hopkins County,15,1965,926,1039
Kentucky,Hopkins County,16,1488,647,841
Kentucky,Hopkins County,17,981,374,607
Kentucky,Hopkins County,18,925,292,633
Kentucky,Jackson County,0,13289,6651,6638
Kentucky,Jackson County,1,755,406,349
Kentucky,Jackson County,2,837,448,389
Kentucky,Jackson County,3,855,454,401
Kentucky,Jackson County,4,806,452,354
Kentucky,Jackson County,5,778,391,387
Kentucky,Jackson County,6,739,359,380
Kentucky,Jackson County,7,814,407,407
Kentucky,Jackson County,8,883,444,439
Kentucky,Jackson County,9,946,463,483
Kentucky,Jackson County,10,919,440,479
Kentucky,Jackson County,11,988,491,497
Kentucky,Jackson County,12,998,494,504
Kentucky,Jackson County,13,894,445,449
Kentucky,Jackson County,14,745,359,386
Kentucky,Jackson County,15,569,279,290
Kentucky,Jackson County,16,381,166,215
Kentucky,Jackson County,17,195,91,104
Kentucky,Jackson County,18,187,62,125
Kentucky,Jefferson County,0,760026,366661,393365
Kentucky,Jefferson County,1,49289,25254,24035
Kentucky,Jefferson County,2,47543,24366,23177
Kentucky,Jefferson County,3,46872,23912,22960
Kentucky,Jefferson County,4,45709,23451,22258
Kentucky,Jefferson County,5,50292,24981,25311
Kentucky,Jefferson County,6,55864,27443,28421
Kentucky,Jefferson County,7,53577,26206,27371
Kentucky,Jefferson County,8,48203,23921,24282
Kentucky,Jefferson County,9,48319,23614,24705
Kentucky,Jefferson County,10,47697,23252,24445
Kentucky,Jefferson County,11,55187,26579,28608
Kentucky,Jefferson County,12,54179,25749,28430
Kentucky,Jefferson County,13,47004,21945,25059
Kentucky,Jefferson County,14,36499,16885,19614
Kentucky,Jefferson County,15,25092,10982,14110
Kentucky,Jefferson County,16,18630,7625,11005
Kentucky,Jefferson County,17,14377,5526,8851
Kentucky,Jefferson County,18,15693,4970,10723
Kentucky,Jessamine County,0,50815,24700,26115
Kentucky,Jessamine County,1,3422,1680,1742
Kentucky,Jessamine County,2,3528,1783,1745
Kentucky,Jessamine County,3,3492,1822,1670
Kentucky,Jessamine County,4,3598,1836,1762
Kentucky,Jessamine County,5,3675,1794,1881
Kentucky,Jessamine County,6,3203,1556,1647
Kentucky,Jessamine County,7,3191,1549,1642
Kentucky,Jessamine County,8,3207,1565,1642
Kentucky,Jessamine County,9,3409,1677,1732
Kentucky,Jessamine County,10,3346,1582,1764
Kentucky,Jessamine County,11,3668,1750,1918
Kentucky,Jessamine County,12,3438,1622,1816
Kentucky,Jessamine County,13,2814,1335,1479
Kentucky,Jessamine County,14,2373,1129,1244
Kentucky,Jessamine County,15,1553,736,817
Kentucky,Jessamine County,16,1133,526,607
Kentucky,Jessamine County,17,814,368,446
Kentucky,Jessamine County,18,951,390,561
Kentucky,Johnson County,0,23262,11434,11828
Kentucky,Johnson County,1,1512,744,768
Kentucky,Johnson County,2,1395,727,668
Kentucky,Johnson County,3,1456,777,679
Kentucky,Johnson County,4,1378,711,667
Kentucky,Johnson County,5,1416,727,689
Kentucky,Johnson County,6,1321,681,640
Kentucky,Johnson County,7,1399,670,729
Kentucky,Johnson County,8,1420,697,723
Kentucky,Johnson County,9,1603,782,821
Kentucky,Johnson County,10,1599,764,835
Kentucky,Johnson County,11,1697,811,886
Kentucky,Johnson County,12,1714,827,887
Kentucky,Johnson County,13,1607,758,849
Kentucky,Johnson County,14,1362,700,662
Kentucky,Johnson County,15,975,473,502
Kentucky,Johnson County,16,652,302,350
Kentucky,Johnson County,17,394,170,224
Kentucky,Johnson County,18,362,113,249
Kentucky,Kenton County,0,163929,80985,82944
Kentucky,Kenton County,1,11615,5914,5701
Kentucky,Kenton County,2,11213,5597,5616
Kentucky,Kenton County,3,11004,5747,5257
Kentucky,Kenton County,4,9890,5146,4744
Kentucky,Kenton County,5,10274,5203,5071
Kentucky,Kenton County,6,12122,6002,6120
Kentucky,Kenton County,7,12014,5949,6065
Kentucky,Kenton County,8,10923,5541,5382
Kentucky,Kenton County,9,10227,5174,5053
Kentucky,Kenton County,10,10936,5474,5462
Kentucky,Kenton County,11,11989,5965,6024
Kentucky,Kenton County,12,11415,5584,5831
Kentucky,Kenton County,13,9505,4657,4848
Kentucky,Kenton County,14,7344,3516,3828
Kentucky,Kenton County,15,4878,2247,2631
Kentucky,Kenton County,16,3493,1514,1979
Kentucky,Kenton County,17,2492,935,1557
Kentucky,Kenton County,18,2595,820,1775
Kentucky,Knott County,0,15892,7893,7999
Kentucky,Knott County,1,898,474,424
Kentucky,Knott County,2,914,449,465
Kentucky,Knott County,3,931,488,443
Kentucky,Knott County,4,1002,532,470
Kentucky,Knott County,5,1203,605,598
Kentucky,Knott County,6,812,402,410
Kentucky,Knott County,7,880,436,444
Kentucky,Knott County,8,910,457,453
Kentucky,Knott County,9,1049,525,524
Kentucky,Knott County,10,1155,565,590
Kentucky,Knott County,11,1234,619,615
Kentucky,Knott County,12,1252,633,619
Kentucky,Knott County,13,1141,549,592
Kentucky,Knott County,14,927,486,441
Kentucky,Knott County,15,624,280,344
Kentucky,Knott County,16,470,210,260
Kentucky,Knott County,17,263,123,140
Kentucky,Knott County,18,227,60,167
Kentucky,Knox County,0,31798,15437,16361
Kentucky,Knox County,1,2131,1098,1033
Kentucky,Knox County,2,2092,1060,1032
Kentucky,Knox County,3,2037,1033,1004
Kentucky,Knox County,4,2074,1121,953
Kentucky,Knox County,5,2169,1102,1067
Kentucky,Knox County,6,1915,925,990
Kentucky,Knox County,7,1822,910,912
Kentucky,Knox County,8,1835,891,944
Kentucky,Knox County,9,2065,1021,1044
Kentucky,Knox County,10,2121,1053,1068
Kentucky,Knox County,11,2207,1047,1160
Kentucky,Knox County,12,2101,990,1111
Kentucky,Knox County,13,1862,846,1016
Kentucky,Knox County,14,1813,848,965
Kentucky,Knox County,15,1461,666,795
Kentucky,Knox County,16,1015,459,556
Kentucky,Knox County,17,603,238,365
Kentucky,Knox County,18,475,129,346
Kentucky,Larue County,0,14180,7025,7155
Kentucky,Larue County,1,752,400,352
Kentucky,Larue County,2,904,455,449
Kentucky,Larue County,3,942,511,431
Kentucky,Larue County,4,887,460,427
Kentucky,Larue County,5,833,432,401
Kentucky,Larue County,6,848,427,421
Kentucky,Larue County,7,929,492,437
Kentucky,Larue County,8,805,398,407
Kentucky,Larue County,9,840,412,428
Kentucky,Larue County,10,911,471,440
Kentucky,Larue County,11,1172,562,610
Kentucky,Larue County,12,1018,514,504
Kentucky,Larue County,13,933,463,470
Kentucky,Larue County,14,739,367,372
Kentucky,Larue County,15,563,237,326
Kentucky,Larue County,16,472,214,258
Kentucky,Larue County,17,298,109,189
Kentucky,Larue County,18,334,101,233
Kentucky,Laurel County,0,60015,29401,30614
Kentucky,Laurel County,1,3677,1915,1762
Kentucky,Laurel County,2,3875,1935,1940
Kentucky,Laurel County,3,4144,2103,2041
Kentucky,Laurel County,4,3645,1901,1744
Kentucky,Laurel County,5,3655,1797,1858
Kentucky,Laurel County,6,3743,1853,1890
Kentucky,Laurel County,7,3850,1897,1953
Kentucky,Laurel County,8,3894,1889,2005
Kentucky,Laurel County,9,4073,2053,2020
Kentucky,Laurel County,10,4165,2051,2114
Kentucky,Laurel County,11,4364,2124,2240
Kentucky,Laurel County,12,4249,1976,2273
Kentucky,Laurel County,13,3677,1815,1862
Kentucky,Laurel County,14,3257,1623,1634
Kentucky,Laurel County,15,2272,1058,1214
Kentucky,Laurel County,16,1668,743,925
Kentucky,Laurel County,17,1016,412,604
Kentucky,Laurel County,18,791,256,535
Kentucky,Lawrence County,0,15804,7891,7913
Kentucky,Lawrence County,1,1030,573,457
Kentucky,Lawrence County,2,1083,539,544
Kentucky,Lawrence County,3,1011,536,475
Kentucky,Lawrence County,4,828,452,376
Kentucky,Lawrence County,5,965,499,466
Kentucky,Lawrence County,6,855,417,438
Kentucky,Lawrence County,7,938,441,497
Kentucky,Lawrence County,8,1008,499,509
Kentucky,Lawrence County,9,986,497,489
Kentucky,Lawrence County,10,1066,542,524
Kentucky,Lawrence County,11,1227,597,630
Kentucky,Lawrence County,12,1177,557,620
Kentucky,Lawrence County,13,1121,558,563
Kentucky,Lawrence County,14,912,439,473
Kentucky,Lawrence County,15,662,327,335
Kentucky,Lawrence County,16,447,212,235
Kentucky,Lawrence County,17,262,123,139
Kentucky,Lawrence County,18,226,83,143
Kentucky,Lee County,0,7594,4205,3389
Kentucky,Lee County,1,364,207,157
Kentucky,Lee County,2,390,200,190
Kentucky,Lee County,3,398,196,202
Kentucky,Lee County,4,439,231,208
Kentucky,Lee County,5,430,261,169
Kentucky,Lee County,6,578,381,197
Kentucky,Lee County,7,519,354,165
Kentucky,Lee County,8,487,284,203
Kentucky,Lee County,9,523,320,203
Kentucky,Lee County,10,629,351,278
Kentucky,Lee County,11,636,331,305
Kentucky,Lee County,12,551,302,249
Kentucky,Lee County,13,508,260,248
Kentucky,Lee County,14,449,224,225
Kentucky,Lee County,15,261,121,140
Kentucky,Lee County,16,189,96,93
Kentucky,Lee County,17,153,59,94
Kentucky,Lee County,18,90,27,63
Kentucky,Leslie County,0,10918,5407,5511
Kentucky,Leslie County,1,696,351,345
Kentucky,Leslie County,2,654,331,323
Kentucky,Leslie County,3,649,354,295
Kentucky,Leslie County,4,562,301,261
Kentucky,Leslie County,5,655,321,334
Kentucky,Leslie County,6,670,349,321
Kentucky,Leslie County,7,640,320,320
Kentucky,Leslie County,8,678,336,342
Kentucky,Leslie County,9,708,346,362
Kentucky,Leslie County,10,788,404,384
Kentucky,Leslie County,11,862,435,427
Kentucky,Leslie County,12,868,433,435
Kentucky,Leslie County,13,716,348,368
Kentucky,Leslie County,14,604,307,297
Kentucky,Leslie County,15,445,193,252
Kentucky,Leslie County,16,355,149,206
Kentucky,Leslie County,17,203,80,123
Kentucky,Leslie County,18,165,49,116
Kentucky,Letcher County,0,23359,11533,11826
Kentucky,Letcher County,1,1389,727,662
Kentucky,Letcher County,2,1461,757,704
Kentucky,Letcher County,3,1378,724,654
Kentucky,Letcher County,4,1225,650,575
Kentucky,Letcher County,5,1268,661,607
Kentucky,Letcher County,6,1363,706,657
Kentucky,Letcher County,7,1447,698,749
Kentucky,Letcher County,8,1485,745,740
Kentucky,Letcher County,9,1466,719,747
Kentucky,Letcher County,10,1553,752,801
Kentucky,Letcher County,11,1785,873,912
Kentucky,Letcher County,12,1879,911,968
Kentucky,Letcher County,13,1759,851,908
Kentucky,Letcher County,14,1407,696,711
Kentucky,Letcher County,15,983,460,523
Kentucky,Letcher County,16,723,312,411
Kentucky,Letcher County,17,429,153,276
Kentucky,Letcher County,18,359,138,221
Kentucky,Lewis County,0,13880,6909,6971
Kentucky,Lewis County,1,872,452,420
Kentucky,Lewis County,2,874,442,432
Kentucky,Lewis County,3,873,445,428
Kentucky,Lewis County,4,832,420,412
Kentucky,Lewis County,5,805,431,374
Kentucky,Lewis County,6,789,392,397
Kentucky,Lewis County,7,762,349,413
Kentucky,Lewis County,8,847,428,419
Kentucky,Lewis County,9,903,465,438
Kentucky,Lewis County,10,974,499,475
Kentucky,Lewis County,11,1090,515,575
Kentucky,Lewis County,12,1076,546,530
Kentucky,Lewis County,13,878,424,454
Kentucky,Lewis County,14,776,380,396
Kentucky,Lewis County,15,642,332,310
Kentucky,Lewis County,16,424,198,226
Kentucky,Lewis County,17,253,116,137
Kentucky,Lewis County,18,210,75,135
Kentucky,Lincoln County,0,24445,11981,12464
Kentucky,Lincoln County,1,1526,756,770
Kentucky,Lincoln County,2,1610,849,761
Kentucky,Lincoln County,3,1638,839,799
Kentucky,Lincoln County,4,1558,804,754
Kentucky,Lincoln County,5,1386,720,666
Kentucky,Lincoln County,6,1364,671,693
Kentucky,Lincoln County,7,1403,675,728
Kentucky,Lincoln County,8,1470,715,755
Kentucky,Lincoln County,9,1618,781,837
Kentucky,Lincoln County,10,1736,852,884
Kentucky,Lincoln County,11,1803,921,882
Kentucky,Lincoln County,12,1663,821,842
Kentucky,Lincoln County,13,1582,754,828
Kentucky,Lincoln County,14,1320,625,695
Kentucky,Lincoln County,15,1064,497,567
Kentucky,Lincoln County,16,795,334,461
Kentucky,Lincoln County,17,510,212,298
Kentucky,Lincoln County,18,399,155,244
Kentucky,Livingston County,0,9359,4594,4765
Kentucky,Livingston County,1,528,267,261
Kentucky,Livingston County,2,531,273,258
Kentucky,Livingston County,3,535,253,282
Kentucky,Livingston County,4,488,235,253
Kentucky,Livingston County,5,515,254,261
Kentucky,Livingston County,6,465,232,233
Kentucky,Livingston County,7,461,217,244
Kentucky,Livingston County,8,525,277,248
Kentucky,Livingston County,9,536,268,268
Kentucky,Livingston County,10,655,326,329
Kentucky,Livingston County,11,759,360,399
Kentucky,Livingston County,12,795,385,410
Kentucky,Livingston County,13,705,382,323
Kentucky,Livingston County,14,639,303,336
Kentucky,Livingston County,15,501,239,262
Kentucky,Livingston County,16,342,176,166
Kentucky,Livingston County,17,212,86,126
Kentucky,Livingston County,18,167,61,106
Kentucky,Logan County,0,26867,13150,13717
Kentucky,Logan County,1,1718,869,849
Kentucky,Logan County,2,1751,907,844
Kentucky,Logan County,3,1865,934,931
Kentucky,Logan County,4,1716,858,858
Kentucky,Logan County,5,1527,771,756
Kentucky,Logan County,6,1466,732,734
Kentucky,Logan County,7,1666,799,867
Kentucky,Logan County,8,1492,737,755
Kentucky,Logan County,9,1648,840,808
Kentucky,Logan County,10,1761,855,906
Kentucky,Logan County,11,2033,1010,1023
Kentucky,Logan County,12,1928,944,984
Kentucky,Logan County,13,1684,808,876
Kentucky,Logan County,14,1516,705,811
Kentucky,Logan County,15,1217,577,640
Kentucky,Logan County,16,803,374,429
Kentucky,Logan County,17,573,252,321
Kentucky,Logan County,18,503,178,325
Kentucky,Lyon County,0,8430,4689,3741
Kentucky,Lyon County,1,335,164,171
Kentucky,Lyon County,2,345,193,152
Kentucky,Lyon County,3,361,183,178
Kentucky,Lyon County,4,377,191,186
Kentucky,Lyon County,5,437,271,166
Kentucky,Lyon County,6,459,331,128
Kentucky,Lyon County,7,511,351,160
Kentucky,Lyon County,8,490,335,155
Kentucky,Lyon County,9,544,356,188
Kentucky,Lyon County,10,562,336,226
Kentucky,Lyon County,11,673,361,312
Kentucky,Lyon County,12,685,340,345
Kentucky,Lyon County,13,677,343,334
Kentucky,Lyon County,14,681,327,354
Kentucky,Lyon County,15,525,262,263
Kentucky,Lyon County,16,360,187,173
Kentucky,Lyon County,17,215,90,125
Kentucky,Lyon County,18,193,68,125
Kentucky,McCracken County,0,65316,31415,33901
Kentucky,McCracken County,1,3868,2057,1811
Kentucky,McCracken County,2,3921,1961,1960
Kentucky,McCracken County,3,4077,2093,1984
Kentucky,McCracken County,4,3715,1890,1825
Kentucky,McCracken County,5,3804,1873,1931
Kentucky,McCracken County,6,3713,1824,1889
Kentucky,McCracken County,7,4031,1983,2048
Kentucky,McCracken County,8,3886,1899,1987
Kentucky,McCracken County,9,4036,1989,2047
Kentucky,McCracken County,10,4115,2006,2109
Kentucky,McCracken County,11,4805,2291,2514
Kentucky,McCracken County,12,4921,2406,2515
Kentucky,McCracken County,13,4525,2173,2352
Kentucky,McCracken County,14,3760,1746,2014
Kentucky,McCracken County,15,2902,1250,1652
Kentucky,McCracken County,16,1985,843,1142
Kentucky,McCracken County,17,1549,585,964
Kentucky,McCracken County,18,1703,546,1157
Kentucky,McCreary County,0,17863,9716,8147
Kentucky,McCreary County,1,1133,593,540
Kentucky,McCreary County,2,1096,561,535
Kentucky,McCreary County,3,1093,593,500
Kentucky,McCreary County,4,1067,571,496
Kentucky,McCreary County,5,1176,652,524
Kentucky,McCreary County,6,1139,674,465
Kentucky,McCreary County,7,1297,842,455
Kentucky,McCreary County,8,1269,762,507
Kentucky,McCreary County,9,1341,806,535
Kentucky,McCreary County,10,1334,751,583
Kentucky,McCreary County,11,1233,641,592
Kentucky,McCreary County,12,1151,625,526
Kentucky,McCreary County,13,1040,501,539
Kentucky,McCreary County,14,915,430,485
Kentucky,McCreary County,15,673,298,375
Kentucky,McCreary County,16,457,232,225
Kentucky,McCreary County,17,254,114,140
Kentucky,McCreary County,18,195,70,125
Kentucky,McLean County,0,9478,4722,4756
Kentucky,McLean County,1,614,345,269
Kentucky,McLean County,2,598,302,296
Kentucky,McLean County,3,666,355,311
Kentucky,McLean County,4,546,282,264
Kentucky,McLean County,5,531,276,255
Kentucky,McLean County,6,455,227,228
Kentucky,McLean County,7,526,267,259
Kentucky,McLean County,8,543,264,279
Kentucky,McLean County,9,600,290,310
Kentucky,McLean County,10,655,335,320
Kentucky,McLean County,11,689,342,347
Kentucky,McLean County,12,687,338,349
Kentucky,McLean County,13,606,299,307
Kentucky,McLean County,14,565,275,290
Kentucky,McLean County,15,472,225,247
Kentucky,McLean County,16,307,130,177
Kentucky,McLean County,17,193,86,107
Kentucky,McLean County,18,225,84,141
Kentucky,Madison County,0,87340,42343,44997
Kentucky,Madison County,1,4965,2490,2475
Kentucky,Madison County,2,5241,2681,2560
Kentucky,Madison County,3,5141,2604,2537
Kentucky,Madison County,4,7650,3570,4080
Kentucky,Madison County,5,11068,5405,5663
Kentucky,Madison County,6,5132,2610,2522
Kentucky,Madison County,7,5342,2604,2738
Kentucky,Madison County,8,5373,2712,2661
Kentucky,Madison County,9,5537,2747,2790
Kentucky,Madison County,10,5331,2597,2734
Kentucky,Madison County,11,5677,2772,2905
Kentucky,Madison County,12,5088,2417,2671
Kentucky,Madison County,13,4675,2236,2439
Kentucky,Madison County,14,3940,1861,2079
Kentucky,Madison County,15,2733,1263,1470
Kentucky,Madison County,16,1884,817,1067
Kentucky,Madison County,17,1314,535,779
Kentucky,Madison County,18,1249,422,827
Kentucky,Magoffin County,0,12913,6484,6429
Kentucky,Magoffin County,1,718,401,317
Kentucky,Magoffin County,2,815,416,399
Kentucky,Magoffin County,3,904,476,428
Kentucky,Magoffin County,4,782,410,372
Kentucky,Magoffin County,5,799,421,378
Kentucky,Magoffin County,6,714,360,354
Kentucky,Magoffin County,7,711,360,351
Kentucky,Magoffin County,8,846,412,434
Kentucky,Magoffin County,9,896,457,439
Kentucky,Magoffin County,10,986,500,486
Kentucky,Magoffin County,11,994,501,493
Kentucky,Magoffin County,12,988,489,499
Kentucky,Magoffin County,13,851,416,435
Kentucky,Magoffin County,14,660,318,342
Kentucky,Magoffin County,15,513,229,284
Kentucky,Magoffin County,16,362,162,200
Kentucky,Magoffin County,17,210,89,121
Kentucky,Magoffin County,18,164,67,97
Kentucky,Marion County,0,20007,10367,9640
Kentucky,Marion County,1,1239,648,591
Kentucky,Marion County,2,1327,669,658
Kentucky,Marion County,3,1352,685,667
Kentucky,Marion County,4,1253,663,590
Kentucky,Marion County,5,1263,694,569
Kentucky,Marion County,6,1219,717,502
Kentucky,Marion County,7,1403,801,602
Kentucky,Marion County,8,1324,777,547
Kentucky,Marion County,9,1292,680,612
Kentucky,Marion County,10,1416,741,675
Kentucky,Marion County,11,1486,774,712
Kentucky,Marion County,12,1339,670,669
Kentucky,Marion County,13,1132,569,563
Kentucky,Marion County,14,996,490,506
Kentucky,Marion County,15,697,336,361
Kentucky,Marion County,16,467,194,273
Kentucky,Marion County,17,373,134,239
Kentucky,Marion County,18,429,125,304
Kentucky,Marshall County,0,30953,15143,15810
Kentucky,Marshall County,1,1584,799,785
Kentucky,Marshall County,2,1714,882,832
Kentucky,Marshall County,3,1832,937,895
Kentucky,Marshall County,4,1687,857,830
Kentucky,Marshall County,5,1663,832,831
Kentucky,Marshall County,6,1540,764,776
Kentucky,Marshall County,7,1712,819,893
Kentucky,Marshall County,8,1741,906,835
Kentucky,Marshall County,9,1935,934,1001
Kentucky,Marshall County,10,2093,1042,1051
Kentucky,Marshall County,11,2379,1165,1214
Kentucky,Marshall County,12,2338,1130,1208
Kentucky,Marshall County,13,2210,1102,1108
Kentucky,Marshall County,14,2110,1010,1100
Kentucky,Marshall County,15,1699,813,886
Kentucky,Marshall County,16,1197,531,666
Kentucky,Marshall County,17,801,379,422
Kentucky,Marshall County,18,718,241,477
Kentucky,Martin County,0,12537,6993,5544
Kentucky,Martin County,1,682,387,295
Kentucky,Martin County,2,707,375,332
Kentucky,Martin County,3,759,396,363
Kentucky,Martin County,4,676,355,321
Kentucky,Martin County,5,803,495,308
Kentucky,Martin County,6,983,687,296
Kentucky,Martin County,7,1071,759,312
Kentucky,Martin County,8,970,614,356
Kentucky,Martin County,9,890,500,390
Kentucky,Martin County,10,832,431,401
Kentucky,Martin County,11,899,448,451
Kentucky,Martin County,12,815,397,418
Kentucky,Martin County,13,779,393,386
Kentucky,Martin County,14,634,327,307
Kentucky,Martin County,15,377,177,200
Kentucky,Martin County,16,296,134,162
Kentucky,Martin County,17,181,68,113
Kentucky,Martin County,18,183,50,133
Kentucky,Mason County,0,17166,8316,8850
Kentucky,Mason County,1,1121,584,537
Kentucky,Mason County,2,1124,582,542
Kentucky,Mason County,3,1102,529,573
Kentucky,Mason County,4,1086,597,489
Kentucky,Mason County,5,1023,522,501
Kentucky,Mason County,6,952,468,484
Kentucky,Mason County,7,925,448,477
Kentucky,Mason County,8,959,456,503
Kentucky,Mason County,9,1096,536,560
Kentucky,Mason County,10,1207,596,611
Kentucky,Mason County,11,1237,619,618
Kentucky,Mason County,12,1269,577,692
Kentucky,Mason County,13,1179,580,599
Kentucky,Mason County,14,959,445,514
Kentucky,Mason County,15,726,315,411
Kentucky,Mason County,16,488,213,275
Kentucky,Mason County,17,372,142,230
Kentucky,Mason County,18,341,107,234
Kentucky,Meade County,0,29139,14596,14543
Kentucky,Meade County,1,1654,773,881
Kentucky,Meade County,2,2090,1059,1031
Kentucky,Meade County,3,2119,1091,1028
Kentucky,Meade County,4,1939,987,952
Kentucky,Meade County,5,1980,1054,926
Kentucky,Meade County,6,2103,1063,1040
Kentucky,Meade County,7,1985,991,994
Kentucky,Meade County,8,1909,949,960
Kentucky,Meade County,9,2034,1012,1022
Kentucky,Meade County,10,1958,1006,952
Kentucky,Meade County,11,2210,1092,1118
Kentucky,Meade County,12,2009,1019,990
Kentucky,Meade County,13,1575,809,766
Kentucky,Meade County,14,1295,665,630
Kentucky,Meade County,15,902,411,491
Kentucky,Meade County,16,645,323,322
Kentucky,Meade County,17,396,179,217
Kentucky,Meade County,18,336,113,223
Kentucky,Menifee County,0,6287,3174,3113
Kentucky,Menifee County,1,336,164,172
Kentucky,Menifee County,2,316,159,157
Kentucky,Menifee County,3,367,194,173
Kentucky,Menifee County,4,443,262,181
Kentucky,Menifee County,5,400,216,184
Kentucky,Menifee County,6,354,192,162
Kentucky,Menifee County,7,321,150,171
Kentucky,Menifee County,8,345,167,178
Kentucky,Menifee County,9,391,203,188
Kentucky,Menifee County,10,417,221,196
Kentucky,Menifee County,11,499,256,243
Kentucky,Menifee County,12,489,246,243
Kentucky,Menifee County,13,462,215,247
Kentucky,Menifee County,14,386,189,197
Kentucky,Menifee County,15,317,169,148
Kentucky,Menifee County,16,214,94,120
Kentucky,Menifee County,17,127,42,85
Kentucky,Menifee County,18,103,35,68
Kentucky,Mercer County,0,21319,10441,10878
Kentucky,Mercer County,1,1286,678,608
Kentucky,Mercer County,2,1265,653,612
Kentucky,Mercer County,3,1312,692,620
Kentucky,Mercer County,4,1315,692,623
Kentucky,Mercer County,5,1200,629,571
Kentucky,Mercer County,6,1138,569,569
Kentucky,Mercer County,7,1142,561,581
Kentucky,Mercer County,8,1161,587,574
Kentucky,Mercer County,9,1359,655,704
Kentucky,Mercer County,10,1503,714,789
Kentucky,Mercer County,11,1698,838,860
Kentucky,Mercer County,12,1638,814,824
Kentucky,Mercer County,13,1439,707,732
Kentucky,Mercer County,14,1314,608,706
Kentucky,Mercer County,15,970,444,526
Kentucky,Mercer County,16,709,297,412
Kentucky,Mercer County,17,417,171,246
Kentucky,Mercer County,18,453,132,321
Kentucky,Metcalfe County,0,9990,4961,5029
Kentucky,Metcalfe County,1,668,351,317
Kentucky,Metcalfe County,2,607,309,298
Kentucky,Metcalfe County,3,680,344,336
Kentucky,Metcalfe County,4,590,316,274
Kentucky,Metcalfe County,5,600,315,285
Kentucky,Metcalfe County,6,539,264,275
Kentucky,Metcalfe County,7,572,291,281
Kentucky,Metcalfe County,8,531,262,269
Kentucky,Metcalfe County,9,603,299,304
Kentucky,Metcalfe County,10,703,342,361
Kentucky,Metcalfe County,11,749,376,373
Kentucky,Metcalfe County,12,734,369,365
Kentucky,Metcalfe County,13,653,310,343
Kentucky,Metcalfe County,14,526,254,272
Kentucky,Metcalfe County,15,445,216,229
Kentucky,Metcalfe County,16,376,179,197
Kentucky,Metcalfe County,17,238,103,135
Kentucky,Metcalfe County,18,176,61,115
Kentucky,Monroe County,0,10704,5334,5370
Kentucky,Monroe County,1,624,345,279
Kentucky,Monroe County,2,659,342,317
Kentucky,Monroe County,3,670,359,311
Kentucky,Monroe County,4,677,349,328
Kentucky,Monroe County,5,635,327,308
Kentucky,Monroe County,6,551,282,269
Kentucky,Monroe County,7,611,311,300
Kentucky,Monroe County,8,598,303,295
Kentucky,Monroe County,9,637,310,327
Kentucky,Monroe County,10,732,380,352
Kentucky,Monroe County,11,835,424,411
Kentucky,Monroe County,12,794,392,402
Kentucky,Monroe County,13,710,353,357
Kentucky,Monroe County,14,637,289,348
Kentucky,Monroe County,15,541,253,288
Kentucky,Monroe County,16,382,181,201
Kentucky,Monroe County,17,232,87,145
Kentucky,Monroe County,18,179,47,132
Kentucky,Montgomery County,0,27474,13387,14087
Kentucky,Montgomery County,1,1879,955,924
Kentucky,Montgomery County,2,1815,937,878
Kentucky,Montgomery County,3,1815,939,876
Kentucky,Montgomery County,4,1677,871,806
Kentucky,Montgomery County,5,1731,863,868
Kentucky,Montgomery County,6,1577,787,790
Kentucky,Montgomery County,7,1761,893,868
Kentucky,Montgomery County,8,1861,881,980
Kentucky,Montgomery County,9,2010,1008,1002
Kentucky,Montgomery County,10,1956,954,1002
Kentucky,Montgomery County,11,1897,942,955
Kentucky,Montgomery County,12,1815,836,979
Kentucky,Montgomery County,13,1622,755,867
Kentucky,Montgomery County,14,1488,686,802
Kentucky,Montgomery County,15,957,431,526
Kentucky,Montgomery County,16,698,308,390
Kentucky,Montgomery County,17,453,184,269
Kentucky,Montgomery County,18,462,157,305
Kentucky,Morgan County,0,13303,7478,5825
Kentucky,Morgan County,1,614,292,322
Kentucky,Morgan County,2,710,381,329
Kentucky,Morgan County,3,728,395,333
Kentucky,Morgan County,4,668,377,291
Kentucky,Morgan County,5,901,564,337
Kentucky,Morgan County,6,976,656,320
Kentucky,Morgan County,7,1013,645,368
Kentucky,Morgan County,8,967,589,378
Kentucky,Morgan County,9,988,588,400
Kentucky,Morgan County,10,967,563,404
Kentucky,Morgan County,11,908,493,415
Kentucky,Morgan County,12,1020,551,469
Kentucky,Morgan County,13,902,466,436
Kentucky,Morgan County,14,676,342,334
Kentucky,Morgan County,15,460,214,246
Kentucky,Morgan County,16,375,179,196
Kentucky,Morgan County,17,235,104,131
Kentucky,Morgan County,18,195,79,116
Kentucky,Muhlenberg County,0,31207,15868,15339
Kentucky,Muhlenberg County,1,1642,850,792
Kentucky,Muhlenberg County,2,1728,946,782
Kentucky,Muhlenberg County,3,1955,1026,929
Kentucky,Muhlenberg County,4,1981,1041,940
Kentucky,Muhlenberg County,5,2084,1183,901
Kentucky,Muhlenberg County,6,1846,1007,839
Kentucky,Muhlenberg County,7,1832,969,863
Kentucky,Muhlenberg County,8,1928,1048,880
Kentucky,Muhlenberg County,9,2079,1102,977
Kentucky,Muhlenberg County,10,2090,1116,974
Kentucky,Muhlenberg County,11,2293,1143,1150
Kentucky,Muhlenberg County,12,2198,1094,1104
Kentucky,Muhlenberg County,13,1992,968,1024
Kentucky,Muhlenberg County,14,1823,866,957
Kentucky,Muhlenberg County,15,1412,637,775
Kentucky,Muhlenberg County,16,978,401,577
Kentucky,Muhlenberg County,17,704,284,420
Kentucky,Muhlenberg County,18,642,187,455
Kentucky,Nelson County,0,44812,22031,22781
Kentucky,Nelson County,1,2993,1532,1461
Kentucky,Nelson County,2,3076,1649,1427
Kentucky,Nelson County,3,3111,1590,1521
Kentucky,Nelson County,4,2987,1553,1434
Kentucky,Nelson County,5,2786,1363,1423
Kentucky,Nelson County,6,2690,1305,1385
Kentucky,Nelson County,7,2844,1394,1450
Kentucky,Nelson County,8,2824,1404,1420
Kentucky,Nelson County,9,2944,1455,1489
Kentucky,Nelson County,10,3142,1545,1597
Kentucky,Nelson County,11,3424,1676,1748
Kentucky,Nelson County,12,3193,1588,1605
Kentucky,Nelson County,13,2749,1302,1447
Kentucky,Nelson County,14,2198,1059,1139
Kentucky,Nelson County,15,1526,689,837
Kentucky,Nelson County,16,1023,453,570
Kentucky,Nelson County,17,669,289,380
Kentucky,Nelson County,18,633,185,448
Kentucky,Nicholas County,0,7041,3470,3571
Kentucky,Nicholas County,1,403,195,208
Kentucky,Nicholas County,2,451,226,225
Kentucky,Nicholas County,3,458,236,222
Kentucky,Nicholas County,4,429,228,201
Kentucky,Nicholas County,5,404,195,209
Kentucky,Nicholas County,6,392,203,189
Kentucky,Nicholas County,7,389,182,207
Kentucky,Nicholas County,8,421,222,199
Kentucky,Nicholas County,9,457,216,241
Kentucky,Nicholas County,10,522,288,234
Kentucky,Nicholas County,11,554,273,281
Kentucky,Nicholas County,12,501,251,250
Kentucky,Nicholas County,13,452,210,242
Kentucky,Nicholas County,14,402,196,206
Kentucky,Nicholas County,15,296,129,167
Kentucky,Nicholas County,16,228,95,133
Kentucky,Nicholas County,17,148,70,78
Kentucky,Nicholas County,18,134,55,79
Kentucky,Ohio County,0,23977,11962,12015
Kentucky,Ohio County,1,1542,778,764
Kentucky,Ohio County,2,1741,882,859
Kentucky,Ohio County,3,1631,895,736
Kentucky,Ohio County,4,1451,763,688
Kentucky,Ohio County,5,1362,710,652
Kentucky,Ohio County,6,1379,670,709
Kentucky,Ohio County,7,1433,722,711
Kentucky,Ohio County,8,1498,762,736
Kentucky,Ohio County,9,1522,760,762
Kentucky,Ohio County,10,1470,717,753
Kentucky,Ohio County,11,1701,842,859
Kentucky,Ohio County,12,1685,822,863
Kentucky,Ohio County,13,1511,760,751
Kentucky,Ohio County,14,1344,660,684
Kentucky,Ohio County,15,1053,530,523
Kentucky,Ohio County,16,723,344,379
Kentucky,Ohio County,17,468,210,258
Kentucky,Ohio County,18,463,135,328
Kentucky,Oldham County,0,63490,33344,30146
Kentucky,Oldham County,1,2913,1510,1403
Kentucky,Oldham County,2,4703,2368,2335
Kentucky,Oldham County,3,5616,2873,2743
Kentucky,Oldham County,4,5056,2585,2471
Kentucky,Oldham County,5,3502,2027,1475
Kentucky,Oldham County,6,2773,1709,1064
Kentucky,Oldham County,7,3427,1926,1501
Kentucky,Oldham County,8,4261,2298,1963
Kentucky,Oldham County,9,5139,2685,2454
Kentucky,Oldham County,10,5475,2937,2538
Kentucky,Oldham County,11,5321,2847,2474
Kentucky,Oldham County,12,4303,2197,2106
Kentucky,Oldham County,13,3543,1783,1760
Kentucky,Oldham County,14,3029,1543,1486
Kentucky,Oldham County,15,1996,1014,982
Kentucky,Oldham County,16,1133,560,573
Kentucky,Oldham County,17,669,272,397
Kentucky,Oldham County,18,631,210,421
Kentucky,Owen County,0,10645,5312,5333
Kentucky,Owen County,1,522,262,260
Kentucky,Owen County,2,724,349,375
Kentucky,Owen County,3,751,366,385
Kentucky,Owen County,4,693,371,322
Kentucky,Owen County,5,571,295,276
Kentucky,Owen County,6,529,259,270
Kentucky,Owen County,7,591,300,291
Kentucky,Owen County,8,657,326,331
Kentucky,Owen County,9,704,337,367
Kentucky,Owen County,10,717,379,338
Kentucky,Owen County,11,815,401,414
Kentucky,Owen County,12,838,438,400
Kentucky,Owen County,13,767,384,383
Kentucky,Owen County,14,607,283,324
Kentucky,Owen County,15,497,277,220
Kentucky,Owen County,16,306,156,150
Kentucky,Owen County,17,207,76,131
Kentucky,Owen County,18,149,53,96
Kentucky,Owsley County,0,4508,2199,2309
Kentucky,Owsley County,1,256,119,137
Kentucky,Owsley County,2,265,140,125
Kentucky,Owsley County,3,263,133,130
Kentucky,Owsley County,4,248,115,133
Kentucky,Owsley County,5,252,127,125
Kentucky,Owsley County,6,279,139,140
Kentucky,Owsley County,7,262,126,136
Kentucky,Owsley County,8,249,126,123
Kentucky,Owsley County,9,271,129,142
Kentucky,Owsley County,10,336,165,171
Kentucky,Owsley County,11,323,172,151
Kentucky,Owsley County,12,346,168,178
Kentucky,Owsley County,13,356,174,182
Kentucky,Owsley County,14,258,128,130
Kentucky,Owsley County,15,238,110,128
Kentucky,Owsley County,16,132,57,75
Kentucky,Owsley County,17,85,27,58
Kentucky,Owsley County,18,89,44,45
Kentucky,Pendleton County,0,14493,7301,7192
Kentucky,Pendleton County,1,827,439,388
Kentucky,Pendleton County,2,917,471,446
Kentucky,Pendleton County,3,934,458,476
Kentucky,Pendleton County,4,910,492,418
Kentucky,Pendleton County,5,970,496,474
Kentucky,Pendleton County,6,807,402,405
Kentucky,Pendleton County,7,810,405,405
Kentucky,Pendleton County,8,818,417,401
Kentucky,Pendleton County,9,999,518,481
Kentucky,Pendleton County,10,1127,571,556
Kentucky,Pendleton County,11,1185,622,563
Kentucky,Pendleton County,12,1160,581,579
Kentucky,Pendleton County,13,924,466,458
Kentucky,Pendleton County,14,765,389,376
Kentucky,Pendleton County,15,530,244,286
Kentucky,Pendleton County,16,351,166,185
Kentucky,Pendleton County,17,229,94,135
Kentucky,Pendleton County,18,230,70,160
Kentucky,Perry County,0,27597,13666,13931
Kentucky,Perry County,1,1822,1005,817
Kentucky,Perry County,2,1622,856,766
Kentucky,Perry County,3,1616,829,787
Kentucky,Perry County,4,1345,689,656
Kentucky,Perry County,5,1704,875,829
Kentucky,Perry County,6,1767,910,857
Kentucky,Perry County,7,1712,847,865
Kentucky,Perry County,8,1811,888,923
Kentucky,Perry County,9,1836,878,958
Kentucky,Perry County,10,1977,986,991
Kentucky,Perry County,11,2066,986,1080
Kentucky,Perry County,12,2121,1037,1084
Kentucky,Perry County,13,1941,927,1014
Kentucky,Perry County,14,1548,752,796
Kentucky,Perry County,15,1071,469,602
Kentucky,Perry County,16,802,391,411
Kentucky,Perry County,17,433,185,248
Kentucky,Perry County,18,403,156,247
Kentucky,Pike County,0,63034,30909,32125
Kentucky,Pike County,1,3580,1784,1796
Kentucky,Pike County,2,3625,1796,1829
Kentucky,Pike County,3,3724,1926,1798
Kentucky,Pike County,4,3817,2024,1793
Kentucky,Pike County,5,4121,2184,1937
Kentucky,Pike County,6,3560,1822,1738
Kentucky,Pike County,7,3703,1856,1847
Kentucky,Pike County,8,4162,2086,2076
Kentucky,Pike County,9,4215,2038,2177
Kentucky,Pike County,10,4471,2154,2317
Kentucky,Pike County,11,4702,2329,2373
Kentucky,Pike County,12,4896,2409,2487
Kentucky,Pike County,13,4414,2148,2266
Kentucky,Pike County,14,3680,1683,1997
Kentucky,Pike County,15,2465,1106,1359
Kentucky,Pike County,16,1766,784,982
Kentucky,Pike County,17,1145,418,727
Kentucky,Pike County,18,988,362,626
Kentucky,Powell County,0,12434,6170,6264
Kentucky,Powell County,1,864,448,416
Kentucky,Powell County,2,795,409,386
Kentucky,Powell County,3,792,403,389
Kentucky,Powell County,4,778,381,397
Kentucky,Powell County,5,774,389,385
Kentucky,Powell County,6,740,369,371
Kentucky,Powell County,7,783,381,402
Kentucky,Powell County,8,791,397,394
Kentucky,Powell County,9,880,440,440
Kentucky,Powell County,10,850,466,384
Kentucky,Powell County,11,886,416,470
Kentucky,Powell County,12,928,457,471
Kentucky,Powell County,13,788,394,394
Kentucky,Powell County,14,650,318,332
Kentucky,Powell County,15,434,204,230
Kentucky,Powell County,16,330,149,181
Kentucky,Powell County,17,219,93,126
Kentucky,Powell County,18,152,56,96
Kentucky,Pulaski County,0,63825,31170,32655
Kentucky,Pulaski County,1,3654,1895,1759
Kentucky,Pulaski County,2,4074,2035,2039
Kentucky,Pulaski County,3,4249,2220,2029
Kentucky,Pulaski County,4,3756,1919,1837
Kentucky,Pulaski County,5,3684,1900,1784
Kentucky,Pulaski County,6,3433,1611,1822
Kentucky,Pulaski County,7,3752,1842,1910
Kentucky,Pulaski County,8,3854,1859,1995
Kentucky,Pulaski County,9,4191,2123,2068
Kentucky,Pulaski County,10,4309,2121,2188
Kentucky,Pulaski County,11,4743,2306,2437
Kentucky,Pulaski County,12,4554,2202,2352
Kentucky,Pulaski County,13,4268,2029,2239
Kentucky,Pulaski County,14,3800,1804,1996
Kentucky,Pulaski County,15,2908,1382,1526
Kentucky,Pulaski County,16,2052,958,1094
Kentucky,Pulaski County,17,1428,592,836
Kentucky,Pulaski County,18,1116,372,744
Kentucky,Robertson County,0,2197,1142,1055
Kentucky,Robertson County,1,74,60,14
Kentucky,Robertson County,2,145,67,78
Kentucky,Robertson County,3,137,83,54
Kentucky,Robertson County,4,117,60,57
Kentucky,Robertson County,5,148,74,74
Kentucky,Robertson County,6,109,58,51
Kentucky,Robertson County,7,101,45,56
Kentucky,Robertson County,8,102,56,46
Kentucky,Robertson County,9,127,63,64
Kentucky,Robertson County,10,160,83,77
Kentucky,Robertson County,11,187,98,89
Kentucky,Robertson County,12,160,72,88
Kentucky,Robertson County,13,147,85,62
Kentucky,Robertson County,14,159,81,78
Kentucky,Robertson County,15,114,62,52
Kentucky,Robertson County,16,76,31,45
Kentucky,Robertson County,17,67,27,40
Kentucky,Robertson County,18,67,37,30
Kentucky,Rockcastle County,0,16826,8238,8588
Kentucky,Rockcastle County,1,931,463,468
Kentucky,Rockcastle County,2,1001,469,532
Kentucky,Rockcastle County,3,1143,589,554
Kentucky,Rockcastle County,4,992,524,468
Kentucky,Rockcastle County,5,1002,505,497
Kentucky,Rockcastle County,6,961,476,485
Kentucky,Rockcastle County,7,892,433,459
Kentucky,Rockcastle County,8,1012,479,533
Kentucky,Rockcastle County,9,1123,537,586
Kentucky,Rockcastle County,10,1313,704,609
Kentucky,Rockcastle County,11,1315,641,674
Kentucky,Rockcastle County,12,1242,630,612
Kentucky,Rockcastle County,13,1099,528,571
Kentucky,Rockcastle County,14,955,438,517
Kentucky,Rockcastle County,15,759,353,406
Kentucky,Rockcastle County,16,550,261,289
Kentucky,Rockcastle County,17,308,127,181
Kentucky,Rockcastle County,18,228,81,147
Kentucky,Rowan County,0,23655,11522,12133
Kentucky,Rowan County,1,1332,702,630
Kentucky,Rowan County,2,1286,672,614
Kentucky,Rowan County,3,1209,631,578
Kentucky,Rowan County,4,2275,1035,1240
Kentucky,Rowan County,5,3547,1737,1810
Kentucky,Rowan County,6,1516,838,678
Kentucky,Rowan County,7,1309,656,653
Kentucky,Rowan County,8,1229,596,633
Kentucky,Rowan County,9,1293,621,672
Kentucky,Rowan County,10,1410,675,735
Kentucky,Rowan County,11,1432,701,731
Kentucky,Rowan County,12,1424,691,733
Kentucky,Rowan County,13,1213,565,648
Kentucky,Rowan County,14,1030,476,554
Kentucky,Rowan County,15,809,360,449
Kentucky,Rowan County,16,631,304,327
Kentucky,Rowan County,17,361,143,218
Kentucky,Rowan County,18,349,119,230
Kentucky,Russell County,0,17774,8698,9076
Kentucky,Russell County,1,1125,561,564
Kentucky,Russell County,2,1111,569,542
Kentucky,Russell County,3,1102,544,558
Kentucky,Russell County,4,994,506,488
Kentucky,Russell County,5,997,503,494
Kentucky,Russell County,6,934,484,450
Kentucky,Russell County,7,948,465,483
Kentucky,Russell County,8,1000,475,525
Kentucky,Russell County,9,1149,583,566
Kentucky,Russell County,10,1221,585,636
Kentucky,Russell County,11,1298,660,638
Kentucky,Russell County,12,1323,630,693
Kentucky,Russell County,13,1207,584,623
Kentucky,Russell County,14,1115,560,555
Kentucky,Russell County,15,821,395,426
Kentucky,Russell County,16,620,306,314
Kentucky,Russell County,17,436,178,258
Kentucky,Russell County,18,373,110,263
Kentucky,Scott County,0,51284,25221,26063
Kentucky,Scott County,1,3467,1740,1727
Kentucky,Scott County,2,3763,1919,1844
Kentucky,Scott County,3,3893,1946,1947
Kentucky,Scott County,4,3639,1853,1786
Kentucky,Scott County,5,3503,1765,1738
Kentucky,Scott County,6,2983,1456,1527
Kentucky,Scott County,7,3575,1735,1840
Kentucky,Scott County,8,3742,1812,1930
Kentucky,Scott County,9,3966,1993,1973
Kentucky,Scott County,10,3681,1794,1887
Kentucky,Scott County,11,3649,1857,1792
Kentucky,Scott County,12,3216,1571,1645
Kentucky,Scott County,13,2734,1352,1382
Kentucky,Scott County,14,2056,963,1093
Kentucky,Scott County,15,1384,644,740
Kentucky,Scott County,16,907,402,505
Kentucky,Scott County,17,613,239,374
Kentucky,Scott County,18,513,180,333
Kentucky,Shelby County,0,44875,21775,23100
Kentucky,Shelby County,1,3164,1683,1481
Kentucky,Shelby County,2,2835,1449,1386
Kentucky,Shelby County,3,2997,1530,1467
Kentucky,Shelby County,4,2891,1515,1376
Kentucky,Shelby County,5,2730,1341,1389
Kentucky,Shelby County,6,2476,1099,1377
Kentucky,Shelby County,7,2946,1391,1555
Kentucky,Shelby County,8,2957,1365,1592
Kentucky,Shelby County,9,3182,1552,1630
Kentucky,Shelby County,10,3244,1541,1703
Kentucky,Shelby County,11,3391,1623,1768
Kentucky,Shelby County,12,3062,1493,1569
Kentucky,Shelby County,13,2720,1295,1425
Kentucky,Shelby County,14,2368,1150,1218
Kentucky,Shelby County,15,1613,787,826
Kentucky,Shelby County,16,980,448,532
Kentucky,Shelby County,17,671,284,387
Kentucky,Shelby County,18,648,229,419
Kentucky,Simpson County,0,17826,8722,9104
Kentucky,Simpson County,1,1131,594,537
Kentucky,Simpson County,2,1199,619,580
Kentucky,Simpson County,3,1227,624,603
Kentucky,Simpson County,4,1112,544,568
Kentucky,Simpson County,5,1122,599,523
Kentucky,Simpson County,6,1055,529,526
Kentucky,Simpson County,7,1026,490,536
Kentucky,Simpson County,8,1094,548,546
Kentucky,Simpson County,9,1145,580,565
Kentucky,Simpson County,10,1195,602,593
Kentucky,Simpson County,11,1332,644,688
Kentucky,Simpson County,12,1276,613,663
Kentucky,Simpson County,13,1088,513,575
Kentucky,Simpson County,14,958,452,506
Kentucky,Simpson County,15,735,332,403
Kentucky,Simpson County,16,497,202,295
Kentucky,Simpson County,17,337,142,195
Kentucky,Simpson County,18,297,95,202
Kentucky,Spencer County,0,17668,8912,8756
Kentucky,Spencer County,1,924,454,470
Kentucky,Spencer County,2,1214,648,566
Kentucky,Spencer County,3,1301,657,644
Kentucky,Spencer County,4,1148,615,533
Kentucky,Spencer County,5,929,492,437
Kentucky,Spencer County,6,800,395,405
Kentucky,Spencer County,7,1071,504,567
Kentucky,Spencer County,8,1170,591,579
Kentucky,Spencer County,9,1434,706,728
Kentucky,Spencer County,10,1445,722,723
Kentucky,Spencer County,11,1576,794,782
Kentucky,Spencer County,12,1381,709,672
Kentucky,Spencer County,13,1083,536,547
Kentucky,Spencer County,14,903,447,456
Kentucky,Spencer County,15,586,303,283
Kentucky,Spencer County,16,319,165,154
Kentucky,Spencer County,17,218,104,114
Kentucky,Spencer County,18,166,70,96
Kentucky,Taylor County,0,25257,12248,13009
Kentucky,Taylor County,1,1583,786,797
Kentucky,Taylor County,2,1528,791,737
Kentucky,Taylor County,3,1513,758,755
Kentucky,Taylor County,4,2033,1039,994
Kentucky,Taylor County,5,2080,1063,1017
Kentucky,Taylor County,6,1574,800,774
Kentucky,Taylor County,7,1412,729,683
Kentucky,Taylor County,8,1284,643,641
Kentucky,Taylor County,9,1331,646,685
Kentucky,Taylor County,10,1560,752,808
Kentucky,Taylor County,11,1745,826,919
Kentucky,Taylor County,12,1725,786,939
Kentucky,Taylor County,13,1526,723,803
Kentucky,Taylor County,14,1403,690,713
Kentucky,Taylor County,15,1073,489,584
Kentucky,Taylor County,16,837,349,488
Kentucky,Taylor County,17,578,231,347
Kentucky,Taylor County,18,472,147,325
Kentucky,Todd County,0,12520,6227,6293
Kentucky,Todd County,1,918,481,437
Kentucky,Todd County,2,989,499,490
Kentucky,Todd County,3,936,479,457
Kentucky,Todd County,4,837,441,396
Kentucky,Todd County,5,750,365,385
Kentucky,Todd County,6,781,379,402
Kentucky,Todd County,7,673,340,333
Kentucky,Todd County,8,715,356,359
Kentucky,Todd County,9,798,413,385
Kentucky,Todd County,10,811,416,395
Kentucky,Todd County,11,863,421,442
Kentucky,Todd County,12,810,405,405
Kentucky,Todd County,13,683,335,348
Kentucky,Todd County,14,641,312,329
Kentucky,Todd County,15,509,250,259
Kentucky,Todd County,16,345,166,179
Kentucky,Todd County,17,247,104,143
Kentucky,Todd County,18,214,65,149
Kentucky,Trigg County,0,14142,6913,7229
Kentucky,Trigg County,1,746,386,360
Kentucky,Trigg County,2,816,382,434
Kentucky,Trigg County,3,958,479,479
Kentucky,Trigg County,4,829,429,400
Kentucky,Trigg County,5,718,375,343
Kentucky,Trigg County,6,615,286,329
Kentucky,Trigg County,7,680,322,358
Kentucky,Trigg County,8,697,327,370
Kentucky,Trigg County,9,918,444,474
Kentucky,Trigg County,10,963,468,495
Kentucky,Trigg County,11,1073,525,548
Kentucky,Trigg County,12,1069,494,575
Kentucky,Trigg County,13,1064,525,539
Kentucky,Trigg County,14,1048,521,527
Kentucky,Trigg County,15,804,401,403
Kentucky,Trigg County,16,566,315,251
Kentucky,Trigg County,17,312,140,172
Kentucky,Trigg County,18,266,94,172
Kentucky,Trimble County,0,8786,4435,4351
Kentucky,Trimble County,1,492,254,238
Kentucky,Trimble County,2,593,307,286
Kentucky,Trimble County,3,595,322,273
Kentucky,Trimble County,4,611,295,316
Kentucky,Trimble County,5,486,246,240
Kentucky,Trimble County,6,460,232,228
Kentucky,Trimble County,7,508,244,264
Kentucky,Trimble County,8,509,257,252
Kentucky,Trimble County,9,647,332,315
Kentucky,Trimble County,10,625,337,288
Kentucky,Trimble County,11,692,357,335
Kentucky,Trimble County,12,649,337,312
Kentucky,Trimble County,13,545,270,275
Kentucky,Trimble County,14,546,268,278
Kentucky,Trimble County,15,319,149,170
Kentucky,Trimble County,16,245,116,129
Kentucky,Trimble County,17,120,52,68
Kentucky,Trimble County,18,144,60,84
Kentucky,Union County,0,15165,7874,7291
Kentucky,Union County,1,801,405,396
Kentucky,Union County,2,807,410,397
Kentucky,Union County,3,855,410,445
Kentucky,Union County,4,1409,901,508
Kentucky,Union County,5,1693,1128,565
Kentucky,Union County,6,814,444,370
Kentucky,Union County,7,847,402,445
Kentucky,Union County,8,869,439,430
Kentucky,Union County,9,848,418,430
Kentucky,Union County,10,885,422,463
Kentucky,Union County,11,984,482,502
Kentucky,Union County,12,1069,496,573
Kentucky,Union County,13,1002,511,491
Kentucky,Union County,14,809,405,404
Kentucky,Union County,15,514,233,281
Kentucky,Union County,16,412,186,226
Kentucky,Union County,17,307,112,195
Kentucky,Union County,18,240,70,170
Kentucky,Warren County,0,120460,58887,61573
Kentucky,Warren County,1,7623,3896,3727
Kentucky,Warren County,2,7536,3812,3724
Kentucky,Warren County,3,7352,3777,3575
Kentucky,Warren County,4,10108,5016,5092
Kentucky,Warren County,5,14431,7243,7188
Kentucky,Warren County,6,8248,4166,4082
Kentucky,Warren County,7,8062,3960,4102
Kentucky,Warren County,8,7367,3577,3790
Kentucky,Warren County,9,7261,3610,3651
Kentucky,Warren County,10,6913,3370,3543
Kentucky,Warren County,11,7691,3745,3946
Kentucky,Warren County,12,7134,3405,3729
Kentucky,Warren County,13,6241,2925,3316
Kentucky,Warren County,14,5052,2454,2598
Kentucky,Warren County,15,3573,1643,1930
Kentucky,Warren County,16,2432,1087,1345
Kentucky,Warren County,17,1683,662,1021
Kentucky,Warren County,18,1753,539,1214
Kentucky,Washington County,0,11959,5840,6119
Kentucky,Washington County,1,717,367,350
Kentucky,Washington County,2,738,378,360
Kentucky,Washington County,3,784,401,383
Kentucky,Washington County,4,873,448,425
Kentucky,Washington County,5,809,417,392
Kentucky,Washington County,6,595,293,302
Kentucky,Washington County,7,610,302,308
Kentucky,Washington County,8,649,315,334
Kentucky,Washington County,9,751,349,402
Kentucky,Washington County,10,811,428,383
Kentucky,Washington County,11,965,474,491
Kentucky,Washington County,12,814,402,412
Kentucky,Washington County,13,787,388,399
Kentucky,Washington County,14,647,314,333
Kentucky,Washington County,15,515,247,268
Kentucky,Washington County,16,357,150,207
Kentucky,Washington County,17,258,84,174
Kentucky,Washington County,18,279,83,196
Kentucky,Wayne County,0,20486,10144,10342
Kentucky,Wayne County,1,1135,576,559
Kentucky,Wayne County,2,1195,602,593
Kentucky,Wayne County,3,1227,594,633
Kentucky,Wayne County,4,1279,698,581
Kentucky,Wayne County,5,1218,600,618
Kentucky,Wayne County,6,1147,606,541
Kentucky,Wayne County,7,1154,588,566
Kentucky,Wayne County,8,1193,609,584
Kentucky,Wayne County,9,1320,678,642
Kentucky,Wayne County,10,1417,693,724
Kentucky,Wayne County,11,1476,701,775
Kentucky,Wayne County,12,1557,769,788
Kentucky,Wayne County,13,1458,735,723
Kentucky,Wayne County,14,1265,596,669
Kentucky,Wayne County,15,992,468,524
Kentucky,Wayne County,16,711,329,382
Kentucky,Wayne County,17,386,159,227
Kentucky,Wayne County,18,356,143,213
Kentucky,Webster County,0,13236,6615,6621
Kentucky,Webster County,1,874,470,404
Kentucky,Webster County,2,894,456,438
Kentucky,Webster County,3,795,379,416
Kentucky,Webster County,4,724,362,362
Kentucky,Webster County,5,782,425,357
Kentucky,Webster County,6,767,379,388
Kentucky,Webster County,7,801,422,379
Kentucky,Webster County,8,809,442,367
Kentucky,Webster County,9,866,456,410
Kentucky,Webster County,10,897,441,456
Kentucky,Webster County,11,939,442,497
Kentucky,Webster County,12,987,511,476
Kentucky,Webster County,13,935,455,480
Kentucky,Webster County,14,690,340,350
Kentucky,Webster County,15,532,266,266
Kentucky,Webster County,16,393,165,228
Kentucky,Webster County,17,254,101,153
Kentucky,Webster County,18,297,103,194
Kentucky,Whitley County,0,35503,17431,18072
Kentucky,Whitley County,1,2463,1230,1233
Kentucky,Whitley County,2,2235,1178,1057
Kentucky,Whitley County,3,2373,1222,1151
Kentucky,Whitley County,4,2598,1320,1278
Kentucky,Whitley County,5,2902,1474,1428
Kentucky,Whitley County,6,2121,1071,1050
Kentucky,Whitley County,7,1998,991,1007
Kentucky,Whitley County,8,2074,1015,1059
Kentucky,Whitley County,9,2143,1051,1092
Kentucky,Whitley County,10,2372,1126,1246
Kentucky,Whitley County,11,2410,1215,1195
Kentucky,Whitley County,12,2337,1108,1229
Kentucky,Whitley County,13,2119,1037,1082
Kentucky,Whitley County,14,1883,899,984
Kentucky,Whitley County,15,1384,637,747
Kentucky,Whitley County,16,959,423,536
Kentucky,Whitley County,17,590,234,356
Kentucky,Whitley County,18,542,200,342
Kentucky,Wolfe County,0,7214,3568,3646
Kentucky,Wolfe County,1,440,251,189
Kentucky,Wolfe County,2,469,246,223
Kentucky,Wolfe County,3,502,251,251
Kentucky,Wolfe County,4,426,225,201
Kentucky,Wolfe County,5,381,200,181
Kentucky,Wolfe County,6,357,173,184
Kentucky,Wolfe County,7,418,185,233
Kentucky,Wolfe County,8,438,210,228
Kentucky,Wolfe County,9,411,196,215
Kentucky,Wolfe County,10,470,227,243
Kentucky,Wolfe County,11,574,285,289
Kentucky,Wolfe County,12,532,254,278
Kentucky,Wolfe County,13,513,249,264
Kentucky,Wolfe County,14,446,247,199
Kentucky,Wolfe County,15,346,158,188
Kentucky,Wolfe County,16,247,110,137
Kentucky,Wolfe County,17,138,62,76
Kentucky,Wolfe County,18,106,39,67
Kentucky,Woodford County,0,25563,12232,13331
Kentucky,Woodford County,1,1393,669,724
Kentucky,Woodford County,2,1520,721,799
Kentucky,Woodford County,3,1833,921,912
Kentucky,Woodford County,4,1720,815,905
Kentucky,Woodford County,5,1414,655,759
Kentucky,Woodford County,6,1278,648,630
Kentucky,Woodford County,7,1464,729,735
Kentucky,Woodford County,8,1532,749,783
Kentucky,Woodford County,9,1651,805,846
Kentucky,Woodford County,10,1756,847,909
Kentucky,Woodford County,11,2128,1035,1093
Kentucky,Woodford County,12,2002,951,1051
Kentucky,Woodford County,13,1849,869,980
Kentucky,Woodford County,14,1503,751,752
Kentucky,Woodford County,15,969,448,521
Kentucky,Woodford County,16,678,308,370
Kentucky,Woodford County,17,432,161,271
Kentucky,Woodford County,18,441,150,291
Louisiana,Acadia Parish,0,62486,30328,32158
Louisiana,Acadia Parish,1,4418,2146,2272
Louisiana,Acadia Parish,2,4761,2489,2272
Louisiana,Acadia Parish,3,4680,2405,2275
Louisiana,Acadia Parish,4,4243,2217,2026
Louisiana,Acadia Parish,5,4267,2118,2149
Louisiana,Acadia Parish,6,4169,2059,2110
Louisiana,Acadia Parish,7,4037,1945,2092
Louisiana,Acadia Parish,8,3665,1745,1920
Louisiana,Acadia Parish,9,3566,1696,1870
Louisiana,Acadia Parish,10,4025,1917,2108
Louisiana,Acadia Parish,11,4496,2207,2289
Louisiana,Acadia Parish,12,4233,2082,2151
Louisiana,Acadia Parish,13,3492,1678,1814
Louisiana,Acadia Parish,14,2796,1319,1477
Louisiana,Acadia Parish,15,2044,930,1114
Louisiana,Acadia Parish,16,1533,664,869
Louisiana,Acadia Parish,17,1107,438,669
Louisiana,Acadia Parish,18,954,273,681
Louisiana,Allen Parish,0,25713,14570,11143
Louisiana,Allen Parish,1,1582,804,778
Louisiana,Allen Parish,2,1654,831,823
Louisiana,Allen Parish,3,1581,790,791
Louisiana,Allen Parish,4,1502,809,693
Louisiana,Allen Parish,5,1730,1041,689
Louisiana,Allen Parish,6,1945,1299,646
Louisiana,Allen Parish,7,2067,1406,661
Louisiana,Allen Parish,8,1802,1173,629
Louisiana,Allen Parish,9,1787,1141,646
Louisiana,Allen Parish,10,1810,1096,714
Louisiana,Allen Parish,11,1806,1018,788
Louisiana,Allen Parish,12,1621,874,747
Louisiana,Allen Parish,13,1407,736,671
Louisiana,Allen Parish,14,1123,558,565
Louisiana,Allen Parish,15,860,390,470
Louisiana,Allen Parish,16,628,286,342
Louisiana,Allen Parish,17,428,188,240
Louisiana,Allen Parish,18,380,130,250
Louisiana,Ascension Parish,0,117029,57718,59311
Louisiana,Ascension Parish,1,8342,4323,4019
Louisiana,Ascension Parish,2,9159,4641,4518
Louisiana,Ascension Parish,3,9381,4804,4577
Louisiana,Ascension Parish,4,8149,4196,3953
Louisiana,Ascension Parish,5,7229,3679,3550
Louisiana,Ascension Parish,6,7701,3866,3835
Louisiana,Ascension Parish,7,8725,4211,4514
Louisiana,Ascension Parish,8,8252,3906,4346
Louisiana,Ascension Parish,9,8539,4209,4330
Louisiana,Ascension Parish,10,8436,4147,4289
Louisiana,Ascension Parish,11,8135,3992,4143
Louisiana,Ascension Parish,12,7183,3527,3656
Louisiana,Ascension Parish,13,5864,2823,3041
Louisiana,Ascension Parish,14,4522,2223,2299
Louisiana,Ascension Parish,15,3194,1448,1746
Louisiana,Ascension Parish,16,1941,863,1078
Louisiana,Ascension Parish,17,1255,511,744
Louisiana,Ascension Parish,18,1022,349,673
Louisiana,Assumption Parish,0,23034,11268,11766
Louisiana,Assumption Parish,1,1302,680,622
Louisiana,Assumption Parish,2,1465,759,706
Louisiana,Assumption Parish,3,1555,789,766
Louisiana,Assumption Parish,4,1455,734,721
Louisiana,Assumption Parish,5,1600,820,780
Louisiana,Assumption Parish,6,1413,698,715
Louisiana,Assumption Parish,7,1442,693,749
Louisiana,Assumption Parish,8,1306,622,684
Louisiana,Assumption Parish,9,1378,647,731
Louisiana,Assumption Parish,10,1605,772,833
Louisiana,Assumption Parish,11,1777,859,918
Louisiana,Assumption Parish,12,1745,845,900
Louisiana,Assumption Parish,13,1481,713,768
Louisiana,Assumption Parish,14,1182,591,591
Louisiana,Assumption Parish,15,893,423,470
Louisiana,Assumption Parish,16,576,286,290
Louisiana,Assumption Parish,17,407,169,238
Louisiana,Assumption Parish,18,452,168,284
Louisiana,Avoyelles Parish,0,41145,20630,20515
Louisiana,Avoyelles Parish,1,2725,1376,1349
Louisiana,Avoyelles Parish,2,2713,1410,1303
Louisiana,Avoyelles Parish,3,2742,1368,1374
Louisiana,Avoyelles Parish,4,2522,1343,1179
Louisiana,Avoyelles Parish,5,2643,1402,1241
Louisiana,Avoyelles Parish,6,2734,1411,1323
Louisiana,Avoyelles Parish,7,2807,1529,1278
Louisiana,Avoyelles Parish,8,2532,1338,1194
Louisiana,Avoyelles Parish,9,2431,1233,1198
Louisiana,Avoyelles Parish,10,2786,1436,1350
Louisiana,Avoyelles Parish,11,2899,1471,1428
Louisiana,Avoyelles Parish,12,2757,1366,1391
Louisiana,Avoyelles Parish,13,2477,1187,1290
Louisiana,Avoyelles Parish,14,2018,953,1065
Louisiana,Avoyelles Parish,15,1580,752,828
Louisiana,Avoyelles Parish,16,1196,498,698
Louisiana,Avoyelles Parish,17,813,314,499
Louisiana,Avoyelles Parish,18,770,243,527
Louisiana,Beauregard Parish,0,36198,18569,17629
Louisiana,Beauregard Parish,1,2478,1345,1133
Louisiana,Beauregard Parish,2,2424,1280,1144
Louisiana,Beauregard Parish,3,2580,1305,1275
Louisiana,Beauregard Parish,4,2437,1311,1126
Louisiana,Beauregard Parish,5,2234,1254,980
Louisiana,Beauregard Parish,6,2287,1262,1025
Louisiana,Beauregard Parish,7,2575,1413,1162
Louisiana,Beauregard Parish,8,2307,1206,1101
Louisiana,Beauregard Parish,9,2384,1221,1163
Louisiana,Beauregard Parish,10,2293,1159,1134
Louisiana,Beauregard Parish,11,2435,1201,1234
Louisiana,Beauregard Parish,12,2419,1200,1219
Louisiana,Beauregard Parish,13,2138,1021,1117
Louisiana,Beauregard Parish,14,1817,847,970
Louisiana,Beauregard Parish,15,1378,637,741
Louisiana,Beauregard Parish,16,959,465,494
Louisiana,Beauregard Parish,17,591,253,338
Louisiana,Beauregard Parish,18,462,189,273
Louisiana,Bienville Parish,0,13885,6634,7251
Louisiana,Bienville Parish,1,875,406,469
Louisiana,Bienville Parish,2,856,449,407
Louisiana,Bienville Parish,3,928,451,477
Louisiana,Bienville Parish,4,865,454,411
Louisiana,Bienville Parish,5,840,428,412
Louisiana,Bienville Parish,6,842,416,426
Louisiana,Bienville Parish,7,740,347,393
Louisiana,Bienville Parish,8,667,299,368
Louisiana,Bienville Parish,9,784,402,382
Louisiana,Bienville Parish,10,871,416,455
Louisiana,Bienville Parish,11,1119,547,572
Louisiana,Bienville Parish,12,949,471,478
Louisiana,Bienville Parish,13,899,438,461
Louisiana,Bienville Parish,14,761,357,404
Louisiana,Bienville Parish,15,638,288,350
Louisiana,Bienville Parish,16,492,214,278
Louisiana,Bienville Parish,17,377,147,230
Louisiana,Bienville Parish,18,382,104,278
Louisiana,Bossier Parish,0,125064,61973,63091
Louisiana,Bossier Parish,1,9269,4730,4539
Louisiana,Bossier Parish,2,8820,4510,4310
Louisiana,Bossier Parish,3,8637,4452,4185
Louisiana,Bossier Parish,4,7751,4144,3607
Louisiana,Bossier Parish,5,9354,5108,4246
Louisiana,Bossier Parish,6,9811,4954,4857
Louisiana,Bossier Parish,7,9547,4806,4741
Louisiana,Bossier Parish,8,8264,4125,4139
Louisiana,Bossier Parish,9,8027,3975,4052
Louisiana,Bossier Parish,10,7207,3482,3725
Louisiana,Bossier Parish,11,8184,4017,4167
Louisiana,Bossier Parish,12,7709,3646,4063
Louisiana,Bossier Parish,13,6435,3029,3406
Louisiana,Bossier Parish,14,5282,2452,2830
Louisiana,Bossier Parish,15,3886,1727,2159
Louisiana,Bossier Parish,16,3027,1314,1713
Louisiana,Bossier Parish,17,2101,916,1185
Louisiana,Bossier Parish,18,1753,586,1167
Louisiana,Caddo Parish,0,252603,119825,132778
Louisiana,Caddo Parish,1,18236,9199,9037
Louisiana,Caddo Parish,2,16901,8613,8288
Louisiana,Caddo Parish,3,16534,8428,8106
Louisiana,Caddo Parish,4,15531,7780,7751
Louisiana,Caddo Parish,5,17539,8547,8992
Louisiana,Caddo Parish,6,18397,8848,9549
Louisiana,Caddo Parish,7,17469,8367,9102
Louisiana,Caddo Parish,8,15041,7106,7935
Louisiana,Caddo Parish,9,14786,6900,7886
Louisiana,Caddo Parish,10,14526,6880,7646
Louisiana,Caddo Parish,11,17006,8121,8885
Louisiana,Caddo Parish,12,17607,8181,9426
Louisiana,Caddo Parish,13,15656,7186,8470
Louisiana,Caddo Parish,14,12230,5658,6572
Louisiana,Caddo Parish,15,8667,3790,4877
Louisiana,Caddo Parish,16,6481,2651,3830
Louisiana,Caddo Parish,17,4895,1903,2992
Louisiana,Caddo Parish,18,5101,1667,3434
Louisiana,Calcasieu Parish,0,197204,96221,100983
Louisiana,Calcasieu Parish,1,13508,6913,6595
Louisiana,Calcasieu Parish,2,13905,7092,6813
Louisiana,Calcasieu Parish,3,13705,6997,6708
Louisiana,Calcasieu Parish,4,12790,6420,6370
Louisiana,Calcasieu Parish,5,14484,7243,7241
Louisiana,Calcasieu Parish,6,14424,7083,7341
Louisiana,Calcasieu Parish,7,13463,6686,6777
Louisiana,Calcasieu Parish,8,11716,5783,5933
Louisiana,Calcasieu Parish,9,11532,5683,5849
Louisiana,Calcasieu Parish,10,11802,5693,6109
Louisiana,Calcasieu Parish,11,13649,6577,7072
Louisiana,Calcasieu Parish,12,13563,6581,6982
Louisiana,Calcasieu Parish,13,11584,5643,5941
Louisiana,Calcasieu Parish,14,9102,4306,4796
Louisiana,Calcasieu Parish,15,6550,2854,3696
Louisiana,Calcasieu Parish,16,4981,2194,2787
Louisiana,Calcasieu Parish,17,3475,1405,2070
Louisiana,Calcasieu Parish,18,2971,1068,1903
Louisiana,Caldwell Parish,0,9894,5070,4824
Louisiana,Caldwell Parish,1,566,277,289
Louisiana,Caldwell Parish,2,635,332,303
Louisiana,Caldwell Parish,3,657,339,318
Louisiana,Caldwell Parish,4,569,312,257
Louisiana,Caldwell Parish,5,637,352,285
Louisiana,Caldwell Parish,6,655,389,266
Louisiana,Caldwell Parish,7,595,342,253
Louisiana,Caldwell Parish,8,609,318,291
Louisiana,Caldwell Parish,9,663,358,305
Louisiana,Caldwell Parish,10,629,314,315
Louisiana,Caldwell Parish,11,721,378,343
Louisiana,Caldwell Parish,12,685,330,355
Louisiana,Caldwell Parish,13,644,328,316
Louisiana,Caldwell Parish,14,574,276,298
Louisiana,Caldwell Parish,15,388,165,223
Louisiana,Caldwell Parish,16,316,144,172
Louisiana,Caldwell Parish,17,178,67,111
Louisiana,Caldwell Parish,18,173,49,124
Louisiana,Cameron Parish,0,6679,3339,3340
Louisiana,Cameron Parish,1,316,171,145
Louisiana,Cameron Parish,2,427,198,229
Louisiana,Cameron Parish,3,455,228,227
Louisiana,Cameron Parish,4,445,227,218
Louisiana,Cameron Parish,5,428,222,206
Louisiana,Cameron Parish,6,396,195,201
Louisiana,Cameron Parish,7,432,218,214
Louisiana,Cameron Parish,8,388,209,179
Louisiana,Cameron Parish,9,389,193,196
Louisiana,Cameron Parish,10,469,235,234
Louisiana,Cameron Parish,11,592,298,294
Louisiana,Cameron Parish,12,555,276,279
Louisiana,Cameron Parish,13,385,190,195
Louisiana,Cameron Parish,14,340,173,167
Louisiana,Cameron Parish,15,250,131,119
Louisiana,Cameron Parish,16,197,86,111
Louisiana,Cameron Parish,17,120,55,65
Louisiana,Cameron Parish,18,95,34,61
Louisiana,Catahoula Parish,0,10151,5391,4760
Louisiana,Catahoula Parish,1,616,325,291
Louisiana,Catahoula Parish,2,654,335,319
Louisiana,Catahoula Parish,3,622,327,295
Louisiana,Catahoula Parish,4,580,303,277
Louisiana,Catahoula Parish,5,739,450,289
Louisiana,Catahoula Parish,6,679,444,235
Louisiana,Catahoula Parish,7,740,433,307
Louisiana,Catahoula Parish,8,575,313,262
Louisiana,Catahoula Parish,9,598,342,256
Louisiana,Catahoula Parish,10,577,314,263
Louisiana,Catahoula Parish,11,742,374,368
Louisiana,Catahoula Parish,12,754,372,382
Louisiana,Catahoula Parish,13,677,351,326
Louisiana,Catahoula Parish,14,526,256,270
Louisiana,Catahoula Parish,15,375,170,205
Louisiana,Catahoula Parish,16,329,130,199
Louisiana,Catahoula Parish,17,215,88,127
Louisiana,Catahoula Parish,18,153,64,89
Louisiana,Claiborne Parish,0,16412,9284,7128
Louisiana,Claiborne Parish,1,866,432,434
Louisiana,Claiborne Parish,2,834,415,419
Louisiana,Claiborne Parish,3,801,419,382
Louisiana,Claiborne Parish,4,840,428,412
Louisiana,Claiborne Parish,5,1173,780,393
Louisiana,Claiborne Parish,6,1307,948,359
Louisiana,Claiborne Parish,7,1185,791,394
Louisiana,Claiborne Parish,8,998,655,343
Louisiana,Claiborne Parish,9,1050,641,409
Louisiana,Claiborne Parish,10,1132,669,463
Louisiana,Claiborne Parish,11,1169,676,493
Louisiana,Claiborne Parish,12,1182,634,548
Louisiana,Claiborne Parish,13,1002,518,484
Louisiana,Claiborne Parish,14,892,443,449
Louisiana,Claiborne Parish,15,655,303,352
Louisiana,Claiborne Parish,16,567,245,322
Louisiana,Claiborne Parish,17,416,177,239
Louisiana,Claiborne Parish,18,343,110,233
Louisiana,Concordia Parish,0,20466,10405,10061
Louisiana,Concordia Parish,1,1330,701,629
Louisiana,Concordia Parish,2,1443,688,755
Louisiana,Concordia Parish,3,1436,770,666
Louisiana,Concordia Parish,4,1295,683,612
Louisiana,Concordia Parish,5,1402,804,598
Louisiana,Concordia Parish,6,1366,828,538
Louisiana,Concordia Parish,7,1349,766,583
Louisiana,Concordia Parish,8,1243,645,598
Louisiana,Concordia Parish,9,1131,577,554
Louisiana,Concordia Parish,10,1204,605,599
Louisiana,Concordia Parish,11,1378,637,741
Louisiana,Concordia Parish,12,1465,718,747
Louisiana,Concordia Parish,13,1304,599,705
Louisiana,Concordia Parish,14,1006,476,530
Louisiana,Concordia Parish,15,757,336,421
Louisiana,Concordia Parish,16,564,248,316
Louisiana,Concordia Parish,17,424,189,235
Louisiana,Concordia Parish,18,369,135,234
Louisiana,De Soto Parish,0,27142,13119,14023
Louisiana,De Soto Parish,1,1806,903,903
Louisiana,De Soto Parish,2,1900,991,909
Louisiana,De Soto Parish,3,1898,989,909
Louisiana,De Soto Parish,4,1693,857,836
Louisiana,De Soto Parish,5,1660,832,828
Louisiana,De Soto Parish,6,1564,773,791
Louisiana,De Soto Parish,7,1652,797,855
Louisiana,De Soto Parish,8,1623,746,877
Louisiana,De Soto Parish,9,1600,787,813
Louisiana,De Soto Parish,10,1712,819,893
Louisiana,De Soto Parish,11,1995,942,1053
Louisiana,De Soto Parish,12,2004,975,1029
Louisiana,De Soto Parish,13,1702,781,921
Louisiana,De Soto Parish,14,1488,688,800
Louisiana,De Soto Parish,15,1078,523,555
Louisiana,De Soto Parish,16,770,315,455
Louisiana,De Soto Parish,17,502,229,273
Louisiana,De Soto Parish,18,495,172,323
Louisiana,East Baton Rouge Parish,0,446042,213649,232393
Louisiana,East Baton Rouge Parish,1,29076,15016,14060
Louisiana,East Baton Rouge Parish,2,28099,14335,13764
Louisiana,East Baton Rouge Parish,3,28012,14034,13978
Louisiana,East Baton Rouge Parish,4,31733,15742,15991
Louisiana,East Baton Rouge Parish,5,50460,24778,25682
Louisiana,East Baton Rouge Parish,6,33370,16815,16555
Louisiana,East Baton Rouge Parish,7,33065,16218,16847
Louisiana,East Baton Rouge Parish,8,26473,12747,13726
Louisiana,East Baton Rouge Parish,9,24830,11777,13053
Louisiana,East Baton Rouge Parish,10,24941,11804,13137
Louisiana,East Baton Rouge Parish,11,27763,12955,14808
Louisiana,East Baton Rouge Parish,12,28021,12993,15028
Louisiana,East Baton Rouge Parish,13,24864,11329,13535
Louisiana,East Baton Rouge Parish,14,19580,8878,10702
Louisiana,East Baton Rouge Parish,15,13092,5750,7342
Louisiana,East Baton Rouge Parish,16,9068,3741,5327
Louisiana,East Baton Rouge Parish,17,6505,2445,4060
Louisiana,East Baton Rouge Parish,18,7090,2292,4798
Louisiana,East Carroll Parish,0,7487,4056,3431
Louisiana,East Carroll Parish,1,560,273,287
Louisiana,East Carroll Parish,2,522,280,242
Louisiana,East Carroll Parish,3,514,260,254
Louisiana,East Carroll Parish,4,440,227,213
Louisiana,East Carroll Parish,5,624,378,246
Louisiana,East Carroll Parish,6,571,381,190
Louisiana,East Carroll Parish,7,508,313,195
Louisiana,East Carroll Parish,8,475,293,182
Louisiana,East Carroll Parish,9,410,245,165
Louisiana,East Carroll Parish,10,459,257,202
Louisiana,East Carroll Parish,11,512,293,219
Louisiana,East Carroll Parish,12,509,264,245
Louisiana,East Carroll Parish,13,390,194,196
Louisiana,East Carroll Parish,14,304,134,170
Louisiana,East Carroll Parish,15,243,99,144
Louisiana,East Carroll Parish,16,192,84,108
Louisiana,East Carroll Parish,17,133,42,91
Louisiana,East Carroll Parish,18,121,39,82
Louisiana,East Feliciana Parish,0,19813,10629,9184
Louisiana,East Feliciana Parish,1,1066,531,535
Louisiana,East Feliciana Parish,2,1051,512,539
Louisiana,East Feliciana Parish,3,1071,560,511
Louisiana,East Feliciana Parish,4,1084,596,488
Louisiana,East Feliciana Parish,5,1345,766,579
Louisiana,East Feliciana Parish,6,1299,766,533
Louisiana,East Feliciana Parish,7,1330,778,552
Louisiana,East Feliciana Parish,8,1178,702,476
Louisiana,East Feliciana Parish,9,1202,718,484
Louisiana,East Feliciana Parish,10,1403,811,592
Louisiana,East Feliciana Parish,11,1593,853,740
Louisiana,East Feliciana Parish,12,1692,879,813
Louisiana,East Feliciana Parish,13,1351,673,678
Louisiana,East Feliciana Parish,14,1130,542,588
Louisiana,East Feliciana Parish,15,868,420,448
Louisiana,East Feliciana Parish,16,548,270,278
Louisiana,East Feliciana Parish,17,315,137,178
Louisiana,East Feliciana Parish,18,287,115,172
Louisiana,Evangeline Parish,0,33700,17089,16611
Louisiana,Evangeline Parish,1,2459,1285,1174
Louisiana,Evangeline Parish,2,2473,1264,1209
Louisiana,Evangeline Parish,3,2435,1253,1182
Louisiana,Evangeline Parish,4,2367,1253,1114
Louisiana,Evangeline Parish,5,2493,1416,1077
Louisiana,Evangeline Parish,6,2117,1131,986
Louisiana,Evangeline Parish,7,2144,1118,1026
Louisiana,Evangeline Parish,8,1957,1042,915
Louisiana,Evangeline Parish,9,1913,963,950
Louisiana,Evangeline Parish,10,2101,1045,1056
Louisiana,Evangeline Parish,11,2408,1174,1234
Louisiana,Evangeline Parish,12,2164,1078,1086
Louisiana,Evangeline Parish,13,1857,911,946
Louisiana,Evangeline Parish,14,1582,744,838
Louisiana,Evangeline Parish,15,1250,581,669
Louisiana,Evangeline Parish,16,894,406,488
Louisiana,Evangeline Parish,17,576,218,358
Louisiana,Evangeline Parish,18,510,207,303
Louisiana,Franklin Parish,0,20441,9933,10508
Louisiana,Franklin Parish,1,1435,710,725
Louisiana,Franklin Parish,2,1472,762,710
Louisiana,Franklin Parish,3,1460,766,694
Louisiana,Franklin Parish,4,1329,702,627
Louisiana,Franklin Parish,5,1298,670,628
Louisiana,Franklin Parish,6,1252,624,628
Louisiana,Franklin Parish,7,1207,607,600
Louisiana,Franklin Parish,8,1157,550,607
Louisiana,Franklin Parish,9,1079,524,555
Louisiana,Franklin Parish,10,1211,579,632
Louisiana,Franklin Parish,11,1411,669,742
Louisiana,Franklin Parish,12,1395,698,697
Louisiana,Franklin Parish,13,1282,614,668
Louisiana,Franklin Parish,14,1031,487,544
Louisiana,Franklin Parish,15,851,370,481
Louisiana,Franklin Parish,16,664,295,369
Louisiana,Franklin Parish,17,463,167,296
Louisiana,Franklin Parish,18,444,139,305
Louisiana,Grant Parish,0,22384,12548,9836
Louisiana,Grant Parish,1,1284,669,615
Louisiana,Grant Parish,2,1367,680,687
Louisiana,Grant Parish,3,1368,735,633
Louisiana,Grant Parish,4,1300,719,581
Louisiana,Grant Parish,5,1411,820,591
Louisiana,Grant Parish,6,1801,1160,641
Louisiana,Grant Parish,7,1953,1315,638
Louisiana,Grant Parish,8,1673,1100,573
Louisiana,Grant Parish,9,1563,955,608
Louisiana,Grant Parish,10,1451,811,640
Louisiana,Grant Parish,11,1547,828,719
Louisiana,Grant Parish,12,1404,707,697
Louisiana,Grant Parish,13,1171,608,563
Louisiana,Grant Parish,14,1078,523,555
Louisiana,Grant Parish,15,800,391,409
Louisiana,Grant Parish,16,563,249,314
Louisiana,Grant Parish,17,352,166,186
Louisiana,Grant Parish,18,298,112,186
Louisiana,Iberia Parish,0,73913,36188,37725
Louisiana,Iberia Parish,1,5190,2644,2546
Louisiana,Iberia Parish,2,5516,2867,2649
Louisiana,Iberia Parish,3,5520,2756,2764
Louisiana,Iberia Parish,4,5159,2648,2511
Louisiana,Iberia Parish,5,5103,2561,2542
Louisiana,Iberia Parish,6,4779,2343,2436
Louisiana,Iberia Parish,7,4739,2367,2372
Louisiana,Iberia Parish,8,4368,2102,2266
Louisiana,Iberia Parish,9,4201,2060,2141
Louisiana,Iberia Parish,10,4765,2259,2506
Louisiana,Iberia Parish,11,5383,2616,2767
Louisiana,Iberia Parish,12,5195,2508,2687
Louisiana,Iberia Parish,13,4138,2063,2075
Louisiana,Iberia Parish,14,3279,1610,1669
Louisiana,Iberia Parish,15,2483,1095,1388
Louisiana,Iberia Parish,16,1795,779,1016
Louisiana,Iberia Parish,17,1242,527,715
Louisiana,Iberia Parish,18,1058,383,675
Louisiana,Iberville Parish,0,33327,17072,16255
Louisiana,Iberville Parish,1,2050,1090,960
Louisiana,Iberville Parish,2,2025,1046,979
Louisiana,Iberville Parish,3,1976,1024,952
Louisiana,Iberville Parish,4,1946,1054,892
Louisiana,Iberville Parish,5,2403,1296,1107
Louisiana,Iberville Parish,6,2436,1307,1129
Louisiana,Iberville Parish,7,2458,1318,1140
Louisiana,Iberville Parish,8,2106,1097,1009
Louisiana,Iberville Parish,9,2075,1052,1023
Louisiana,Iberville Parish,10,2377,1221,1156
Louisiana,Iberville Parish,11,2569,1350,1219
Louisiana,Iberville Parish,12,2413,1244,1169
Louisiana,Iberville Parish,13,1972,978,994
Louisiana,Iberville Parish,14,1521,735,786
Louisiana,Iberville Parish,15,1138,515,623
Louisiana,Iberville Parish,16,841,377,464
Louisiana,Iberville Parish,17,543,210,333
Louisiana,Iberville Parish,18,478,158,320
Louisiana,Jackson Parish,0,15994,8164,7830
Louisiana,Jackson Parish,1,901,486,415
Louisiana,Jackson Parish,2,1058,550,508
Louisiana,Jackson Parish,3,1017,549,468
Louisiana,Jackson Parish,4,908,429,479
Louisiana,Jackson Parish,5,981,576,405
Louisiana,Jackson Parish,6,1080,603,477
Louisiana,Jackson Parish,7,1058,587,471
Louisiana,Jackson Parish,8,942,509,433
Louisiana,Jackson Parish,9,915,495,420
Louisiana,Jackson Parish,10,1016,534,482
Louisiana,Jackson Parish,11,1114,553,561
Louisiana,Jackson Parish,12,1040,505,535
Louisiana,Jackson Parish,13,1030,486,544
Louisiana,Jackson Parish,14,944,440,504
Louisiana,Jackson Parish,15,711,333,378
Louisiana,Jackson Parish,16,571,275,296
Louisiana,Jackson Parish,17,364,146,218
Louisiana,Jackson Parish,18,344,108,236
Louisiana,Jefferson Parish,0,435716,211201,224515
Louisiana,Jefferson Parish,1,27293,13654,13639
Louisiana,Jefferson Parish,2,27152,13753,13399
Louisiana,Jefferson Parish,3,25426,13003,12423
Louisiana,Jefferson Parish,4,24392,12572,11820
Louisiana,Jefferson Parish,5,27967,13903,14064
Louisiana,Jefferson Parish,6,32802,16317,16485
Louisiana,Jefferson Parish,7,31483,15594,15889
Louisiana,Jefferson Parish,8,27252,13563,13689
Louisiana,Jefferson Parish,9,26727,13273,13454
Louisiana,Jefferson Parish,10,27928,13594,14334
Louisiana,Jefferson Parish,11,32022,15531,16491
Louisiana,Jefferson Parish,12,31858,15297,16561
Louisiana,Jefferson Parish,13,27734,13092,14642
Louisiana,Jefferson Parish,14,22186,10404,11782
Louisiana,Jefferson Parish,15,15647,7028,8619
Louisiana,Jefferson Parish,16,10833,4652,6181
Louisiana,Jefferson Parish,17,8137,3086,5051
Louisiana,Jefferson Parish,18,8877,2885,5992
Louisiana,Jefferson Davis Parish,0,31477,15394,16083
Louisiana,Jefferson Davis Parish,1,2252,1227,1025
Louisiana,Jefferson Davis Parish,2,2334,1173,1161
Louisiana,Jefferson Davis Parish,3,2216,1173,1043
Louisiana,Jefferson Davis Parish,4,2074,1092,982
Louisiana,Jefferson Davis Parish,5,1955,968,987
Louisiana,Jefferson Davis Parish,6,1926,938,988
Louisiana,Jefferson Davis Parish,7,1994,995,999
Louisiana,Jefferson Davis Parish,8,1817,901,916
Louisiana,Jefferson Davis Parish,9,1830,838,992
Louisiana,Jefferson Davis Parish,10,1966,944,1022
Louisiana,Jefferson Davis Parish,11,2338,1116,1222
Louisiana,Jefferson Davis Parish,12,2169,1063,1106
Louisiana,Jefferson Davis Parish,13,1817,860,957
Louisiana,Jefferson Davis Parish,14,1480,667,813
Louisiana,Jefferson Davis Parish,15,1166,529,637
Louisiana,Jefferson Davis Parish,16,905,402,503
Louisiana,Jefferson Davis Parish,17,648,275,373
Louisiana,Jefferson Davis Parish,18,590,233,357
Louisiana,Lafayette Parish,0,235644,115251,120393
Louisiana,Lafayette Parish,1,16064,8136,7928
Louisiana,Lafayette Parish,2,15947,8132,7815
Louisiana,Lafayette Parish,3,15140,7671,7469
Louisiana,Lafayette Parish,4,15241,7762,7479
Louisiana,Lafayette Parish,5,18795,9241,9554
Louisiana,Lafayette Parish,6,21028,10630,10398
Louisiana,Lafayette Parish,7,18751,9479,9272
Louisiana,Lafayette Parish,8,15406,7846,7560
Louisiana,Lafayette Parish,9,14223,7026,7197
Louisiana,Lafayette Parish,10,14272,6878,7394
Louisiana,Lafayette Parish,11,16062,7569,8493
Louisiana,Lafayette Parish,12,15662,7482,8180
Louisiana,Lafayette Parish,13,12540,5943,6597
Louisiana,Lafayette Parish,14,9261,4465,4796
Louisiana,Lafayette Parish,15,6120,2752,3368
Louisiana,Lafayette Parish,16,4573,1908,2665
Louisiana,Lafayette Parish,17,3435,1308,2127
Louisiana,Lafayette Parish,18,3124,1023,2101
Louisiana,Lafourche Parish,0,98020,48328,49692
Louisiana,Lafourche Parish,1,6176,3190,2986
Louisiana,Lafourche Parish,2,6713,3411,3302
Louisiana,Lafourche Parish,3,6383,3239,3144
Louisiana,Lafourche Parish,4,6378,3232,3146
Louisiana,Lafourche Parish,5,7059,3458,3601
Louisiana,Lafourche Parish,6,7100,3593,3507
Louisiana,Lafourche Parish,7,6817,3441,3376
Louisiana,Lafourche Parish,8,5864,2981,2883
Louisiana,Lafourche Parish,9,5851,2889,2962
Louisiana,Lafourche Parish,10,6880,3410,3470
Louisiana,Lafourche Parish,11,7331,3601,3730
Louisiana,Lafourche Parish,12,6671,3388,3283
Louisiana,Lafourche Parish,13,5353,2636,2717
Louisiana,Lafourche Parish,14,4469,2105,2364
Louisiana,Lafourche Parish,15,3296,1537,1759
Louisiana,Lafourche Parish,16,2342,1027,1315
Louisiana,Lafourche Parish,17,1763,704,1059
Louisiana,Lafourche Parish,18,1574,486,1088
Louisiana,LaSalle Parish,0,14839,7699,7140
Louisiana,LaSalle Parish,1,870,460,410
Louisiana,LaSalle Parish,2,984,511,473
Louisiana,LaSalle Parish,3,984,503,481
Louisiana,LaSalle Parish,4,899,469,430
Louisiana,LaSalle Parish,5,992,590,402
Louisiana,LaSalle Parish,6,1041,597,444
Louisiana,LaSalle Parish,7,1083,600,483
Louisiana,LaSalle Parish,8,962,551,411
Louisiana,LaSalle Parish,9,903,496,407
Louisiana,LaSalle Parish,10,907,480,427
Louisiana,LaSalle Parish,11,1000,507,493
Louisiana,LaSalle Parish,12,989,490,499
Louisiana,LaSalle Parish,13,868,416,452
Louisiana,LaSalle Parish,14,745,343,402
Louisiana,LaSalle Parish,15,609,274,335
Louisiana,LaSalle Parish,16,432,193,239
Louisiana,LaSalle Parish,17,321,132,189
Louisiana,LaSalle Parish,18,250,87,163
Louisiana,Lincoln Parish,0,47617,23209,24408
Louisiana,Lincoln Parish,1,2860,1445,1415
Louisiana,Lincoln Parish,2,2639,1332,1307
Louisiana,Lincoln Parish,3,2559,1293,1266
Louisiana,Lincoln Parish,4,5021,2536,2485
Louisiana,Lincoln Parish,5,9265,4721,4544
Louisiana,Lincoln Parish,6,3175,1587,1588
Louisiana,Lincoln Parish,7,2841,1419,1422
Louisiana,Lincoln Parish,8,2158,1055,1103
Louisiana,Lincoln Parish,9,2104,981,1123
Louisiana,Lincoln Parish,10,2127,1019,1108
Louisiana,Lincoln Parish,11,2483,1171,1312
Louisiana,Lincoln Parish,12,2363,1141,1222
Louisiana,Lincoln Parish,13,2180,1063,1117
Louisiana,Lincoln Parish,14,1867,867,1000
Louisiana,Lincoln Parish,15,1388,613,775
Louisiana,Lincoln Parish,16,1007,431,576
Louisiana,Lincoln Parish,17,791,300,491
Louisiana,Lincoln Parish,18,789,235,554
Louisiana,Livingston Parish,0,135751,67052,68699
Louisiana,Livingston Parish,1,9194,4662,4532
Louisiana,Livingston Parish,2,10270,5281,4989
Louisiana,Livingston Parish,3,10298,5253,5045
Louisiana,Livingston Parish,4,8920,4659,4261
Louisiana,Livingston Parish,5,8718,4345,4373
Louisiana,Livingston Parish,6,9296,4536,4760
Louisiana,Livingston Parish,7,10241,4934,5307
Louisiana,Livingston Parish,8,9416,4689,4727
Louisiana,Livingston Parish,9,9596,4756,4840
Louisiana,Livingston Parish,10,8996,4523,4473
Louisiana,Livingston Parish,11,9360,4705,4655
Louisiana,Livingston Parish,12,8614,4286,4328
Louisiana,Livingston Parish,13,7044,3321,3723
Louisiana,Livingston Parish,14,5861,2734,3127
Louisiana,Livingston Parish,15,4261,1954,2307
Louisiana,Livingston Parish,16,2718,1237,1481
Louisiana,Livingston Parish,17,1611,689,922
Louisiana,Livingston Parish,18,1337,488,849
Louisiana,Madison Parish,0,11843,5870,5973
Louisiana,Madison Parish,1,913,483,430
Louisiana,Madison Parish,2,790,389,401
Louisiana,Madison Parish,3,791,391,400
Louisiana,Madison Parish,4,686,354,332
Louisiana,Madison Parish,5,923,496,427
Louisiana,Madison Parish,6,990,556,434
Louisiana,Madison Parish,7,925,494,431
Louisiana,Madison Parish,8,706,339,367
Louisiana,Madison Parish,9,690,304,386
Louisiana,Madison Parish,10,763,382,381
Louisiana,Madison Parish,11,738,342,396
Louisiana,Madison Parish,12,763,363,400
Louisiana,Madison Parish,13,638,302,336
Louisiana,Madison Parish,14,526,254,272
Louisiana,Madison Parish,15,373,177,196
Louisiana,Madison Parish,16,233,97,136
Louisiana,Madison Parish,17,200,75,125
Louisiana,Madison Parish,18,195,72,123
Louisiana,Morehouse Parish,0,26760,12893,13867
Louisiana,Morehouse Parish,1,1863,997,866
Louisiana,Morehouse Parish,2,1781,906,875
Louisiana,Morehouse Parish,3,1796,923,873
Louisiana,Morehouse Parish,4,1617,805,812
Louisiana,Morehouse Parish,5,1754,896,858
Louisiana,Morehouse Parish,6,1635,835,800
Louisiana,Morehouse Parish,7,1577,750,827
Louisiana,Morehouse Parish,8,1500,717,783
Louisiana,Morehouse Parish,9,1516,733,783
Louisiana,Morehouse Parish,10,1657,801,856
Louisiana,Morehouse Parish,11,1777,810,967
Louisiana,Morehouse Parish,12,1912,881,1031
Louisiana,Morehouse Parish,13,1863,889,974
Louisiana,Morehouse Parish,14,1456,663,793
Louisiana,Morehouse Parish,15,1006,484,522
Louisiana,Morehouse Parish,16,809,334,475
Louisiana,Morehouse Parish,17,656,248,408
Louisiana,Morehouse Parish,18,585,221,364
Louisiana,Natchitoches Parish,0,39166,18689,20477
Louisiana,Natchitoches Parish,1,2490,1275,1215
Louisiana,Natchitoches Parish,2,2584,1330,1254
Louisiana,Natchitoches Parish,3,2625,1367,1258
Louisiana,Natchitoches Parish,4,3427,1572,1855
Louisiana,Natchitoches Parish,5,4663,2215,2448
Louisiana,Natchitoches Parish,6,2335,1146,1189
Louisiana,Natchitoches Parish,7,2235,1071,1164
Louisiana,Natchitoches Parish,8,1966,928,1038
Louisiana,Natchitoches Parish,9,1954,928,1026
Louisiana,Natchitoches Parish,10,2137,1048,1089
Louisiana,Natchitoches Parish,11,2256,1106,1150
Louisiana,Natchitoches Parish,12,2290,1054,1236
Louisiana,Natchitoches Parish,13,2226,1048,1178
Louisiana,Natchitoches Parish,14,1940,876,1064
Louisiana,Natchitoches Parish,15,1479,683,796
Louisiana,Natchitoches Parish,16,1074,483,591
Louisiana,Natchitoches Parish,17,786,310,476
Louisiana,Natchitoches Parish,18,699,249,450
Louisiana,Orleans Parish,0,384320,183641,200679
Louisiana,Orleans Parish,1,23425,11841,11584
Louisiana,Orleans Parish,2,22878,11534,11344
Louisiana,Orleans Parish,3,20427,10421,10006
Louisiana,Orleans Parish,4,21446,10619,10827
Louisiana,Orleans Parish,5,29663,14185,15478
Louisiana,Orleans Parish,6,38015,17634,20381
Louisiana,Orleans Parish,7,33258,16292,16966
Louisiana,Orleans Parish,8,25370,12223,13147
Louisiana,Orleans Parish,9,23248,11245,12003
Louisiana,Orleans Parish,10,23703,11595,12108
Louisiana,Orleans Parish,11,25941,12441,13500
Louisiana,Orleans Parish,12,26880,12894,13986
Louisiana,Orleans Parish,13,23553,11132,12421
Louisiana,Orleans Parish,14,16933,7874,9059
Louisiana,Orleans Parish,15,10768,4751,6017
Louisiana,Orleans Parish,16,7499,3022,4477
Louisiana,Orleans Parish,17,5278,2001,3277
Louisiana,Orleans Parish,18,6035,1937,4098
Louisiana,Ouachita Parish,0,156325,74869,81456
Louisiana,Ouachita Parish,1,11019,5690,5329
Louisiana,Ouachita Parish,2,11111,5654,5457
Louisiana,Ouachita Parish,3,10996,5557,5439
Louisiana,Ouachita Parish,4,10970,5554,5416
Louisiana,Ouachita Parish,5,12108,5840,6268
Louisiana,Ouachita Parish,6,11564,5491,6073
Louisiana,Ouachita Parish,7,10516,5139,5377
Louisiana,Ouachita Parish,8,9764,4688,5076
Louisiana,Ouachita Parish,9,9287,4448,4839
Louisiana,Ouachita Parish,10,9283,4370,4913
Louisiana,Ouachita Parish,11,10173,4873,5300
Louisiana,Ouachita Parish,12,10054,4829,5225
Louisiana,Ouachita Parish,13,8633,4009,4624
Louisiana,Ouachita Parish,14,6728,3137,3591
Louisiana,Ouachita Parish,15,4983,2158,2825
Louisiana,Ouachita Parish,16,3750,1492,2258
Louisiana,Ouachita Parish,17,2835,1062,1773
Louisiana,Ouachita Parish,18,2551,878,1673
Louisiana,Plaquemines Parish,0,23447,11708,11739
Louisiana,Plaquemines Parish,1,1702,882,820
Louisiana,Plaquemines Parish,2,1768,917,851
Louisiana,Plaquemines Parish,3,1791,921,870
Louisiana,Plaquemines Parish,4,1524,790,734
Louisiana,Plaquemines Parish,5,1585,813,772
Louisiana,Plaquemines Parish,6,1461,729,732
Louisiana,Plaquemines Parish,7,1559,743,816
Louisiana,Plaquemines Parish,8,1526,752,774
Louisiana,Plaquemines Parish,9,1573,777,796
Louisiana,Plaquemines Parish,10,1611,815,796
Louisiana,Plaquemines Parish,11,1711,884,827
Louisiana,Plaquemines Parish,12,1516,778,738
Louisiana,Plaquemines Parish,13,1260,636,624
Louisiana,Plaquemines Parish,14,961,449,512
Louisiana,Plaquemines Parish,15,722,354,368
Louisiana,Plaquemines Parish,16,500,228,272
Louisiana,Plaquemines Parish,17,344,121,223
Louisiana,Plaquemines Parish,18,333,119,214
Louisiana,Pointe Coupee Parish,0,22406,10760,11646
Louisiana,Pointe Coupee Parish,1,1389,704,685
Louisiana,Pointe Coupee Parish,2,1350,664,686
Louisiana,Pointe Coupee Parish,3,1502,768,734
Louisiana,Pointe Coupee Parish,4,1392,693,699
Louisiana,Pointe Coupee Parish,5,1303,670,633
Louisiana,Pointe Coupee Parish,6,1244,596,648
Louisiana,Pointe Coupee Parish,7,1334,691,643
Louisiana,Pointe Coupee Parish,8,1178,540,638
Louisiana,Pointe Coupee Parish,9,1195,562,633
Louisiana,Pointe Coupee Parish,10,1379,671,708
Louisiana,Pointe Coupee Parish,11,1733,808,925
Louisiana,Pointe Coupee Parish,12,1759,841,918
Louisiana,Pointe Coupee Parish,13,1579,752,827
Louisiana,Pointe Coupee Parish,14,1389,623,766
Louisiana,Pointe Coupee Parish,15,969,462,507
Louisiana,Pointe Coupee Parish,16,678,304,374
Louisiana,Pointe Coupee Parish,17,560,225,335
Louisiana,Pointe Coupee Parish,18,473,186,287
Louisiana,Rapides Parish,0,132488,63994,68494
Louisiana,Rapides Parish,1,8957,4575,4382
Louisiana,Rapides Parish,2,9263,4769,4494
Louisiana,Rapides Parish,3,9436,4776,4660
Louisiana,Rapides Parish,4,9033,4608,4425
Louisiana,Rapides Parish,5,8799,4511,4288
Louisiana,Rapides Parish,6,8452,4154,4298
Louisiana,Rapides Parish,7,8848,4268,4580
Louisiana,Rapides Parish,8,7909,3811,4098
Louisiana,Rapides Parish,9,7771,3784,3987
Louisiana,Rapides Parish,10,8231,3933,4298
Louisiana,Rapides Parish,11,9410,4488,4922
Louisiana,Rapides Parish,12,8917,4257,4660
Louisiana,Rapides Parish,13,7704,3606,4098
Louisiana,Rapides Parish,14,6409,2984,3425
Louisiana,Rapides Parish,15,4848,2133,2715
Louisiana,Rapides Parish,16,3617,1545,2072
Louisiana,Rapides Parish,17,2506,1042,1464
Louisiana,Rapides Parish,18,2378,750,1628
Louisiana,Red River Parish,0,8669,4197,4472
Louisiana,Red River Parish,1,608,325,283
Louisiana,Red River Parish,2,623,324,299
Louisiana,Red River Parish,3,571,289,282
Louisiana,Red River Parish,4,531,263,268
Louisiana,Red River Parish,5,541,284,257
Louisiana,Red River Parish,6,515,274,241
Louisiana,Red River Parish,7,502,244,258
Louisiana,Red River Parish,8,457,221,236
Louisiana,Red River Parish,9,497,249,248
Louisiana,Red River Parish,10,565,269,296
Louisiana,Red River Parish,11,645,311,334
Louisiana,Red River Parish,12,654,298,356
Louisiana,Red River Parish,13,524,251,273
Louisiana,Red River Parish,14,454,209,245
Louisiana,Red River Parish,15,400,172,228
Louisiana,Red River Parish,16,266,120,146
Louisiana,Red River Parish,17,171,58,113
Louisiana,Red River Parish,18,145,36,109
Louisiana,Richland Parish,0,20740,10016,10724
Louisiana,Richland Parish,1,1472,758,714
Louisiana,Richland Parish,2,1426,733,693
Louisiana,Richland Parish,3,1437,723,714
Louisiana,Richland Parish,4,1319,677,642
Louisiana,Richland Parish,5,1348,696,652
Louisiana,Richland Parish,6,1324,658,666
Louisiana,Richland Parish,7,1333,620,713
Louisiana,Richland Parish,8,1317,632,685
Louisiana,Richland Parish,9,1183,541,642
Louisiana,Richland Parish,10,1222,591,631
Louisiana,Richland Parish,11,1452,696,756
Louisiana,Richland Parish,12,1495,709,786
Louisiana,Richland Parish,13,1271,609,662
Louisiana,Richland Parish,14,1024,486,538
Louisiana,Richland Parish,15,787,367,420
Louisiana,Richland Parish,16,565,253,312
Louisiana,Richland Parish,17,393,143,250
Louisiana,Richland Parish,18,372,124,248
Louisiana,Sabine Parish,0,24199,11980,12219
Louisiana,Sabine Parish,1,1652,808,844
Louisiana,Sabine Parish,2,1640,828,812
Louisiana,Sabine Parish,3,1643,889,754
Louisiana,Sabine Parish,4,1465,742,723
Louisiana,Sabine Parish,5,1407,719,688
Louisiana,Sabine Parish,6,1393,699,694
Louisiana,Sabine Parish,7,1412,692,720
Louisiana,Sabine Parish,8,1272,613,659
Louisiana,Sabine Parish,9,1321,605,716
Louisiana,Sabine Parish,10,1534,811,723
Louisiana,Sabine Parish,11,1697,841,856
Louisiana,Sabine Parish,12,1580,764,816
Louisiana,Sabine Parish,13,1695,832,863
Louisiana,Sabine Parish,14,1488,746,742
Louisiana,Sabine Parish,15,1201,582,619
Louisiana,Sabine Parish,16,816,428,388
Louisiana,Sabine Parish,17,523,227,296
Louisiana,Sabine Parish,18,460,154,306
Louisiana,Tangipahoa Parish,0,127049,61626,65423
Louisiana,Tangipahoa Parish,1,9166,4669,4497
Louisiana,Tangipahoa Parish,2,8866,4541,4325
Louisiana,Tangipahoa Parish,3,8401,4334,4067
Louisiana,Tangipahoa Parish,4,9253,4650,4603
Louisiana,Tangipahoa Parish,5,10166,4843,5323
Louisiana,Tangipahoa Parish,6,9590,4701,4889
Louisiana,Tangipahoa Parish,7,8762,4233,4529
Louisiana,Tangipahoa Parish,8,7825,3901,3924
Louisiana,Tangipahoa Parish,9,7207,3492,3715
Louisiana,Tangipahoa Parish,10,7571,3643,3928
Louisiana,Tangipahoa Parish,11,8192,3898,4294
Louisiana,Tangipahoa Parish,12,8426,4017,4409
Louisiana,Tangipahoa Parish,13,7325,3455,3870
Louisiana,Tangipahoa Parish,14,6066,2925,3141
Louisiana,Tangipahoa Parish,15,4064,1899,2165
Louisiana,Tangipahoa Parish,16,2754,1209,1545
Louisiana,Tangipahoa Parish,17,1850,708,1142
Louisiana,Tangipahoa Parish,18,1565,508,1057
Louisiana,Tensas Parish,0,4830,2344,2486
Louisiana,Tensas Parish,1,285,148,137
Louisiana,Tensas Parish,2,342,187,155
Louisiana,Tensas Parish,3,397,219,178
Louisiana,Tensas Parish,4,300,150,150
Louisiana,Tensas Parish,5,256,140,116
Louisiana,Tensas Parish,6,227,100,127
Louisiana,Tensas Parish,7,227,108,119
Louisiana,Tensas Parish,8,229,112,117
Louisiana,Tensas Parish,9,233,119,114
Louisiana,Tensas Parish,10,257,120,137
Louisiana,Tensas Parish,11,346,156,190
Louisiana,Tensas Parish,12,385,193,192
Louisiana,Tensas Parish,13,399,180,219
Louisiana,Tensas Parish,14,334,163,171
Louisiana,Tensas Parish,15,243,115,128
Louisiana,Tensas Parish,16,147,55,92
Louisiana,Tensas Parish,17,112,45,67
Louisiana,Tensas Parish,18,111,34,77
Louisiana,Terrebonne Parish,0,113328,56029,57299
Louisiana,Terrebonne Parish,1,7881,4000,3881
Louisiana,Terrebonne Parish,2,8301,4234,4067
Louisiana,Terrebonne Parish,3,8001,4024,3977
Louisiana,Terrebonne Parish,4,7334,3835,3499
Louisiana,Terrebonne Parish,5,8003,3922,4081
Louisiana,Terrebonne Parish,6,8309,4188,4121
Louisiana,Terrebonne Parish,7,8207,4091,4116
Louisiana,Terrebonne Parish,8,6813,3433,3380
Louisiana,Terrebonne Parish,9,6642,3286,3356
Louisiana,Terrebonne Parish,10,7619,3752,3867
Louisiana,Terrebonne Parish,11,8292,4104,4188
Louisiana,Terrebonne Parish,12,7501,3775,3726
Louisiana,Terrebonne Parish,13,6133,2968,3165
Louisiana,Terrebonne Parish,14,4919,2367,2552
Louisiana,Terrebonne Parish,15,3664,1664,2000
Louisiana,Terrebonne Parish,16,2562,1118,1444
Louisiana,Terrebonne Parish,17,1651,717,934
Louisiana,Terrebonne Parish,18,1496,551,945
Louisiana,Union Parish,0,22539,11136,11403
Louisiana,Union Parish,1,1389,682,707
Louisiana,Union Parish,2,1415,706,709
Louisiana,Union Parish,3,1468,777,691
Louisiana,Union Parish,4,1257,641,616
Louisiana,Union Parish,5,1353,678,675
Louisiana,Union Parish,6,1344,705,639
Louisiana,Union Parish,7,1338,661,677
Louisiana,Union Parish,8,1177,613,564
Louisiana,Union Parish,9,1276,638,638
Louisiana,Union Parish,10,1350,667,683
Louisiana,Union Parish,11,1669,781,888
Louisiana,Union Parish,12,1797,864,933
Louisiana,Union Parish,13,1563,794,769
Louisiana,Union Parish,14,1386,686,700
Louisiana,Union Parish,15,1042,516,526
Louisiana,Union Parish,16,748,322,426
Louisiana,Union Parish,17,531,247,284
Louisiana,Union Parish,18,436,158,278
Louisiana,Vermilion Parish,0,59616,28977,30639
Louisiana,Vermilion Parish,1,4116,2104,2012
Louisiana,Vermilion Parish,2,4436,2275,2161
Louisiana,Vermilion Parish,3,4620,2397,2223
Louisiana,Vermilion Parish,4,3854,1933,1921
Louisiana,Vermilion Parish,5,3742,1835,1907
Louisiana,Vermilion Parish,6,3768,1784,1984
Louisiana,Vermilion Parish,7,4028,1940,2088
Louisiana,Vermilion Parish,8,3618,1746,1872
Louisiana,Vermilion Parish,9,3561,1733,1828
Louisiana,Vermilion Parish,10,3759,1855,1904
Louisiana,Vermilion Parish,11,4344,2088,2256
Louisiana,Vermilion Parish,12,4140,2023,2117
Louisiana,Vermilion Parish,13,3334,1599,1735
Louisiana,Vermilion Parish,14,2614,1238,1376
Louisiana,Vermilion Parish,15,2015,956,1059
Louisiana,Vermilion Parish,16,1504,638,866
Louisiana,Vermilion Parish,17,1125,475,650
Louisiana,Vermilion Parish,18,1038,358,680
Louisiana,Vernon Parish,0,52132,27534,24598
Louisiana,Vernon Parish,1,4663,2450,2213
Louisiana,Vernon Parish,2,3862,1953,1909
Louisiana,Vernon Parish,3,3393,1762,1631
Louisiana,Vernon Parish,4,3263,1801,1462
Louisiana,Vernon Parish,5,5816,3657,2159
Louisiana,Vernon Parish,6,4850,2697,2153
Louisiana,Vernon Parish,7,4370,2329,2041
Louisiana,Vernon Parish,8,3513,1915,1598
Louisiana,Vernon Parish,9,3096,1645,1451
Louisiana,Vernon Parish,10,2569,1349,1220
Louisiana,Vernon Parish,11,2614,1291,1323
Louisiana,Vernon Parish,12,2464,1215,1249
Louisiana,Vernon Parish,13,2183,1002,1181
Louisiana,Vernon Parish,14,1881,870,1011
Louisiana,Vernon Parish,15,1420,661,759
Louisiana,Vernon Parish,16,991,444,547
Louisiana,Vernon Parish,17,640,281,359
Louisiana,Vernon Parish,18,544,212,332
Louisiana,Washington Parish,0,46286,22864,23422
Louisiana,Washington Parish,1,2895,1469,1426
Louisiana,Washington Parish,2,3079,1616,1463
Louisiana,Washington Parish,3,3241,1656,1585
Louisiana,Washington Parish,4,2993,1531,1462
Louisiana,Washington Parish,5,2819,1424,1395
Louisiana,Washington Parish,6,2697,1338,1359
Louisiana,Washington Parish,7,2882,1477,1405
Louisiana,Washington Parish,8,2710,1355,1355
Louisiana,Washington Parish,9,2743,1419,1324
Louisiana,Washington Parish,10,2831,1466,1365
Louisiana,Washington Parish,11,3323,1655,1668
Louisiana,Washington Parish,12,3462,1654,1808
Louisiana,Washington Parish,13,3045,1479,1566
Louisiana,Washington Parish,14,2655,1282,1373
Louisiana,Washington Parish,15,1859,850,1009
Louisiana,Washington Parish,16,1362,563,799
Louisiana,Washington Parish,17,909,356,553
Louisiana,Washington Parish,18,781,274,507
Louisiana,Webster Parish,0,40333,19696,20637
Louisiana,Webster Parish,1,2502,1335,1167
Louisiana,Webster Parish,2,2603,1298,1305
Louisiana,Webster Parish,3,2615,1364,1251
Louisiana,Webster Parish,4,2542,1317,1225
Louisiana,Webster Parish,5,2457,1233,1224
Louisiana,Webster Parish,6,2538,1307,1231
Louisiana,Webster Parish,7,2425,1208,1217
Louisiana,Webster Parish,8,2265,1110,1155
Louisiana,Webster Parish,9,2323,1148,1175
Louisiana,Webster Parish,10,2480,1250,1230
Louisiana,Webster Parish,11,2936,1427,1509
Louisiana,Webster Parish,12,2806,1381,1425
Louisiana,Webster Parish,13,2543,1199,1344
Louisiana,Webster Parish,14,2225,1057,1168
Louisiana,Webster Parish,15,1792,803,989
Louisiana,Webster Parish,16,1415,613,802
Louisiana,Webster Parish,17,977,349,628
Louisiana,Webster Parish,18,889,297,592
Louisiana,West Baton Rouge Parish,0,25085,12278,12807
Louisiana,West Baton Rouge Parish,1,1675,796,879
Louisiana,West Baton Rouge Parish,2,1735,874,861
Louisiana,West Baton Rouge Parish,3,1649,830,819
Louisiana,West Baton Rouge Parish,4,1522,776,746
Louisiana,West Baton Rouge Parish,5,1750,894,856
Louisiana,West Baton Rouge Parish,6,2001,1012,989
Louisiana,West Baton Rouge Parish,7,1991,1020,971
Louisiana,West Baton Rouge Parish,8,1514,753,761
Louisiana,West Baton Rouge Parish,9,1439,725,714
Louisiana,West Baton Rouge Parish,10,1736,808,928
Louisiana,West Baton Rouge Parish,11,1826,910,916
Louisiana,West Baton Rouge Parish,12,1822,862,960
Louisiana,West Baton Rouge Parish,13,1408,703,705
Louisiana,West Baton Rouge Parish,14,1035,497,538
Louisiana,West Baton Rouge Parish,15,737,327,410
Louisiana,West Baton Rouge Parish,16,564,244,320
Louisiana,West Baton Rouge Parish,17,353,131,222
Louisiana,West Baton Rouge Parish,18,328,116,212
Louisiana,West Carroll Parish,0,11525,5786,5739
Louisiana,West Carroll Parish,1,666,352,314
Louisiana,West Carroll Parish,2,840,432,408
Louisiana,West Carroll Parish,3,800,418,382
Louisiana,West Carroll Parish,4,762,398,364
Louisiana,West Carroll Parish,5,718,408,310
Louisiana,West Carroll Parish,6,648,359,289
Louisiana,West Carroll Parish,7,681,360,321
Louisiana,West Carroll Parish,8,702,359,343
Louisiana,West Carroll Parish,9,705,360,345
Louisiana,West Carroll Parish,10,697,350,347
Louisiana,West Carroll Parish,11,838,417,421
Louisiana,West Carroll Parish,12,753,382,371
Louisiana,West Carroll Parish,13,691,335,356
Louisiana,West Carroll Parish,14,597,279,318
Louisiana,West Carroll Parish,15,535,235,300
Louisiana,West Carroll Parish,16,412,170,242
Louisiana,West Carroll Parish,17,269,105,164
Louisiana,West Carroll Parish,18,211,67,144
Louisiana,West Feliciana Parish,0,15406,10160,5246
Louisiana,West Feliciana Parish,1,643,325,318
Louisiana,West Feliciana Parish,2,674,372,302
Louisiana,West Feliciana Parish,3,757,381,376
Louisiana,West Feliciana Parish,4,719,389,330
Louisiana,West Feliciana Parish,5,698,406,292
Louisiana,West Feliciana Parish,6,854,606,248
Louisiana,West Feliciana Parish,7,1307,992,315
Louisiana,West Feliciana Parish,8,1385,1083,302
Louisiana,West Feliciana Parish,9,1395,1072,323
Louisiana,West Feliciana Parish,10,1427,1077,350
Louisiana,West Feliciana Parish,11,1379,982,397
Louisiana,West Feliciana Parish,12,1247,829,418
Louisiana,West Feliciana Parish,13,973,612,361
Louisiana,West Feliciana Parish,14,768,458,310
Louisiana,West Feliciana Parish,15,481,262,219
Louisiana,West Feliciana Parish,16,291,140,151
Louisiana,West Feliciana Parish,17,190,86,104
Louisiana,West Feliciana Parish,18,218,88,130
Louisiana,Winn Parish,0,14743,7860,6883
Louisiana,Winn Parish,1,804,437,367
Louisiana,Winn Parish,2,913,456,457
Louisiana,Winn Parish,3,915,449,466
Louisiana,Winn Parish,4,874,444,430
Louisiana,Winn Parish,5,928,509,419
Louisiana,Winn Parish,6,1013,658,355
Louisiana,Winn Parish,7,942,578,364
Louisiana,Winn Parish,8,913,515,398
Louisiana,Winn Parish,9,977,570,407
Louisiana,Winn Parish,10,1030,603,427
Louisiana,Winn Parish,11,1064,575,489
Louisiana,Winn Parish,12,1057,577,480
Louisiana,Winn Parish,13,925,440,485
Louisiana,Winn Parish,14,830,405,425
Louisiana,Winn Parish,15,608,280,328
Louisiana,Winn Parish,16,414,193,221
Louisiana,Winn Parish,17,260,89,171
Louisiana,Winn Parish,18,276,82,194
Maine,Androscoggin County,0,107440,52783,54657
Maine,Androscoggin County,1,6553,3340,3213
Maine,Androscoggin County,2,6683,3442,3241
Maine,Androscoggin County,3,6458,3301,3157
Maine,Androscoggin County,4,6787,3553,3234
Maine,Androscoggin County,5,6694,3415,3279
Maine,Androscoggin County,6,6619,3198,3421
Maine,Androscoggin County,7,6543,3134,3409
Maine,Androscoggin County,8,6240,3084,3156
Maine,Androscoggin County,9,6861,3404,3457
Maine,Androscoggin County,10,7558,3731,3827
Maine,Androscoggin County,11,8377,4178,4199
Maine,Androscoggin County,12,8030,3959,4071
Maine,Androscoggin County,13,6859,3380,3479
Maine,Androscoggin County,14,5797,2800,2997
Maine,Androscoggin County,15,3918,1828,2090
Maine,Androscoggin County,16,2914,1340,1574
Maine,Androscoggin County,17,2312,931,1381
Maine,Androscoggin County,18,2237,765,1472
Maine,Aroostook County,0,69447,34256,35191
Maine,Aroostook County,1,3288,1675,1613
Maine,Aroostook County,2,3477,1779,1698
Maine,Aroostook County,3,3665,1891,1774
Maine,Aroostook County,4,4237,2155,2082
Maine,Aroostook County,5,3891,2045,1846
Maine,Aroostook County,6,3458,1737,1721
Maine,Aroostook County,7,3363,1683,1680
Maine,Aroostook County,8,3516,1774,1742
Maine,Aroostook County,9,4038,1965,2073
Maine,Aroostook County,10,4753,2370,2383
Maine,Aroostook County,11,5564,2792,2772
Maine,Aroostook County,12,5865,2966,2899
Maine,Aroostook County,13,5542,2730,2812
Maine,Aroostook County,14,4773,2398,2375
Maine,Aroostook County,15,3437,1667,1770
Maine,Aroostook County,16,2678,1189,1489
Maine,Aroostook County,17,2009,841,1168
Maine,Aroostook County,18,1893,599,1294
Maine,Cumberland County,0,287797,139789,148008
Maine,Cumberland County,1,14129,7319,6810
Maine,Cumberland County,2,15375,7816,7559
Maine,Cumberland County,3,16512,8487,8025
Maine,Cumberland County,4,18159,9313,8846
Maine,Cumberland County,5,18113,9039,9074
Maine,Cumberland County,6,19042,9477,9565
Maine,Cumberland County,7,17882,8969,8913
Maine,Cumberland County,8,16809,8399,8410
Maine,Cumberland County,9,19009,9324,9685
Maine,Cumberland County,10,20662,10081,10581
Maine,Cumberland County,11,23096,11193,11903
Maine,Cumberland County,12,22169,10661,11508
Maine,Cumberland County,13,19578,9227,10351
Maine,Cumberland County,14,15823,7620,8203
Maine,Cumberland County,15,10937,4983,5954
Maine,Cumberland County,16,7634,3329,4305
Maine,Cumberland County,17,5865,2323,3542
Maine,Cumberland County,18,7003,2229,4774
Maine,Franklin County,0,30296,14855,15441
Maine,Franklin County,1,1380,725,655
Maine,Franklin County,2,1577,799,778
Maine,Franklin County,3,1603,820,783
Maine,Franklin County,4,2156,1042,1114
Maine,Franklin County,5,2092,959,1133
Maine,Franklin County,6,1657,875,782
Maine,Franklin County,7,1488,726,762
Maine,Franklin County,8,1501,701,800
Maine,Franklin County,9,1638,807,831
Maine,Franklin County,10,1918,904,1014
Maine,Franklin County,11,2534,1266,1268
Maine,Franklin County,12,2580,1274,1306
Maine,Franklin County,13,2356,1158,1198
Maine,Franklin County,14,1935,977,958
Maine,Franklin County,15,1507,751,756
Maine,Franklin County,16,1008,487,521
Maine,Franklin County,17,724,354,370
Maine,Franklin County,18,642,230,412
Maine,Hancock County,0,54696,26718,27978
Maine,Hancock County,1,2346,1223,1123
Maine,Hancock County,2,2659,1321,1338
Maine,Hancock County,3,2782,1434,1348
Maine,Hancock County,4,2934,1556,1378
Maine,Hancock County,5,2998,1648,1350
Maine,Hancock County,6,2926,1446,1480
Maine,Hancock County,7,2756,1365,1391
Maine,Hancock County,8,2700,1311,1389
Maine,Hancock County,9,3291,1601,1690
Maine,Hancock County,10,3562,1726,1836
Maine,Hancock County,11,4500,2145,2355
Maine,Hancock County,12,4763,2319,2444
Maine,Hancock County,13,4715,2250,2465
Maine,Hancock County,14,4212,2053,2159
Maine,Hancock County,15,2853,1362,1491
Maine,Hancock County,16,1897,900,997
Maine,Hancock County,17,1374,601,773
Maine,Hancock County,18,1428,457,971
Maine,Kennebec County,0,121112,58969,62143
Maine,Kennebec County,1,6045,3087,2958
Maine,Kennebec County,2,6524,3315,3209
Maine,Kennebec County,3,7024,3524,3500
Maine,Kennebec County,4,7417,3778,3639
Maine,Kennebec County,5,7378,3727,3651
Maine,Kennebec County,6,6740,3351,3389
Maine,Kennebec County,7,6795,3327,3468
Maine,Kennebec County,8,6660,3267,3393
Maine,Kennebec County,9,7562,3713,3849
Maine,Kennebec County,10,8603,4164,4439
Maine,Kennebec County,11,10001,4810,5191
Maine,Kennebec County,12,10044,4879,5165
Maine,Kennebec County,13,8919,4342,4577
Maine,Kennebec County,14,7229,3572,3657
Maine,Kennebec County,15,5034,2349,2685
Maine,Kennebec County,16,3583,1619,1964
Maine,Kennebec County,17,2757,1176,1581
Maine,Kennebec County,18,2797,969,1828
Maine,Knox County,0,39676,19601,20075
Maine,Knox County,1,1777,886,891
Maine,Knox County,2,2014,1051,963
Maine,Knox County,3,2124,1116,1008
Maine,Knox County,4,2070,1047,1023
Maine,Knox County,5,1935,1048,887
Maine,Knox County,6,1979,1053,926
Maine,Knox County,7,2085,1076,1009
Maine,Knox County,8,2089,1073,1016
Maine,Knox County,9,2388,1227,1161
Maine,Knox County,10,2556,1312,1244
Maine,Knox County,11,3041,1468,1573
Maine,Knox County,12,3414,1614,1800
Maine,Knox County,13,3330,1587,1743
Maine,Knox County,14,3002,1470,1532
Maine,Knox County,15,2046,980,1066
Maine,Knox County,16,1477,656,821
Maine,Knox County,17,1027,425,602
Maine,Knox County,18,1322,512,810
Maine,Lincoln County,0,34170,16727,17443
Maine,Lincoln County,1,1389,722,667
Maine,Lincoln County,2,1673,855,818
Maine,Lincoln County,3,1731,945,786
Maine,Lincoln County,4,1845,981,864
Maine,Lincoln County,5,1562,816,746
Maine,Lincoln County,6,1538,775,763
Maine,Lincoln County,7,1545,738,807
Maine,Lincoln County,8,1635,801,834
Maine,Lincoln County,9,1967,970,997
Maine,Lincoln County,10,2134,1059,1075
Maine,Lincoln County,11,2665,1301,1364
Maine,Lincoln County,12,2890,1371,1519
Maine,Lincoln County,13,2964,1379,1585
Maine,Lincoln County,14,2955,1429,1526
Maine,Lincoln County,15,2157,1032,1125
Maine,Lincoln County,16,1373,662,711
Maine,Lincoln County,17,1059,500,559
Maine,Lincoln County,18,1088,391,697
Maine,Oxford County,0,57238,28405,28833
Maine,Oxford County,1,2597,1318,1279
Maine,Oxford County,2,3028,1565,1463
Maine,Oxford County,3,3222,1679,1543
Maine,Oxford County,4,3602,1907,1695
Maine,Oxford County,5,2763,1468,1295
Maine,Oxford County,6,2767,1359,1408
Maine,Oxford County,7,3081,1499,1582
Maine,Oxford County,8,3013,1522,1491
Maine,Oxford County,9,3427,1640,1787
Maine,Oxford County,10,3996,1941,2055
Maine,Oxford County,11,5058,2550,2508
Maine,Oxford County,12,5000,2411,2589
Maine,Oxford County,13,4609,2324,2285
Maine,Oxford County,14,3680,1876,1804
Maine,Oxford County,15,2755,1343,1412
Maine,Oxford County,16,1949,898,1051
Maine,Oxford County,17,1399,642,757
Maine,Oxford County,18,1292,463,829
Maine,Penobscot County,0,153414,75756,77658
Maine,Penobscot County,1,7329,3760,3569
Maine,Penobscot County,2,8023,4179,3844
Maine,Penobscot County,3,8168,4180,3988
Maine,Penobscot County,4,10596,5589,5007
Maine,Penobscot County,5,11888,6174,5714
Maine,Penobscot County,6,11049,5700,5349
Maine,Penobscot County,7,8974,4492,4482
Maine,Penobscot County,8,8157,3995,4162
Maine,Penobscot County,9,9152,4492,4660
Maine,Penobscot County,10,10258,4978,5280
Maine,Penobscot County,11,12075,5896,6179
Maine,Penobscot County,12,11861,5788,6073
Maine,Penobscot County,13,10500,5154,5346
Maine,Penobscot County,14,8295,4005,4290
Maine,Penobscot County,15,5907,2815,3092
Maine,Penobscot County,16,4359,1944,2415
Maine,Penobscot County,17,3388,1414,1974
Maine,Penobscot County,18,3435,1201,2234
Maine,Piscataquis County,0,17026,8479,8547
Maine,Piscataquis County,1,717,351,366
Maine,Piscataquis County,2,785,401,384
Maine,Piscataquis County,3,899,459,440
Maine,Piscataquis County,4,960,506,454
Maine,Piscataquis County,5,712,378,334
Maine,Piscataquis County,6,685,332,353
Maine,Piscataquis County,7,740,362,378
Maine,Piscataquis County,8,839,394,445
Maine,Piscataquis County,9,973,486,487
Maine,Piscataquis County,10,1156,565,591
Maine,Piscataquis County,11,1444,711,733
Maine,Piscataquis County,12,1566,771,795
Maine,Piscataquis County,13,1534,768,766
Maine,Piscataquis County,14,1425,751,674
Maine,Piscataquis County,15,1013,546,467
Maine,Piscataquis County,16,642,297,345
Maine,Piscataquis County,17,464,210,254
Maine,Piscataquis County,18,472,191,281
Maine,Sagadahoc County,0,35045,16993,18052
Maine,Sagadahoc County,1,1631,802,829
Maine,Sagadahoc County,2,1912,999,913
Maine,Sagadahoc County,3,2047,1056,991
Maine,Sagadahoc County,4,1886,979,907
Maine,Sagadahoc County,5,1688,865,823
Maine,Sagadahoc County,6,1861,906,955
Maine,Sagadahoc County,7,1953,956,997
Maine,Sagadahoc County,8,1886,890,996
Maine,Sagadahoc County,9,2219,1059,1160
Maine,Sagadahoc County,10,2468,1203,1265
Maine,Sagadahoc County,11,2956,1422,1534
Maine,Sagadahoc County,12,2964,1412,1552
Maine,Sagadahoc County,13,2729,1306,1423
Maine,Sagadahoc County,14,2255,1085,1170
Maine,Sagadahoc County,15,1758,855,903
Maine,Sagadahoc County,16,1154,550,604
Maine,Sagadahoc County,17,830,346,484
Maine,Sagadahoc County,18,848,302,546
Maine,Somerset County,0,51163,25385,25778
Maine,Somerset County,1,2387,1202,1185
Maine,Somerset County,2,2778,1449,1329
Maine,Somerset County,3,2970,1457,1513
Maine,Somerset County,4,3097,1629,1468
Maine,Somerset County,5,2510,1328,1182
Maine,Somerset County,6,2641,1309,1332
Maine,Somerset County,7,2640,1293,1347
Maine,Somerset County,8,2859,1362,1497
Maine,Somerset County,9,3282,1662,1620
Maine,Somerset County,10,3851,1909,1942
Maine,Somerset County,11,4253,2127,2126
Maine,Somerset County,12,4388,2183,2205
Maine,Somerset County,13,3853,1900,1953
Maine,Somerset County,14,3421,1734,1687
Maine,Somerset County,15,2429,1199,1230
Maine,Somerset County,16,1641,761,880
Maine,Somerset County,17,1139,512,627
Maine,Somerset County,18,1024,369,655
Maine,Waldo County,0,39051,19128,19923
Maine,Waldo County,1,1959,992,967
Maine,Waldo County,2,2078,1044,1034
Maine,Waldo County,3,2206,1160,1046
Maine,Waldo County,4,2316,1215,1101
Maine,Waldo County,5,2001,1016,985
Maine,Waldo County,6,1956,990,966
Maine,Waldo County,7,2075,990,1085
Maine,Waldo County,8,2215,1103,1112
Maine,Waldo County,9,2418,1194,1224
Maine,Waldo County,10,2576,1289,1287
Maine,Waldo County,11,2991,1392,1599
Maine,Waldo County,12,3332,1559,1773
Maine,Waldo County,13,3247,1578,1669
Maine,Waldo County,14,2896,1411,1485
Maine,Waldo County,15,1926,948,978
Maine,Waldo County,16,1264,585,679
Maine,Waldo County,17,823,377,446
Maine,Waldo County,18,772,285,487
Maine,Washington County,0,31808,15689,16119
Maine,Washington County,1,1551,801,750
Maine,Washington County,2,1710,865,845
Maine,Washington County,3,1712,867,845
Maine,Washington County,4,1792,919,873
Maine,Washington County,5,1679,887,792
Maine,Washington County,6,1495,760,735
Maine,Washington County,7,1572,774,798
Maine,Washington County,8,1574,773,801
Maine,Washington County,9,1805,934,871
Maine,Washington County,10,2054,999,1055
Maine,Washington County,11,2508,1262,1246
Maine,Washington County,12,2764,1359,1405
Maine,Washington County,13,2590,1273,1317
Maine,Washington County,14,2367,1170,1197
Maine,Washington County,15,1739,839,900
Maine,Washington County,16,1202,558,644
Maine,Washington County,17,910,365,545
Maine,Washington County,18,784,284,500
Maine,York County,0,200710,97738,102972
Maine,York County,1,9701,5023,4678
Maine,York County,2,10885,5581,5304
Maine,York County,3,11821,6093,5728
Maine,York County,4,12002,5976,6026
Maine,York County,5,10935,5469,5466
Maine,York County,6,11477,5793,5684
Maine,York County,7,11277,5580,5697
Maine,York County,8,10910,5317,5593
Maine,York County,9,12806,6265,6541
Maine,York County,10,14313,7082,7231
Maine,York County,11,17029,8372,8657
Maine,York County,12,16545,7965,8580
Maine,York County,13,14875,7057,7818
Maine,York County,14,12291,5920,6371
Maine,York County,15,8604,3998,4606
Maine,York County,16,6061,2760,3301
Maine,York County,17,4494,1872,2622
Maine,York County,18,4684,1615,3069
Maryland,Allegany County,0,72952,38093,34859
Maryland,Allegany County,1,3473,1814,1659
Maryland,Allegany County,2,3409,1800,1609
Maryland,Allegany County,3,3675,1936,1739
Maryland,Allegany County,4,4929,2496,2433
Maryland,Allegany County,5,6671,3574,3097
Maryland,Allegany County,6,4639,2861,1778
Maryland,Allegany County,7,4557,2764,1793
Maryland,Allegany County,8,4099,2405,1694
Maryland,Allegany County,9,4423,2457,1966
Maryland,Allegany County,10,4594,2541,2053
Maryland,Allegany County,11,5061,2636,2425
Maryland,Allegany County,12,4947,2512,2435
Maryland,Allegany County,13,4484,2195,2289
Maryland,Allegany County,14,4217,1984,2233
Maryland,Allegany County,15,3316,1524,1792
Maryland,Allegany County,16,2646,1191,1455
Maryland,Allegany County,17,1868,730,1138
Maryland,Allegany County,18,1944,673,1271
Maryland,Anne Arundel County,0,560133,277317,282816
Maryland,Anne Arundel County,1,35451,18272,17179
Maryland,Anne Arundel County,2,35281,17966,17315
Maryland,Anne Arundel County,3,35154,17747,17407
Maryland,Anne Arundel County,4,33980,17911,16069
Maryland,Anne Arundel County,5,37619,20514,17105
Maryland,Anne Arundel County,6,39353,20124,19229
Maryland,Anne Arundel County,7,39806,20039,19767
Maryland,Anne Arundel County,8,36160,18057,18103
Maryland,Anne Arundel County,9,37122,18289,18833
Maryland,Anne Arundel County,10,40299,19618,20681
Maryland,Anne Arundel County,11,43724,21246,22478
Maryland,Anne Arundel County,12,39063,19012,20051
Maryland,Anne Arundel County,13,31871,15195,16676
Maryland,Anne Arundel County,14,26797,12579,14218
Maryland,Anne Arundel County,15,18916,8843,10073
Maryland,Anne Arundel County,16,12241,5447,6794
Maryland,Anne Arundel County,17,8575,3520,5055
Maryland,Anne Arundel County,18,8721,2938,5783
Maryland,Baltimore County,0,826925,391363,435562
Maryland,Baltimore County,1,49924,24960,24964
Maryland,Baltimore County,2,49504,25143,24361
Maryland,Baltimore County,3,49115,25116,23999
Maryland,Baltimore County,4,52798,26354,26444
Maryland,Baltimore County,5,55224,27324,27900
Maryland,Baltimore County,6,59402,28732,30670
Maryland,Baltimore County,7,55636,26583,29053
Maryland,Baltimore County,8,49874,23731,26143
Maryland,Baltimore County,9,51157,24141,27016
Maryland,Baltimore County,10,53849,25474,28375
Maryland,Baltimore County,11,59819,28208,31611
Maryland,Baltimore County,12,59439,27818,31621
Maryland,Baltimore County,13,50401,23238,27163
Maryland,Baltimore County,14,41338,18857,22481
Maryland,Baltimore County,15,28388,12491,15897
Maryland,Baltimore County,16,21157,8882,12275
Maryland,Baltimore County,17,17490,6840,10650
Maryland,Baltimore County,18,22410,7471,14939
Maryland,Calvert County,0,90613,44750,45863
Maryland,Calvert County,1,4965,2540,2425
Maryland,Calvert County,2,5722,2952,2770
Maryland,Calvert County,3,6847,3423,3424
Maryland,Calvert County,4,6735,3464,3271
Maryland,Calvert County,5,5547,2922,2625
Maryland,Calvert County,6,5006,2604,2402
Maryland,Calvert County,7,5027,2464,2563
Maryland,Calvert County,8,4831,2313,2518
Maryland,Calvert County,9,5842,2780,3062
Maryland,Calvert County,10,7600,3746,3854
Maryland,Calvert County,11,8467,4139,4328
Maryland,Calvert County,12,6969,3445,3524
Maryland,Calvert County,13,5272,2623,2649
Maryland,Calvert County,14,4226,2067,2159
Maryland,Calvert County,15,2934,1463,1471
Maryland,Calvert County,16,1859,838,1021
Maryland,Calvert County,17,1331,519,812
Maryland,Calvert County,18,1433,448,985
Maryland,Caroline County,0,32538,15892,16646
Maryland,Caroline County,1,1947,992,955
Maryland,Caroline County,2,2261,1155,1106
Maryland,Caroline County,3,2238,1102,1136
Maryland,Caroline County,4,2058,1074,984
Maryland,Caroline County,5,1994,1009,985
Maryland,Caroline County,6,1947,980,967
Maryland,Caroline County,7,1988,940,1048
Maryland,Caroline County,8,1831,871,960
Maryland,Caroline County,9,2042,1027,1015
Maryland,Caroline County,10,2264,1099,1165
Maryland,Caroline County,11,2580,1267,1313
Maryland,Caroline County,12,2414,1180,1234
Maryland,Caroline County,13,1970,945,1025
Maryland,Caroline County,14,1727,834,893
Maryland,Caroline County,15,1243,582,661
Maryland,Caroline County,16,838,406,432
Maryland,Caroline County,17,592,247,345
Maryland,Caroline County,18,604,182,422
Maryland,Carroll County,0,167830,82964,84866
Maryland,Carroll County,1,8205,4146,4059
Maryland,Carroll County,2,9999,5094,4905
Maryland,Carroll County,3,11868,6098,5770
Maryland,Carroll County,4,12153,6275,5878
Maryland,Carroll County,5,10626,5489,5137
Maryland,Carroll County,6,9020,4805,4215
Maryland,Carroll County,7,8702,4378,4324
Maryland,Carroll County,8,8509,4199,4310
Maryland,Carroll County,9,10947,5317,5630
Maryland,Carroll County,10,13704,6705,6999
Maryland,Carroll County,11,15196,7582,7614
Maryland,Carroll County,12,12937,6441,6496
Maryland,Carroll County,13,10230,5064,5166
Maryland,Carroll County,14,8802,4249,4553
Maryland,Carroll County,15,6306,2920,3386
Maryland,Carroll County,16,4115,1796,2319
Maryland,Carroll County,17,3075,1259,1816
Maryland,Carroll County,18,3436,1147,2289
Maryland,Cecil County,0,102383,50905,51478
Maryland,Cecil County,1,5908,2980,2928
Maryland,Cecil County,2,6680,3469,3211
Maryland,Cecil County,3,7150,3642,3508
Maryland,Cecil County,4,6794,3537,3257
Maryland,Cecil County,5,6417,3256,3161
Maryland,Cecil County,6,6301,3184,3117
Maryland,Cecil County,7,5950,2974,2976
Maryland,Cecil County,8,5969,2849,3120
Maryland,Cecil County,9,6746,3294,3452
Maryland,Cecil County,10,7863,3925,3938
Maryland,Cecil County,11,8401,4203,4198
Maryland,Cecil County,12,7734,3873,3861
Maryland,Cecil County,13,6379,3154,3225
Maryland,Cecil County,14,5220,2589,2631
Maryland,Cecil County,15,3564,1768,1796
Maryland,Cecil County,16,2298,1083,1215
Maryland,Cecil County,17,1540,628,912
Maryland,Cecil County,18,1469,497,972
Maryland,Charles County,0,154747,74634,80113
Maryland,Charles County,1,9360,4732,4628
Maryland,Charles County,2,10366,5303,5063
Maryland,Charles County,3,11387,5836,5551
Maryland,Charles County,4,11405,5856,5549
Maryland,Charles County,5,10513,5347,5166
Maryland,Charles County,6,9676,4854,4822
Maryland,Charles County,7,9751,4614,5137
Maryland,Charles County,8,9692,4449,5243
Maryland,Charles County,9,11487,5237,6250
Maryland,Charles County,10,12779,6027,6752
Maryland,Charles County,11,13037,6236,6801
Maryland,Charles County,12,10426,5061,5365
Maryland,Charles County,13,7837,3672,4165
Maryland,Charles County,14,6221,2882,3339
Maryland,Charles County,15,4386,2009,2377
Maryland,Charles County,16,2765,1248,1517
Maryland,Charles County,17,1864,725,1139
Maryland,Charles County,18,1795,546,1249
Maryland,Dorchester County,0,32578,15483,17095
Maryland,Dorchester County,1,2022,1037,985
Maryland,Dorchester County,2,1964,983,981
Maryland,Dorchester County,3,1870,939,931
Maryland,Dorchester County,4,1687,902,785
Maryland,Dorchester County,5,1895,891,1004
Maryland,Dorchester County,6,1972,896,1076
Maryland,Dorchester County,7,1771,848,923
Maryland,Dorchester County,8,1659,792,867
Maryland,Dorchester County,9,1800,826,974
Maryland,Dorchester County,10,2128,1034,1094
Maryland,Dorchester County,11,2484,1196,1288
Maryland,Dorchester County,12,2590,1221,1369
Maryland,Dorchester County,13,2311,1072,1239
Maryland,Dorchester County,14,2030,975,1055
Maryland,Dorchester County,15,1620,740,880
Maryland,Dorchester County,16,1183,529,654
Maryland,Dorchester County,17,778,331,447
Maryland,Dorchester County,18,814,271,543
Maryland,Frederick County,0,243675,120185,123490
Maryland,Frederick County,1,14530,7547,6983
Maryland,Frederick County,2,16040,8188,7852
Maryland,Frederick County,3,17150,8786,8364
Maryland,Frederick County,4,17155,8845,8310
Maryland,Frederick County,5,15027,7672,7355
Maryland,Frederick County,6,14665,7239,7426
Maryland,Frederick County,7,15414,7607,7807
Maryland,Frederick County,8,14996,7440,7556
Maryland,Frederick County,9,17132,8430,8702
Maryland,Frederick County,10,18938,9333,9605
Maryland,Frederick County,11,20199,9983,10216
Maryland,Frederick County,12,17303,8564,8739
Maryland,Frederick County,13,13651,6628,7023
Maryland,Frederick County,14,11039,5358,5681
Maryland,Frederick County,15,7439,3444,3995
Maryland,Frederick County,16,4938,2210,2728
Maryland,Frederick County,17,3712,1557,2155
Maryland,Frederick County,18,4347,1354,2993
Maryland,Garrett County,0,29679,14757,14922
Maryland,Garrett County,1,1456,764,692
Maryland,Garrett County,2,1536,786,750
Maryland,Garrett County,3,1671,872,799
Maryland,Garrett County,4,1863,1044,819
Maryland,Garrett County,5,1881,957,924
Maryland,Garrett County,6,1540,814,726
Maryland,Garrett County,7,1541,747,794
Maryland,Garrett County,8,1560,799,761
Maryland,Garrett County,9,1851,884,967
Maryland,Garrett County,10,2024,1006,1018
Maryland,Garrett County,11,2323,1129,1194
Maryland,Garrett County,12,2339,1146,1193
Maryland,Garrett County,13,2158,1075,1083
Maryland,Garrett County,14,1954,970,984
Maryland,Garrett County,15,1528,765,763
Maryland,Garrett County,16,1042,500,542
Maryland,Garrett County,17,695,281,414
Maryland,Garrett County,18,717,218,499
Maryland,Harford County,0,250105,122473,127632
Maryland,Harford County,1,13856,7148,6708
Maryland,Harford County,2,15641,8040,7601
Maryland,Harford County,3,17080,8878,8202
Maryland,Harford County,4,16834,8662,8172
Maryland,Harford County,5,15385,7901,7484
Maryland,Harford County,6,15217,7841,7376
Maryland,Harford County,7,15463,7610,7853
Maryland,Harford County,8,14253,6924,7329
Maryland,Harford County,9,16606,7931,8675
Maryland,Harford County,10,18620,9020,9600
Maryland,Harford County,11,20699,10119,10580
Maryland,Harford County,12,18894,9187,9707
Maryland,Harford County,13,15114,7211,7903
Maryland,Harford County,14,12756,6086,6670
Maryland,Harford County,15,9127,4142,4985
Maryland,Harford County,16,6037,2704,3333
Maryland,Harford County,17,4201,1721,2480
Maryland,Harford County,18,4322,1348,2974
Maryland,Howard County,0,309284,151612,157672
Maryland,Howard County,1,18497,9457,9040
Maryland,Howard County,2,20566,10607,9959
Maryland,Howard County,3,22916,11836,11080
Maryland,Howard County,4,21458,10993,10465
Maryland,Howard County,5,17858,9231,8627
Maryland,Howard County,6,18391,9354,9037
Maryland,Howard County,7,20620,10029,10591
Maryland,Howard County,8,20483,9860,10623
Maryland,Howard County,9,22519,10691,11828
Maryland,Howard County,10,24004,11437,12567
Maryland,Howard County,11,25431,12288,13143
Maryland,Howard County,12,21723,10697,11026
Maryland,Howard County,13,17124,8316,8808
Maryland,Howard County,14,13887,6569,7318
Maryland,Howard County,15,9543,4340,5203
Maryland,Howard County,16,6089,2792,3297
Maryland,Howard County,17,4000,1725,2275
Maryland,Howard County,18,4175,1390,2785
Maryland,Kent County,0,19820,9485,10335
Maryland,Kent County,1,901,485,416
Maryland,Kent County,2,945,461,484
Maryland,Kent County,3,926,495,431
Maryland,Kent County,4,1433,693,740
Maryland,Kent County,5,1555,747,808
Maryland,Kent County,6,1106,559,547
Maryland,Kent County,7,951,466,485
Maryland,Kent County,8,808,400,408
Maryland,Kent County,9,911,463,448
Maryland,Kent County,10,1099,534,565
Maryland,Kent County,11,1444,698,746
Maryland,Kent County,12,1507,670,837
Maryland,Kent County,13,1406,635,771
Maryland,Kent County,14,1469,701,768
Maryland,Kent County,15,1260,607,653
Maryland,Kent County,16,788,375,413
Maryland,Kent County,17,615,280,335
Maryland,Kent County,18,696,216,480
Maryland,Montgomery County,0,1030447,496461,533986
Maryland,Montgomery County,1,67326,34467,32859
Maryland,Montgomery County,2,67586,34200,33386
Maryland,Montgomery County,3,67276,34177,33099
Maryland,Montgomery County,4,62966,32442,30524
Maryland,Montgomery County,5,58131,29971,28160
Maryland,Montgomery County,6,66952,32886,34066
Maryland,Montgomery County,7,72086,35164,36922
Maryland,Montgomery County,8,71043,34283,36760
Maryland,Montgomery County,9,72594,34770,37824
Maryland,Montgomery County,10,73863,34865,38998
Maryland,Montgomery County,11,77260,36690,40570
Maryland,Montgomery County,12,72393,34349,38044
Maryland,Montgomery County,13,60086,28145,31941
Maryland,Montgomery County,14,46701,21503,25198
Maryland,Montgomery County,15,32049,14380,17669
Maryland,Montgomery County,16,22522,9687,12835
Maryland,Montgomery County,17,17236,6994,10242
Maryland,Montgomery County,18,22377,7488,14889
Maryland,Somerset County,0,25859,14018,11841
Maryland,Somerset County,1,1343,660,683
Maryland,Somerset County,2,1194,620,574
Maryland,Somerset County,3,1129,572,557
Maryland,Somerset County,4,1999,984,1015
Maryland,Somerset County,5,3568,1902,1666
Maryland,Somerset County,6,1679,1111,568
Maryland,Somerset County,7,1588,987,601
Maryland,Somerset County,8,1398,884,514
Maryland,Somerset County,9,1473,927,546
Maryland,Somerset County,10,1537,920,617
Maryland,Somerset County,11,1773,982,791
Maryland,Somerset County,12,1692,853,839
Maryland,Somerset County,13,1541,789,752
Maryland,Somerset County,14,1278,640,638
Maryland,Somerset County,15,982,479,503
Maryland,Somerset County,16,686,319,367
Maryland,Somerset County,17,509,215,294
Maryland,Somerset County,18,490,174,316
Maryland,Talbot County,0,37643,17834,19809
Maryland,Talbot County,1,1748,893,855
Maryland,Talbot County,2,1975,1014,961
Maryland,Talbot County,3,2094,1053,1041
Maryland,Talbot County,4,1863,946,917
Maryland,Talbot County,5,1858,929,929
Maryland,Talbot County,6,1842,919,923
Maryland,Talbot County,7,1776,866,910
Maryland,Talbot County,8,1649,782,867
Maryland,Talbot County,9,2065,992,1073
Maryland,Talbot County,10,2347,1068,1279
Maryland,Talbot County,11,2747,1306,1441
Maryland,Talbot County,12,2843,1284,1559
Maryland,Talbot County,13,2810,1262,1548
Maryland,Talbot County,14,2938,1320,1618
Maryland,Talbot County,15,2589,1228,1361
Maryland,Talbot County,16,1808,861,947
Maryland,Talbot County,17,1300,596,704
Maryland,Talbot County,18,1391,515,876
Maryland,Washington County,0,149573,76230,73343
Maryland,Washington County,1,8693,4516,4177
Maryland,Washington County,2,9142,4617,4525
Maryland,Washington County,3,9549,4909,4640
Maryland,Washington County,4,9091,4811,4280
Maryland,Washington County,5,9389,5192,4197
Maryland,Washington County,6,9961,5402,4559
Maryland,Washington County,7,9348,5094,4254
Maryland,Washington County,8,8955,4803,4152
Maryland,Washington County,9,10322,5497,4825
Maryland,Washington County,10,10936,5740,5196
Maryland,Washington County,11,11435,5778,5657
Maryland,Washington County,12,10373,5293,5080
Maryland,Washington County,13,8808,4308,4500
Maryland,Washington County,14,7383,3516,3867
Maryland,Washington County,15,5558,2547,3011
Maryland,Washington County,16,4149,1817,2332
Maryland,Washington County,17,3091,1260,1831
Maryland,Washington County,18,3390,1130,2260
Maryland,Wicomico County,0,101539,48534,53005
Maryland,Wicomico County,1,6030,3117,2913
Maryland,Wicomico County,2,6211,3125,3086
Maryland,Wicomico County,3,6288,3186,3102
Maryland,Wicomico County,4,8752,4187,4565
Maryland,Wicomico County,5,10757,5078,5679
Maryland,Wicomico County,6,6222,3215,3007
Maryland,Wicomico County,7,5973,2873,3100
Maryland,Wicomico County,8,5506,2627,2879
Maryland,Wicomico County,9,5642,2757,2885
Maryland,Wicomico County,10,6103,2910,3193
Maryland,Wicomico County,11,6824,3237,3587
Maryland,Wicomico County,12,6763,3192,3571
Maryland,Wicomico County,13,5849,2722,3127
Maryland,Wicomico County,14,4936,2279,2657
Maryland,Wicomico County,15,3533,1660,1873
Maryland,Wicomico County,16,2366,1004,1362
Maryland,Wicomico County,17,1835,723,1112
Maryland,Wicomico County,18,1949,642,1307
Maryland,Worcester County,0,51675,25120,26555
Maryland,Worcester County,1,2306,1117,1189
Maryland,Worcester County,2,2493,1303,1190
Maryland,Worcester County,3,2722,1396,1326
Maryland,Worcester County,4,2656,1350,1306
Maryland,Worcester County,5,2818,1414,1404
Maryland,Worcester County,6,2690,1369,1321
Maryland,Worcester County,7,2421,1230,1191
Maryland,Worcester County,8,2327,1139,1188
Maryland,Worcester County,9,2786,1384,1402
Maryland,Worcester County,10,3358,1651,1707
Maryland,Worcester County,11,3991,1937,2054
Maryland,Worcester County,12,4030,1936,2094
Maryland,Worcester County,13,3996,1940,2056
Maryland,Worcester County,14,4091,1936,2155
Maryland,Worcester County,15,3362,1544,1818
Maryland,Worcester County,16,2463,1159,1304
Maryland,Worcester County,17,1675,740,935
Maryland,Worcester County,18,1490,575,915
Maryland,Baltimore city,0,622793,293460,329333
Maryland,Baltimore city,1,41767,21483,20284
Maryland,Baltimore city,2,37652,19154,18498
Maryland,Baltimore city,3,33489,17022,16467
Maryland,Baltimore city,4,36615,18060,18555
Maryland,Baltimore city,5,50419,23956,26463
Maryland,Baltimore city,6,62200,29375,32825
Maryland,Baltimore city,7,52678,25179,27499
Maryland,Baltimore city,8,39236,18830,20406
Maryland,Baltimore city,9,35369,16875,18494
Maryland,Baltimore city,10,38089,18318,19771
Maryland,Baltimore city,11,42770,20240,22530
Maryland,Baltimore city,12,41120,18822,22298
Maryland,Baltimore city,13,34721,15556,19165
Maryland,Baltimore city,14,25938,11352,14586
Maryland,Baltimore city,15,17839,7425,10414
Maryland,Baltimore city,16,12727,5036,7691
Maryland,Baltimore city,17,9571,3540,6031
Maryland,Baltimore city,18,10593,3237,7356
Massachusetts,Barnstable County,0,214914,102385,112529
Massachusetts,Barnstable County,1,8357,4199,4158
Massachusetts,Barnstable County,2,9195,4599,4596
Massachusetts,Barnstable County,3,10034,5093,4941
Massachusetts,Barnstable County,4,10839,5813,5026
Massachusetts,Barnstable County,5,11151,6080,5071
Massachusetts,Barnstable County,6,9203,4777,4426
Massachusetts,Barnstable County,7,9453,4809,4644
Massachusetts,Barnstable County,8,8895,4381,4514
Massachusetts,Barnstable County,9,10601,5136,5465
Massachusetts,Barnstable County,10,13431,6277,7154
Massachusetts,Barnstable County,11,17053,8016,9037
Massachusetts,Barnstable County,12,18371,8586,9785
Massachusetts,Barnstable County,13,18483,8485,9998
Massachusetts,Barnstable County,14,18506,8568,9938
Massachusetts,Barnstable County,15,14224,6395,7829
Massachusetts,Barnstable County,16,10191,4554,5637
Massachusetts,Barnstable County,17,8126,3415,4711
Massachusetts,Barnstable County,18,8801,3202,5599
Massachusetts,Berkshire County,0,128715,62280,66435
Massachusetts,Berkshire County,1,5615,2926,2689
Massachusetts,Berkshire County,2,6115,3089,3026
Massachusetts,Berkshire County,3,6664,3350,3314
Massachusetts,Berkshire County,4,8537,4311,4226
Massachusetts,Berkshire County,5,8719,4377,4342
Massachusetts,Berkshire County,6,6637,3401,3236
Massachusetts,Berkshire County,7,6730,3315,3415
Massachusetts,Berkshire County,8,6245,3105,3140
Massachusetts,Berkshire County,9,7272,3524,3748
Massachusetts,Berkshire County,10,8613,4275,4338
Massachusetts,Berkshire County,11,10411,5080,5331
Massachusetts,Berkshire County,12,10579,5052,5527
Massachusetts,Berkshire County,13,9708,4653,5055
Massachusetts,Berkshire County,14,8514,4104,4410
Massachusetts,Berkshire County,15,6085,2795,3290
Massachusetts,Berkshire County,16,4287,1947,2340
Massachusetts,Berkshire County,17,3589,1498,2091
Massachusetts,Berkshire County,18,4395,1478,2917
Massachusetts,Bristol County,0,554194,268571,285623
Massachusetts,Bristol County,1,29029,14864,14165
Massachusetts,Bristol County,2,32415,16457,15958
Massachusetts,Bristol County,3,34275,17385,16890
Massachusetts,Bristol County,4,36660,18660,18000
Massachusetts,Bristol County,5,38226,19425,18801
Massachusetts,Bristol County,6,34429,17027,17402
Massachusetts,Bristol County,7,33514,16528,16986
Massachusetts,Bristol County,8,32922,15989,16933
Massachusetts,Bristol County,9,37356,18162,19194
Massachusetts,Bristol County,10,41576,20420,21156
Massachusetts,Bristol County,11,43482,21305,22177
Massachusetts,Bristol County,12,40229,19498,20731
Massachusetts,Bristol County,13,33200,15857,17343
Massachusetts,Bristol County,14,28165,13251,14914
Massachusetts,Bristol County,15,20150,9155,10995
Massachusetts,Bristol County,16,13931,6095,7836
Massachusetts,Bristol County,17,10915,4232,6683
Massachusetts,Bristol County,18,13720,4261,9459
Massachusetts,Dukes County,0,17356,8598,8758
Massachusetts,Dukes County,1,820,436,384
Massachusetts,Dukes County,2,938,481,457
Massachusetts,Dukes County,3,870,464,406
Massachusetts,Dukes County,4,876,458,418
Massachusetts,Dukes County,5,836,430,406
Massachusetts,Dukes County,6,915,459,456
Massachusetts,Dukes County,7,1012,525,487
Massachusetts,Dukes County,8,938,503,435
Massachusetts,Dukes County,9,1097,533,564
Massachusetts,Dukes County,10,1193,590,603
Massachusetts,Dukes County,11,1465,730,735
Massachusetts,Dukes County,12,1427,690,737
Massachusetts,Dukes County,13,1534,721,813
Massachusetts,Dukes County,14,1317,630,687
Massachusetts,Dukes County,15,828,409,419
Massachusetts,Dukes County,16,505,214,291
Massachusetts,Dukes County,17,354,160,194
Massachusetts,Dukes County,18,431,165,266
Massachusetts,Essex County,0,769091,370560,398531
Massachusetts,Essex County,1,43621,22388,21233
Massachusetts,Essex County,2,45490,23394,22096
Massachusetts,Essex County,3,49088,25130,23958
Massachusetts,Essex County,4,51501,26273,25228
Massachusetts,Essex County,5,51395,25947,25448
Massachusetts,Essex County,6,46033,22946,23087
Massachusetts,Essex County,7,45800,22216,23584
Massachusetts,Essex County,8,44414,21477,22937
Massachusetts,Essex County,9,49419,23717,25702
Massachusetts,Essex County,10,55754,26762,28992
Massachusetts,Essex County,11,61212,29244,31968
Massachusetts,Essex County,12,57537,27592,29945
Massachusetts,Essex County,13,47949,22598,25351
Massachusetts,Essex County,14,39156,18280,20876
Massachusetts,Essex County,15,27151,12353,14798
Massachusetts,Essex County,16,19234,8212,11022
Massachusetts,Essex County,17,15371,6015,9356
Massachusetts,Essex County,18,18966,6016,12950
Massachusetts,Franklin County,0,70862,34593,36269
Massachusetts,Franklin County,1,3218,1650,1568
Massachusetts,Franklin County,2,3437,1766,1671
Massachusetts,Franklin County,3,3817,1980,1837
Massachusetts,Franklin County,4,3814,1988,1826
Massachusetts,Franklin County,5,4120,2137,1983
Massachusetts,Franklin County,6,4232,2204,2028
Massachusetts,Franklin County,7,4130,2049,2081
Massachusetts,Franklin County,8,3804,1887,1917
Massachusetts,Franklin County,9,4344,2082,2262
Massachusetts,Franklin County,10,4833,2359,2474
Massachusetts,Franklin County,11,5727,2737,2990
Massachusetts,Franklin County,12,6260,3011,3249
Massachusetts,Franklin County,13,6230,2946,3284
Massachusetts,Franklin County,14,4867,2369,2498
Massachusetts,Franklin County,15,2937,1412,1525
Massachusetts,Franklin County,16,1879,840,1039
Massachusetts,Franklin County,17,1441,578,863
Massachusetts,Franklin County,18,1772,598,1174
Massachusetts,Hampden County,0,468161,225908,242253
Massachusetts,Hampden County,1,27499,14075,13424
Massachusetts,Hampden County,2,28384,14584,13800
Massachusetts,Hampden County,3,30112,15354,14758
Massachusetts,Hampden County,4,34187,17455,16732
Massachusetts,Hampden County,5,36037,18278,17759
Massachusetts,Hampden County,6,30621,15265,15356
Massachusetts,Hampden County,7,28575,13755,14820
Massachusetts,Hampden County,8,25810,12283,13527
Massachusetts,Hampden County,9,27927,13307,14620
Massachusetts,Hampden County,10,31135,14891,16244
Massachusetts,Hampden County,11,34302,16520,17782
Massachusetts,Hampden County,12,33496,16342,17154
Massachusetts,Hampden County,13,28631,13584,15047
Massachusetts,Hampden County,14,22855,10675,12180
Massachusetts,Hampden County,15,15997,7280,8717
Massachusetts,Hampden County,16,11372,4926,6446
Massachusetts,Hampden County,17,9221,3520,5701
Massachusetts,Hampden County,18,12000,3814,8186
Massachusetts,Hampshire County,0,160939,74993,85946
Massachusetts,Hampshire County,1,5788,2957,2831
Massachusetts,Hampshire County,2,6669,3434,3235
Massachusetts,Hampshire County,3,7612,3760,3852
Massachusetts,Hampshire County,4,18180,7820,10360
Massachusetts,Hampshire County,5,24540,11099,13441
Massachusetts,Hampshire County,6,8574,4340,4234
Massachusetts,Hampshire County,7,8034,3896,4138
Massachusetts,Hampshire County,8,7532,3603,3929
Massachusetts,Hampshire County,9,8395,4013,4382
Massachusetts,Hampshire County,10,9477,4498,4979
Massachusetts,Hampshire County,11,11060,5222,5838
Massachusetts,Hampshire County,12,11085,5197,5888
Massachusetts,Hampshire County,13,10285,4840,5445
Massachusetts,Hampshire County,14,8476,4051,4425
Massachusetts,Hampshire County,15,5311,2421,2890
Massachusetts,Hampshire County,16,3646,1575,2071
Massachusetts,Hampshire County,17,2762,1109,1653
Massachusetts,Hampshire County,18,3513,1158,2355
Massachusetts,Middlesex County,0,1570315,766953,803362
Massachusetts,Middlesex County,1,88093,44896,43197
Massachusetts,Middlesex County,2,87629,44788,42841
Massachusetts,Middlesex County,3,90947,46279,44668
Massachusetts,Middlesex County,4,102601,52385,50216
Massachusetts,Middlesex County,5,106245,54105,52140
Massachusetts,Middlesex County,6,121199,60601,60598
Massachusetts,Middlesex County,7,116823,58826,57997
Massachusetts,Middlesex County,8,103683,51427,52256
Massachusetts,Middlesex County,9,105077,51924,53153
Massachusetts,Middlesex County,10,112162,54783,57379
Massachusetts,Middlesex County,11,118463,58040,60423
Massachusetts,Middlesex County,12,107962,52164,55798
Massachusetts,Middlesex County,13,89294,42551,46743
Massachusetts,Middlesex County,14,71099,33189,37910
Massachusetts,Middlesex County,15,49380,22212,27168
Massachusetts,Middlesex County,16,36590,15845,20745
Massachusetts,Middlesex County,17,29083,11796,17287
Massachusetts,Middlesex County,18,33985,11142,22843
Massachusetts,Nantucket County,0,10856,5544,5312
Massachusetts,Nantucket County,1,695,362,333
Massachusetts,Nantucket County,2,665,316,349
Massachusetts,Nantucket County,3,591,283,308
Massachusetts,Nantucket County,4,477,253,224
Massachusetts,Nantucket County,5,520,267,253
Massachusetts,Nantucket County,6,743,413,330
Massachusetts,Nantucket County,7,856,454,402
Massachusetts,Nantucket County,8,806,442,364
Massachusetts,Nantucket County,9,860,478,382
Massachusetts,Nantucket County,10,868,439,429
Massachusetts,Nantucket County,11,857,450,407
Massachusetts,Nantucket County,12,787,388,399
Massachusetts,Nantucket County,13,675,333,342
Massachusetts,Nantucket County,14,502,258,244
Massachusetts,Nantucket County,15,335,154,181
Massachusetts,Nantucket County,16,263,129,134
Massachusetts,Nantucket County,17,155,69,86
Massachusetts,Nantucket County,18,201,56,145
Massachusetts,Norfolk County,0,692254,331922,360332
Massachusetts,Norfolk County,1,37434,19064,18370
Massachusetts,Norfolk County,2,40583,20526,20057
Massachusetts,Norfolk County,3,44386,22800,21586
Massachusetts,Norfolk County,4,45075,22619,22456
Massachusetts,Norfolk County,5,42140,20499,21641
Massachusetts,Norfolk County,6,43363,20851,22512
Massachusetts,Norfolk County,7,42848,20841,22007
Massachusetts,Norfolk County,8,42001,20346,21655
Massachusetts,Norfolk County,9,46188,22317,23871
Massachusetts,Norfolk County,10,51452,25014,26438
Massachusetts,Norfolk County,11,55296,26791,28505
Massachusetts,Norfolk County,12,50993,24513,26480
Massachusetts,Norfolk County,13,41969,20016,21953
Massachusetts,Norfolk County,14,33938,15926,18012
Massachusetts,Norfolk County,15,23786,10597,13189
Massachusetts,Norfolk County,16,17666,7551,10115
Massachusetts,Norfolk County,17,14797,5781,9016
Massachusetts,Norfolk County,18,18339,5870,12469
Massachusetts,Plymouth County,0,507022,246592,260430
Massachusetts,Plymouth County,1,26899,13921,12978
Massachusetts,Plymouth County,2,30862,16013,14849
Massachusetts,Plymouth County,3,34674,17788,16886
Massachusetts,Plymouth County,4,34607,17579,17028
Massachusetts,Plymouth County,5,31252,15829,15423
Massachusetts,Plymouth County,6,26042,13252,12790
Massachusetts,Plymouth County,7,26534,12879,13655
Massachusetts,Plymouth County,8,27735,13540,14195
Massachusetts,Plymouth County,9,33666,16257,17409
Massachusetts,Plymouth County,10,39178,19086,20092
Massachusetts,Plymouth County,11,41617,20301,21316
Massachusetts,Plymouth County,12,38507,18612,19895
Massachusetts,Plymouth County,13,33145,15720,17425
Massachusetts,Plymouth County,14,28271,13153,15118
Massachusetts,Plymouth County,15,20130,9281,10849
Massachusetts,Plymouth County,16,13249,5864,7385
Massachusetts,Plymouth County,17,9728,4044,5684
Massachusetts,Plymouth County,18,10926,3473,7453
Massachusetts,Suffolk County,0,767254,370956,396298
Massachusetts,Suffolk County,1,43806,22415,21391
Massachusetts,Suffolk County,2,35635,17994,17641
Massachusetts,Suffolk County,3,32805,16725,16080
Massachusetts,Suffolk County,4,52488,25057,27431
Massachusetts,Suffolk County,5,79688,38612,41076
Massachusetts,Suffolk County,6,99915,49098,50817
Massachusetts,Suffolk County,7,74163,36849,37314
Massachusetts,Suffolk County,8,52095,26047,26048
Massachusetts,Suffolk County,9,45979,22773,23206
Massachusetts,Suffolk County,10,44567,22046,22521
Massachusetts,Suffolk County,11,44441,21826,22615
Massachusetts,Suffolk County,12,41697,19767,21930
Massachusetts,Suffolk County,13,35806,16813,18993
Massachusetts,Suffolk County,14,27462,12318,15144
Massachusetts,Suffolk County,15,19258,8587,10671
Massachusetts,Suffolk County,16,14305,5990,8315
Massachusetts,Suffolk County,17,10815,4133,6682
Massachusetts,Suffolk County,18,12329,3906,8423
Massachusetts,Worcester County,0,813475,400969,412506
Massachusetts,Worcester County,1,45181,23158,22023
Massachusetts,Worcester County,2,48305,24895,23410
Massachusetts,Worcester County,3,52288,26864,25424
Massachusetts,Worcester County,4,57354,29257,28097
Massachusetts,Worcester County,5,56523,28967,27556
Massachusetts,Worcester County,6,50824,25723,25101
Massachusetts,Worcester County,7,49200,24639,24561
Massachusetts,Worcester County,8,48069,23739,24330
Massachusetts,Worcester County,9,54602,26610,27992
Massachusetts,Worcester County,10,60974,30326,30648
Massachusetts,Worcester County,11,66012,32746,33266
Massachusetts,Worcester County,12,60818,30169,30649
Massachusetts,Worcester County,13,48641,24001,24640
Massachusetts,Worcester County,14,37809,18275,19534
Massachusetts,Worcester County,15,26287,12187,14100
Massachusetts,Worcester County,16,18486,7969,10517
Massachusetts,Worcester County,17,14286,5690,8596
Massachusetts,Worcester County,18,17816,5754,12062
Michigan,Alcona County,0,10454,5249,5205
Michigan,Alcona County,1,319,159,160
Michigan,Alcona County,2,351,171,180
Michigan,Alcona County,3,402,214,188
Michigan,Alcona County,4,471,246,225
Michigan,Alcona County,5,387,204,183
Michigan,Alcona County,6,325,164,161
Michigan,Alcona County,7,317,161,156
Michigan,Alcona County,8,345,174,171
Michigan,Alcona County,9,427,202,225
Michigan,Alcona County,10,610,329,281
Michigan,Alcona County,11,795,388,407
Michigan,Alcona County,12,1015,518,497
Michigan,Alcona County,13,1057,507,550
Michigan,Alcona County,14,1085,557,528
Michigan,Alcona County,15,1032,521,511
Michigan,Alcona County,16,726,380,346
Michigan,Alcona County,17,432,200,232
Michigan,Alcona County,18,358,154,204
Michigan,Alger County,0,9459,5206,4253
Michigan,Alger County,1,325,173,152
Michigan,Alger County,2,395,202,193
Michigan,Alger County,3,459,232,227
Michigan,Alger County,4,446,242,204
Michigan,Alger County,5,476,323,153
Michigan,Alger County,6,517,356,161
Michigan,Alger County,7,561,373,188
Michigan,Alger County,8,511,308,203
Michigan,Alger County,9,525,324,201
Michigan,Alger County,10,578,323,255
Michigan,Alger County,11,732,388,344
Michigan,Alger County,12,843,412,431
Michigan,Alger County,13,846,454,392
Michigan,Alger County,14,695,365,330
Michigan,Alger County,15,579,308,271
Michigan,Alger County,16,417,194,223
Michigan,Alger County,17,276,127,149
Michigan,Alger County,18,278,102,176
Michigan,Allegan County,0,113847,56755,57092
Michigan,Allegan County,1,6818,3455,3363
Michigan,Allegan County,2,7920,4022,3898
Michigan,Allegan County,3,8342,4295,4047
Michigan,Allegan County,4,7843,4100,3743
Michigan,Allegan County,5,6546,3324,3222
Michigan,Allegan County,6,6275,3149,3126
Michigan,Allegan County,7,6620,3294,3326
Michigan,Allegan County,8,6444,3195,3249
Michigan,Allegan County,9,7125,3611,3514
Michigan,Allegan County,10,7787,3900,3887
Michigan,Allegan County,11,8985,4468,4517
Michigan,Allegan County,12,8646,4354,4292
Michigan,Allegan County,13,7337,3671,3666
Michigan,Allegan County,14,5842,2870,2972
Michigan,Allegan County,15,4415,2147,2268
Michigan,Allegan County,16,2909,1370,1539
Michigan,Allegan County,17,1967,855,1112
Michigan,Allegan County,18,2026,675,1351
Michigan,Alpena County,0,28988,14227,14761
Michigan,Alpena County,1,1323,677,646
Michigan,Alpena County,2,1532,802,730
Michigan,Alpena County,3,1683,841,842
Michigan,Alpena County,4,1676,884,792
Michigan,Alpena County,5,1607,825,782
Michigan,Alpena County,6,1323,686,637
Michigan,Alpena County,7,1556,785,771
Michigan,Alpena County,8,1484,725,759
Michigan,Alpena County,9,1651,808,843
Michigan,Alpena County,10,1742,851,891
Michigan,Alpena County,11,2420,1205,1215
Michigan,Alpena County,12,2560,1264,1296
Michigan,Alpena County,13,2206,1087,1119
Michigan,Alpena County,14,1867,924,943
Michigan,Alpena County,15,1462,689,773
Michigan,Alpena County,16,1160,529,631
Michigan,Alpena County,17,845,350,495
Michigan,Alpena County,18,891,295,596
Michigan,Antrim County,0,23267,11557,11710
Michigan,Antrim County,1,993,535,458
Michigan,Antrim County,2,1200,607,593
Michigan,Antrim County,3,1386,682,704
Michigan,Antrim County,4,1299,682,617
Michigan,Antrim County,5,1063,555,508
Michigan,Antrim County,6,926,458,468
Michigan,Antrim County,7,1087,549,538
Michigan,Antrim County,8,1023,537,486
Michigan,Antrim County,9,1165,577,588
Michigan,Antrim County,10,1506,729,777
Michigan,Antrim County,11,1784,880,904
Michigan,Antrim County,12,1973,956,1017
Michigan,Antrim County,13,1998,1004,994
Michigan,Antrim County,14,1803,862,941
Michigan,Antrim County,15,1612,845,767
Michigan,Antrim County,16,1094,542,552
Michigan,Antrim County,17,699,320,379
Michigan,Antrim County,18,656,237,419
Michigan,Arenac County,0,15353,7777,7576
Michigan,Arenac County,1,623,336,287
Michigan,Arenac County,2,778,394,384
Michigan,Arenac County,3,847,423,424
Michigan,Arenac County,4,896,481,415
Michigan,Arenac County,5,773,412,361
Michigan,Arenac County,6,677,335,342
Michigan,Arenac County,7,778,395,383
Michigan,Arenac County,8,722,367,355
Michigan,Arenac County,9,835,433,402
Michigan,Arenac County,10,941,463,478
Michigan,Arenac County,11,1311,651,660
Michigan,Arenac County,12,1400,727,673
Michigan,Arenac County,13,1314,687,627
Michigan,Arenac County,14,1116,559,557
Michigan,Arenac County,15,884,449,435
Michigan,Arenac County,16,686,336,350
Michigan,Arenac County,17,400,170,230
Michigan,Arenac County,18,372,159,213
Michigan,Baraga County,0,8654,4748,3906
Michigan,Baraga County,1,392,192,200
Michigan,Baraga County,2,458,249,209
Michigan,Baraga County,3,452,227,225
Michigan,Baraga County,4,517,254,263
Michigan,Baraga County,5,521,341,180
Michigan,Baraga County,6,496,337,159
Michigan,Baraga County,7,523,339,184
Michigan,Baraga County,8,531,338,193
Michigan,Baraga County,9,550,306,244
Michigan,Baraga County,10,606,322,284
Michigan,Baraga County,11,639,367,272
Michigan,Baraga County,12,640,346,294
Michigan,Baraga County,13,674,343,331
Michigan,Baraga County,14,526,269,257
Michigan,Baraga County,15,452,230,222
Michigan,Baraga County,16,313,151,162
Michigan,Baraga County,17,170,68,102
Michigan,Baraga County,18,194,69,125
Michigan,Barry County,0,59281,29823,29458
Michigan,Barry County,1,3159,1651,1508
Michigan,Barry County,2,3667,1885,1782
Michigan,Barry County,3,4161,2109,2052
Michigan,Barry County,4,4046,2144,1902
Michigan,Barry County,5,3271,1715,1556
Michigan,Barry County,6,3022,1527,1495
Michigan,Barry County,7,3182,1602,1580
Michigan,Barry County,8,3294,1671,1623
Michigan,Barry County,9,3626,1825,1801
Michigan,Barry County,10,3955,1993,1962
Michigan,Barry County,11,4943,2518,2425
Michigan,Barry County,12,4756,2411,2345
Michigan,Barry County,13,4158,2117,2041
Michigan,Barry County,14,3447,1699,1748
Michigan,Barry County,15,2576,1254,1322
Michigan,Barry County,16,1755,837,918
Michigan,Barry County,17,1092,474,618
Michigan,Barry County,18,1171,391,780
Michigan,Bay County,0,106179,52307,53872
Michigan,Bay County,1,5493,2882,2611
Michigan,Bay County,2,6183,3180,3003
Michigan,Bay County,3,6541,3386,3155
Michigan,Bay County,4,6218,3246,2972
Michigan,Bay County,5,6651,3396,3255
Michigan,Bay County,6,6358,3272,3086
Michigan,Bay County,7,6147,3075,3072
Michigan,Bay County,8,5951,3024,2927
Michigan,Bay County,9,6314,3186,3128
Michigan,Bay County,10,6884,3502,3382
Michigan,Bay County,11,8066,3944,4122
Michigan,Bay County,12,8399,4068,4331
Michigan,Bay County,13,7540,3657,3883
Michigan,Bay County,14,6198,2988,3210
Michigan,Bay County,15,4651,2181,2470
Michigan,Bay County,16,3375,1520,1855
Michigan,Bay County,17,2361,917,1444
Michigan,Bay County,18,2849,883,1966
Michigan,Benzie County,0,17519,8697,8822
Michigan,Benzie County,1,735,352,383
Michigan,Benzie County,2,909,480,429
Michigan,Benzie County,3,1040,551,489
Michigan,Benzie County,4,999,517,482
Michigan,Benzie County,5,825,457,368
Michigan,Benzie County,6,773,395,378
Michigan,Benzie County,7,877,451,426
Michigan,Benzie County,8,846,406,440
Michigan,Benzie County,9,980,468,512
Michigan,Benzie County,10,1099,551,548
Michigan,Benzie County,11,1396,673,723
Michigan,Benzie County,12,1475,719,756
Michigan,Benzie County,13,1384,681,703
Michigan,Benzie County,14,1346,678,668
Michigan,Benzie County,15,1088,541,547
Michigan,Benzie County,16,766,372,394
Michigan,Benzie County,17,462,217,245
Michigan,Benzie County,18,519,188,331
Michigan,Berrien County,0,155233,75774,79459
Michigan,Berrien County,1,9388,4733,4655
Michigan,Berrien County,2,9523,4876,4647
Michigan,Berrien County,3,9777,5046,4731
Michigan,Berrien County,4,9877,5048,4829
Michigan,Berrien County,5,9746,5007,4739
Michigan,Berrien County,6,8664,4302,4362
Michigan,Berrien County,7,8742,4318,4424
Michigan,Berrien County,8,8604,4314,4290
Michigan,Berrien County,9,9262,4542,4720
Michigan,Berrien County,10,9925,4833,5092
Michigan,Berrien County,11,11677,5738,5939
Michigan,Berrien County,12,11750,5781,5969
Michigan,Berrien County,13,10628,5124,5504
Michigan,Berrien County,14,8732,4101,4631
Michigan,Berrien County,15,6585,3050,3535
Michigan,Berrien County,16,4796,2153,2643
Michigan,Berrien County,17,3587,1452,2135
Michigan,Berrien County,18,3970,1356,2614
Michigan,Branch County,0,43545,22483,21062
Michigan,Branch County,1,2690,1391,1299
Michigan,Branch County,2,2904,1489,1415
Michigan,Branch County,3,2944,1499,1445
Michigan,Branch County,4,2688,1412,1276
Michigan,Branch County,5,2511,1348,1163
Michigan,Branch County,6,2507,1340,1167
Michigan,Branch County,7,2727,1504,1223
Michigan,Branch County,8,2461,1366,1095
Michigan,Branch County,9,2736,1520,1216
Michigan,Branch County,10,2771,1504,1267
Michigan,Branch County,11,3288,1715,1573
Michigan,Branch County,12,3256,1675,1581
Michigan,Branch County,13,2842,1456,1386
Michigan,Branch County,14,2359,1142,1217
Michigan,Branch County,15,1824,884,940
Michigan,Branch County,16,1390,645,745
Michigan,Branch County,17,892,367,525
Michigan,Branch County,18,755,226,529
Michigan,Calhoun County,0,134878,65866,69012
Michigan,Calhoun County,1,8190,4223,3967
Michigan,Calhoun County,2,8715,4421,4294
Michigan,Calhoun County,3,8898,4502,4396
Michigan,Calhoun County,4,9033,4666,4367
Michigan,Calhoun County,5,8951,4595,4356
Michigan,Calhoun County,6,8006,3909,4097
Michigan,Calhoun County,7,8014,3944,4070
Michigan,Calhoun County,8,7578,3720,3858
Michigan,Calhoun County,9,8338,4080,4258
Michigan,Calhoun County,10,8586,4274,4312
Michigan,Calhoun County,11,9905,4855,5050
Michigan,Calhoun County,12,9771,4778,4993
Michigan,Calhoun County,13,8759,4229,4530
Michigan,Calhoun County,14,7060,3379,3681
Michigan,Calhoun County,15,5108,2283,2825
Michigan,Calhoun County,16,3858,1742,2116
Michigan,Calhoun County,17,2928,1248,1680
Michigan,Calhoun County,18,3180,1018,2162
Michigan,Cass County,0,51608,25824,25784
Michigan,Cass County,1,2383,1278,1105
Michigan,Cass County,2,3047,1563,1484
Michigan,Cass County,3,3407,1715,1692
Michigan,Cass County,4,3370,1765,1605
Michigan,Cass County,5,2906,1498,1408
Michigan,Cass County,6,2433,1249,1184
Michigan,Cass County,7,2654,1320,1334
Michigan,Cass County,8,2602,1319,1283
Michigan,Cass County,9,3261,1638,1623
Michigan,Cass County,10,3510,1761,1749
Michigan,Cass County,11,4007,2031,1976
Michigan,Cass County,12,4099,2056,2043
Michigan,Cass County,13,3922,1964,1958
Michigan,Cass County,14,3575,1736,1839
Michigan,Cass County,15,2659,1286,1373
Michigan,Cass County,16,1639,795,844
Michigan,Cass County,17,1059,466,593
Michigan,Cass County,18,1075,384,691
Michigan,Charlevoix County,0,26121,12914,13207
Michigan,Charlevoix County,1,1258,691,567
Michigan,Charlevoix County,2,1402,702,700
Michigan,Charlevoix County,3,1590,796,794
Michigan,Charlevoix County,4,1575,795,780
Michigan,Charlevoix County,5,1286,653,633
Michigan,Charlevoix County,6,1230,630,600
Michigan,Charlevoix County,7,1301,680,621
Michigan,Charlevoix County,8,1222,622,600
Michigan,Charlevoix County,9,1367,659,708
Michigan,Charlevoix County,10,1702,840,862
Michigan,Charlevoix County,11,2108,1066,1042
Michigan,Charlevoix County,12,2276,1092,1184
Michigan,Charlevoix County,13,2187,1056,1131
Michigan,Charlevoix County,14,1884,913,971
Michigan,Charlevoix County,15,1420,702,718
Michigan,Charlevoix County,16,977,489,488
Michigan,Charlevoix County,17,643,284,359
Michigan,Charlevoix County,18,693,244,449
Michigan,Cheboygan County,0,25675,12793,12882
Michigan,Cheboygan County,1,1018,515,503
Michigan,Cheboygan County,2,1234,640,594
Michigan,Cheboygan County,3,1390,713,677
Michigan,Cheboygan County,4,1469,798,671
Michigan,Cheboygan County,5,1204,631,573
Michigan,Cheboygan County,6,1088,544,544
Michigan,Cheboygan County,7,1155,603,552
Michigan,Cheboygan County,8,1223,587,636
Michigan,Cheboygan County,9,1444,717,727
Michigan,Cheboygan County,10,1693,865,828
Michigan,Cheboygan County,11,1915,957,958
Michigan,Cheboygan County,12,2235,1065,1170
Michigan,Cheboygan County,13,2276,1130,1146
Michigan,Cheboygan County,14,2046,1003,1043
Michigan,Cheboygan County,15,1664,815,849
Michigan,Cheboygan County,16,1156,580,576
Michigan,Cheboygan County,17,739,359,380
Michigan,Cheboygan County,18,726,271,455
Michigan,Chippewa County,0,38321,21123,17198
Michigan,Chippewa County,1,1851,939,912
Michigan,Chippewa County,2,1990,1033,957
Michigan,Chippewa County,3,2091,1069,1022
Michigan,Chippewa County,4,2536,1327,1209
Michigan,Chippewa County,5,3374,1826,1548
Michigan,Chippewa County,6,2523,1633,890
Michigan,Chippewa County,7,2525,1620,905
Michigan,Chippewa County,8,2404,1480,924
Michigan,Chippewa County,9,2502,1562,940
Michigan,Chippewa County,10,2500,1467,1033
Michigan,Chippewa County,11,2777,1556,1221
Michigan,Chippewa County,12,2710,1410,1300
Michigan,Chippewa County,13,2359,1234,1125
Michigan,Chippewa County,14,1972,1012,960
Michigan,Chippewa County,15,1588,767,821
Michigan,Chippewa County,16,1099,554,545
Michigan,Chippewa County,17,803,373,430
Michigan,Chippewa County,18,717,261,456
Michigan,Clare County,0,30652,15271,15381
Michigan,Clare County,1,1665,843,822
Michigan,Clare County,2,1697,842,855
Michigan,Clare County,3,1645,842,803
Michigan,Clare County,4,1735,936,799
Michigan,Clare County,5,1661,840,821
Michigan,Clare County,6,1593,778,815
Michigan,Clare County,7,1469,752,717
Michigan,Clare County,8,1474,737,737
Michigan,Clare County,9,1713,876,837
Michigan,Clare County,10,1919,948,971
Michigan,Clare County,11,2342,1173,1169
Michigan,Clare County,12,2570,1285,1285
Michigan,Clare County,13,2485,1176,1309
Michigan,Clare County,14,2227,1088,1139
Michigan,Clare County,15,1786,915,871
Michigan,Clare County,16,1292,674,618
Michigan,Clare County,17,731,343,388
Michigan,Clare County,18,648,223,425
Michigan,Clinton County,0,77297,38201,39096
Michigan,Clinton County,1,4184,2143,2041
Michigan,Clinton County,2,4898,2451,2447
Michigan,Clinton County,3,5330,2705,2625
Michigan,Clinton County,4,5162,2753,2409
Michigan,Clinton County,5,5214,2643,2571
Michigan,Clinton County,6,4572,2288,2284
Michigan,Clinton County,7,4449,2219,2230
Michigan,Clinton County,8,4576,2239,2337
Michigan,Clinton County,9,4779,2303,2476
Michigan,Clinton County,10,5502,2713,2789
Michigan,Clinton County,11,5996,2982,3014
Michigan,Clinton County,12,5787,2854,2933
Michigan,Clinton County,13,5006,2481,2525
Michigan,Clinton County,14,3953,1908,2045
Michigan,Clinton County,15,2978,1466,1512
Michigan,Clinton County,16,2010,931,1079
Michigan,Clinton County,17,1429,586,843
Michigan,Clinton County,18,1472,536,936
Michigan,Crawford County,0,13745,6922,6823
Michigan,Crawford County,1,564,300,264
Michigan,Crawford County,2,679,339,340
Michigan,Crawford County,3,749,384,365
Michigan,Crawford County,4,754,384,370
Michigan,Crawford County,5,657,328,329
Michigan,Crawford County,6,579,289,290
Michigan,Crawford County,7,661,336,325
Michigan,Crawford County,8,539,258,281
Michigan,Crawford County,9,744,370,374
Michigan,Crawford County,10,909,467,442
Michigan,Crawford County,11,1203,581,622
Michigan,Crawford County,12,1270,657,613
Michigan,Crawford County,13,1137,600,537
Michigan,Crawford County,14,1075,558,517
Michigan,Crawford County,15,905,455,450
Michigan,Crawford County,16,620,312,308
Michigan,Crawford County,17,367,172,195
Michigan,Crawford County,18,333,132,201
Michigan,Delta County,0,36559,18144,18415
Michigan,Delta County,1,1872,967,905
Michigan,Delta County,2,1998,1023,975
Michigan,Delta County,3,2165,1105,1060
Michigan,Delta County,4,2111,1107,1004
Michigan,Delta County,5,1970,1011,959
Michigan,Delta County,6,1642,846,796
Michigan,Delta County,7,1887,938,949
Michigan,Delta County,8,1884,989,895
Michigan,Delta County,9,2000,979,1021
Michigan,Delta County,10,2238,1123,1115
Michigan,Delta County,11,2854,1444,1410
Michigan,Delta County,12,3133,1548,1585
Michigan,Delta County,13,2999,1470,1529
Michigan,Delta County,14,2472,1275,1197
Michigan,Delta County,15,1774,858,916
Michigan,Delta County,16,1375,647,728
Michigan,Delta County,17,1075,438,637
Michigan,Delta County,18,1110,376,734
Michigan,Dickinson County,0,25957,13012,12945
Michigan,Dickinson County,1,1287,678,609
Michigan,Dickinson County,2,1385,737,648
Michigan,Dickinson County,3,1549,767,782
Michigan,Dickinson County,4,1530,812,718
Michigan,Dickinson County,5,1390,731,659
Michigan,Dickinson County,6,1289,669,620
Michigan,Dickinson County,7,1474,746,728
Michigan,Dickinson County,8,1210,616,594
Michigan,Dickinson County,9,1407,695,712
Michigan,Dickinson County,10,1754,897,857
Michigan,Dickinson County,11,2150,1045,1105
Michigan,Dickinson County,12,2305,1177,1128
Michigan,Dickinson County,13,1923,990,933
Michigan,Dickinson County,14,1564,798,766
Michigan,Dickinson County,15,1223,575,648
Michigan,Dickinson County,16,868,429,439
Michigan,Dickinson County,17,750,341,409
Michigan,Dickinson County,18,899,309,590
Michigan,Eaton County,0,108579,53050,55529
Michigan,Eaton County,1,5824,2921,2903
Michigan,Eaton County,2,6220,3161,3059
Michigan,Eaton County,3,7089,3618,3471
Michigan,Eaton County,4,7193,3677,3516
Michigan,Eaton County,5,7076,3618,3458
Michigan,Eaton County,6,6874,3489,3385
Michigan,Eaton County,7,6637,3208,3429
Michigan,Eaton County,8,6096,3052,3044
Michigan,Eaton County,9,6455,3176,3279
Michigan,Eaton County,10,7162,3443,3719
Michigan,Eaton County,11,8291,3979,4312
Michigan,Eaton County,12,8484,4108,4376
Michigan,Eaton County,13,7390,3592,3798
Michigan,Eaton County,14,6168,2971,3197
Michigan,Eaton County,15,4375,2043,2332
Michigan,Eaton County,16,2940,1324,1616
Michigan,Eaton County,17,2081,907,1174
Michigan,Eaton County,18,2224,763,1461
Michigan,Emmet County,0,33204,16383,16821
Michigan,Emmet County,1,1603,841,762
Michigan,Emmet County,2,1788,957,831
Michigan,Emmet County,3,2150,1078,1072
Michigan,Emmet County,4,2107,1121,986
Michigan,Emmet County,5,1807,908,899
Michigan,Emmet County,6,1820,944,876
Michigan,Emmet County,7,1733,838,895
Michigan,Emmet County,8,1772,843,929
Michigan,Emmet County,9,1918,989,929
Michigan,Emmet County,10,2037,998,1039
Michigan,Emmet County,11,2502,1228,1274
Michigan,Emmet County,12,2720,1268,1452
Michigan,Emmet County,13,2694,1316,1378
Michigan,Emmet County,14,2174,1065,1109
Michigan,Emmet County,15,1542,791,751
Michigan,Emmet County,16,1119,547,572
Michigan,Emmet County,17,785,320,465
Michigan,Emmet County,18,933,331,602
Michigan,Genesee County,0,412895,198836,214059
Michigan,Genesee County,1,24826,12769,12057
Michigan,Genesee County,2,26239,13521,12718
Michigan,Genesee County,3,28094,14337,13757
Michigan,Genesee County,4,27740,14191,13549
Michigan,Genesee County,5,27633,13633,14000
Michigan,Genesee County,6,23806,11590,12216
Michigan,Genesee County,7,24054,11441,12613
Michigan,Genesee County,8,23726,11415,12311
Michigan,Genesee County,9,26519,12709,13810
Michigan,Genesee County,10,27454,13373,14081
Michigan,Genesee County,11,30841,14675,16166
Michigan,Genesee County,12,31282,15053,16229
Michigan,Genesee County,13,25930,12238,13692
Michigan,Genesee County,14,21247,9870,11377
Michigan,Genesee County,15,15269,7050,8219
Michigan,Genesee County,16,11339,4733,6606
Michigan,Genesee County,17,8608,3418,5190
Michigan,Genesee County,18,8288,2820,5468
Michigan,Gladwin County,0,25411,12794,12617
Michigan,Gladwin County,1,1201,687,514
Michigan,Gladwin County,2,1254,669,585
Michigan,Gladwin County,3,1452,737,715
Michigan,Gladwin County,4,1458,747,711
Michigan,Gladwin County,5,1197,628,569
Michigan,Gladwin County,6,1090,538,552
Michigan,Gladwin County,7,1153,608,545
Michigan,Gladwin County,8,1159,588,571
Michigan,Gladwin County,9,1377,690,687
Michigan,Gladwin County,10,1606,816,790
Michigan,Gladwin County,11,1890,979,911
Michigan,Gladwin County,12,2066,1005,1061
Michigan,Gladwin County,13,2122,1020,1102
Michigan,Gladwin County,14,2065,1039,1026
Michigan,Gladwin County,15,1704,850,854
Michigan,Gladwin County,16,1244,622,622
Michigan,Gladwin County,17,755,345,410
Michigan,Gladwin County,18,618,226,392
Michigan,Gogebic County,0,15737,8562,7175
Michigan,Gogebic County,1,612,331,281
Michigan,Gogebic County,2,715,365,350
Michigan,Gogebic County,3,685,352,333
Michigan,Gogebic County,4,851,462,389
Michigan,Gogebic County,5,921,580,341
Michigan,Gogebic County,6,911,559,352
Michigan,Gogebic County,7,859,541,318
Michigan,Gogebic County,8,796,500,296
Michigan,Gogebic County,9,942,545,397
Michigan,Gogebic County,10,1013,579,434
Michigan,Gogebic County,11,1229,628,601
Michigan,Gogebic County,12,1286,699,587
Michigan,Gogebic County,13,1318,711,607
Michigan,Gogebic County,14,1100,590,510
Michigan,Gogebic County,15,818,405,413
Michigan,Gogebic County,16,608,292,316
Michigan,Gogebic County,17,484,220,264
Michigan,Gogebic County,18,589,203,386
Michigan,Grand Traverse County,0,90782,44806,45976
Michigan,Grand Traverse County,1,4882,2482,2400
Michigan,Grand Traverse County,2,5184,2633,2551
Michigan,Grand Traverse County,3,5547,2805,2742
Michigan,Grand Traverse County,4,5289,2724,2565
Michigan,Grand Traverse County,5,5334,2793,2541
Michigan,Grand Traverse County,6,5652,2892,2760
Michigan,Grand Traverse County,7,5945,3087,2858
Michigan,Grand Traverse County,8,5247,2701,2546
Michigan,Grand Traverse County,9,5609,2870,2739
Michigan,Grand Traverse County,10,5825,2937,2888
Michigan,Grand Traverse County,11,7024,3434,3590
Michigan,Grand Traverse County,12,7161,3472,3689
Michigan,Grand Traverse County,13,6541,3183,3358
Michigan,Grand Traverse County,14,5313,2534,2779
Michigan,Grand Traverse County,15,3641,1695,1946
Michigan,Grand Traverse County,16,2485,1110,1375
Michigan,Grand Traverse County,17,1924,793,1131
Michigan,Grand Traverse County,18,2179,661,1518
Michigan,Gratiot County,0,41665,22217,19448
Michigan,Gratiot County,1,2155,1119,1036
Michigan,Gratiot County,2,2300,1144,1156
Michigan,Gratiot County,3,2513,1317,1196
Michigan,Gratiot County,4,2944,1505,1439
Michigan,Gratiot County,5,3360,1956,1404
Michigan,Gratiot County,6,2642,1630,1012
Michigan,Gratiot County,7,2645,1568,1077
Michigan,Gratiot County,8,2549,1502,1047
Michigan,Gratiot County,9,2660,1548,1112
Michigan,Gratiot County,10,2833,1598,1235
Michigan,Gratiot County,11,3055,1652,1403
Michigan,Gratiot County,12,2752,1433,1319
Michigan,Gratiot County,13,2410,1171,1239
Michigan,Gratiot County,14,2042,1021,1021
Michigan,Gratiot County,15,1609,756,853
Michigan,Gratiot County,16,1190,520,670
Michigan,Gratiot County,17,884,379,505
Michigan,Gratiot County,18,1122,398,724
Michigan,Hillsdale County,0,45830,22863,22967
Michigan,Hillsdale County,1,2520,1257,1263
Michigan,Hillsdale County,2,2754,1435,1319
Michigan,Hillsdale County,3,3024,1545,1479
Michigan,Hillsdale County,4,3294,1690,1604
Michigan,Hillsdale County,5,3075,1548,1527
Michigan,Hillsdale County,6,2407,1248,1159
Michigan,Hillsdale County,7,2378,1203,1175
Michigan,Hillsdale County,8,2430,1193,1237
Michigan,Hillsdale County,9,2731,1404,1327
Michigan,Hillsdale County,10,2809,1424,1385
Michigan,Hillsdale County,11,3443,1749,1694
Michigan,Hillsdale County,12,3645,1811,1834
Michigan,Hillsdale County,13,3228,1652,1576
Michigan,Hillsdale County,14,2672,1259,1413
Michigan,Hillsdale County,15,2072,1044,1028
Michigan,Hillsdale County,16,1444,692,752
Michigan,Hillsdale County,17,1000,395,605
Michigan,Hillsdale County,18,904,314,590
Michigan,Houghton County,0,36495,19775,16720
Michigan,Houghton County,1,1932,1047,885
Michigan,Houghton County,2,2117,1080,1037
Michigan,Houghton County,3,2120,1056,1064
Michigan,Houghton County,4,3691,2235,1456
Michigan,Houghton County,5,5407,3616,1791
Michigan,Houghton County,6,1912,1118,794
Michigan,Houghton County,7,1863,972,891
Michigan,Houghton County,8,1643,824,819
Michigan,Houghton County,9,1663,859,804
Michigan,Houghton County,10,1756,920,836
Michigan,Houghton County,11,2126,1065,1061
Michigan,Houghton County,12,2206,1109,1097
Michigan,Houghton County,13,2190,1135,1055
Michigan,Houghton County,14,1837,910,927
Michigan,Houghton County,15,1421,693,728
Michigan,Houghton County,16,1069,523,546
Michigan,Houghton County,17,698,310,388
Michigan,Houghton County,18,844,303,541
Michigan,Huron County,0,32065,15861,16204
Michigan,Huron County,1,1502,764,738
Michigan,Huron County,2,1665,831,834
Michigan,Huron County,3,1865,944,921
Michigan,Huron County,4,1925,1000,925
Michigan,Huron County,5,1574,805,769
Michigan,Huron County,6,1423,739,684
Michigan,Huron County,7,1588,851,737
Michigan,Huron County,8,1452,752,700
Michigan,Huron County,9,1705,843,862
Michigan,Huron County,10,2056,1043,1013
Michigan,Huron County,11,2468,1239,1229
Michigan,Huron County,12,2754,1373,1381
Michigan,Huron County,13,2573,1303,1270
Michigan,Huron County,14,2212,1092,1120
Michigan,Huron County,15,1822,857,965
Michigan,Huron County,16,1397,644,753
Michigan,Huron County,17,1009,403,606
Michigan,Huron County,18,1075,378,697
Michigan,Ingham County,0,284582,138130,146452
Michigan,Ingham County,1,16154,7976,8178
Michigan,Ingham County,2,15816,8053,7763
Michigan,Ingham County,3,15925,8213,7712
Michigan,Ingham County,4,26497,12963,13534
Michigan,Ingham County,5,40961,20273,20688
Michigan,Ingham County,6,20344,10350,9994
Michigan,Ingham County,7,18394,9200,9194
Michigan,Ingham County,8,15699,7890,7809
Michigan,Ingham County,9,15250,7429,7821
Michigan,Ingham County,10,15424,7543,7881
Michigan,Ingham County,11,16924,8141,8783
Michigan,Ingham County,12,17511,8217,9294
Michigan,Ingham County,13,15747,7296,8451
Michigan,Ingham County,14,11951,5636,6315
Michigan,Ingham County,15,7949,3587,4362
Michigan,Ingham County,16,5171,2231,2940
Michigan,Ingham County,17,4059,1554,2505
Michigan,Ingham County,18,4806,1578,3228
Michigan,Ionia County,0,64294,34509,29785
Michigan,Ionia County,1,3655,1884,1771
Michigan,Ionia County,2,4222,2120,2102
Michigan,Ionia County,3,4353,2262,2091
Michigan,Ionia County,4,4332,2307,2025
Michigan,Ionia County,5,4514,2800,1714
Michigan,Ionia County,6,4302,2599,1703
Michigan,Ionia County,7,4331,2499,1832
Michigan,Ionia County,8,4151,2365,1786
Michigan,Ionia County,9,4456,2525,1931
Michigan,Ionia County,10,4549,2528,2021
Michigan,Ionia County,11,4811,2558,2253
Michigan,Ionia County,12,4506,2322,2184
Michigan,Ionia County,13,3776,1940,1836
Michigan,Ionia County,14,2922,1455,1467
Michigan,Ionia County,15,2103,1000,1103
Michigan,Ionia County,16,1443,655,788
Michigan,Ionia County,17,996,392,604
Michigan,Ionia County,18,872,298,574
Michigan,Iosco County,0,25420,12614,12806
Michigan,Iosco County,1,1156,596,560
Michigan,Iosco County,2,1108,537,571
Michigan,Iosco County,3,1254,646,608
Michigan,Iosco County,4,1256,660,596
Michigan,Iosco County,5,1132,596,536
Michigan,Iosco County,6,1115,564,551
Michigan,Iosco County,7,1109,558,551
Michigan,Iosco County,8,1044,513,531
Michigan,Iosco County,9,1192,608,584
Michigan,Iosco County,10,1519,775,744
Michigan,Iosco County,11,1915,913,1002
Michigan,Iosco County,12,2271,1161,1110
Michigan,Iosco County,13,2256,1117,1139
Michigan,Iosco County,14,2196,1073,1123
Michigan,Iosco County,15,1798,895,903
Michigan,Iosco County,16,1358,658,700
Michigan,Iosco County,17,908,424,484
Michigan,Iosco County,18,833,320,513
Michigan,Iron County,0,11387,5627,5760
Michigan,Iron County,1,478,224,254
Michigan,Iron County,2,515,251,264
Michigan,Iron County,3,520,279,241
Michigan,Iron County,4,569,279,290
Michigan,Iron County,5,466,244,222
Michigan,Iron County,6,414,205,209
Michigan,Iron County,7,504,245,259
Michigan,Iron County,8,485,269,216
Michigan,Iron County,9,489,242,247
Michigan,Iron County,10,619,324,295
Michigan,Iron County,11,903,447,456
Michigan,Iron County,12,1080,540,540
Michigan,Iron County,13,1130,589,541
Michigan,Iron County,14,938,490,448
Michigan,Iron County,15,740,375,365
Michigan,Iron County,16,509,252,257
Michigan,Iron County,17,425,165,260
Michigan,Iron County,18,603,207,396
Michigan,Isabella County,0,70616,34308,36308
Michigan,Isabella County,1,3287,1646,1641
Michigan,Isabella County,2,3501,1789,1712
Michigan,Isabella County,3,3439,1723,1716
Michigan,Isabella County,4,8143,3693,4450
Michigan,Isabella County,5,14784,7020,7764
Michigan,Isabella County,6,4879,2615,2264
Michigan,Isabella County,7,3825,2011,1814
Michigan,Isabella County,8,3313,1689,1624
Michigan,Isabella County,9,3149,1576,1573
Michigan,Isabella County,10,3431,1693,1738
Michigan,Isabella County,11,3788,1903,1885
Michigan,Isabella County,12,3866,1831,2035
Michigan,Isabella County,13,3453,1697,1756
Michigan,Isabella County,14,2549,1234,1315
Michigan,Isabella County,15,1864,887,977
Michigan,Isabella County,16,1347,606,741
Michigan,Isabella County,17,964,387,577
Michigan,Isabella County,18,1034,308,726
Michigan,Jackson County,0,159741,81744,77997
Michigan,Jackson County,1,8787,4623,4164
Michigan,Jackson County,2,9686,5075,4611
Michigan,Jackson County,3,10374,5305,5069
Michigan,Jackson County,4,10679,5496,5183
Michigan,Jackson County,5,10850,5791,5059
Michigan,Jackson County,6,9570,5118,4452
Michigan,Jackson County,7,9345,5014,4331
Michigan,Jackson County,8,9254,5104,4150
Michigan,Jackson County,9,10216,5483,4733
Michigan,Jackson County,10,10933,5850,5083
Michigan,Jackson County,11,12215,6320,5895
Michigan,Jackson County,12,11901,5924,5977
Michigan,Jackson County,13,10447,5193,5254
Michigan,Jackson County,14,8317,4054,4263
Michigan,Jackson County,15,6040,2867,3173
Michigan,Jackson County,16,4276,1927,2349
Michigan,Jackson County,17,3274,1371,1903
Michigan,Jackson County,18,3577,1229,2348
Michigan,Kalamazoo County,0,258818,126782,132036
Michigan,Kalamazoo County,1,15401,7809,7592
Michigan,Kalamazoo County,2,16046,8312,7734
Michigan,Kalamazoo County,3,15864,8184,7680
Michigan,Kalamazoo County,4,18963,9481,9482
Michigan,Kalamazoo County,5,33006,16437,16569
Michigan,Kalamazoo County,6,16926,8883,8043
Michigan,Kalamazoo County,7,16578,8281,8297
Michigan,Kalamazoo County,8,14696,7290,7406
Michigan,Kalamazoo County,9,14780,7237,7543
Michigan,Kalamazoo County,10,14519,7212,7307
Michigan,Kalamazoo County,11,16188,7821,8367
Michigan,Kalamazoo County,12,16336,7894,8442
Michigan,Kalamazoo County,13,14567,6927,7640
Michigan,Kalamazoo County,14,11341,5316,6025
Michigan,Kalamazoo County,15,8208,3708,4500
Michigan,Kalamazoo County,16,5786,2552,3234
Michigan,Kalamazoo County,17,4375,1761,2614
Michigan,Kalamazoo County,18,5238,1677,3561
Michigan,Kalkaska County,0,17394,8843,8551
Michigan,Kalkaska County,1,961,492,469
Michigan,Kalkaska County,2,1048,523,525
Michigan,Kalkaska County,3,1123,576,547
Michigan,Kalkaska County,4,990,532,458
Michigan,Kalkaska County,5,863,448,415
Michigan,Kalkaska County,6,912,486,426
Michigan,Kalkaska County,7,955,470,485
Michigan,Kalkaska County,8,936,466,470
Michigan,Kalkaska County,9,1050,557,493
Michigan,Kalkaska County,10,1131,579,552
Michigan,Kalkaska County,11,1361,672,689
Michigan,Kalkaska County,12,1418,703,715
Michigan,Kalkaska County,13,1344,711,633
Michigan,Kalkaska County,14,1172,594,578
Michigan,Kalkaska County,15,902,442,460
Michigan,Kalkaska County,16,591,307,284
Michigan,Kalkaska County,17,364,175,189
Michigan,Kalkaska County,18,273,110,163
Michigan,Kent County,0,629237,309279,319958
Michigan,Kent County,1,44149,22609,21540
Michigan,Kent County,2,44237,22733,21504
Michigan,Kent County,3,43629,22264,21365
Michigan,Kent County,4,42683,21863,20820
Michigan,Kent County,5,45144,22423,22721
Michigan,Kent County,6,50216,24773,25443
Michigan,Kent County,7,44995,22574,22421
Michigan,Kent County,8,38891,19264,19627
Michigan,Kent County,9,38433,19068,19365
Michigan,Kent County,10,39721,19566,20155
Michigan,Kent County,11,43841,21634,22207
Michigan,Kent County,12,41708,20413,21295
Michigan,Kent County,13,34605,16804,17801
Michigan,Kent County,14,25164,11847,13317
Michigan,Kent County,15,17372,7869,9503
Michigan,Kent County,16,12813,5612,7201
Michigan,Kent County,17,9898,3934,5964
Michigan,Kent County,18,11738,4029,7709
Michigan,Keweenaw County,0,2217,1138,1079
Michigan,Keweenaw County,1,84,48,36
Michigan,Keweenaw County,2,106,57,49
Michigan,Keweenaw County,3,127,59,68
Michigan,Keweenaw County,4,107,61,46
Michigan,Keweenaw County,5,82,44,38
Michigan,Keweenaw County,6,67,35,32
Michigan,Keweenaw County,7,86,41,45
Michigan,Keweenaw County,8,105,56,49
Michigan,Keweenaw County,9,99,53,46
Michigan,Keweenaw County,10,93,46,47
Michigan,Keweenaw County,11,169,85,84
Michigan,Keweenaw County,12,190,93,97
Michigan,Keweenaw County,13,218,104,114
Michigan,Keweenaw County,14,233,136,97
Michigan,Keweenaw County,15,185,104,81
Michigan,Keweenaw County,16,131,62,69
Michigan,Keweenaw County,17,89,43,46
Michigan,Keweenaw County,18,46,11,35
Michigan,Lake County,0,11341,5762,5579
Michigan,Lake County,1,395,193,202
Michigan,Lake County,2,556,269,287
Michigan,Lake County,3,562,270,292
Michigan,Lake County,4,590,304,286
Michigan,Lake County,5,450,249,201
Michigan,Lake County,6,441,231,210
Michigan,Lake County,7,488,234,254
Michigan,Lake County,8,460,246,214
Michigan,Lake County,9,646,341,305
Michigan,Lake County,10,657,329,328
Michigan,Lake County,11,935,455,480
Michigan,Lake County,12,1040,517,523
Michigan,Lake County,13,1152,580,572
Michigan,Lake County,14,1031,544,487
Michigan,Lake County,15,802,425,377
Michigan,Lake County,16,574,310,264
Michigan,Lake County,17,329,175,154
Michigan,Lake County,18,233,90,143
Michigan,Lapeer County,0,88153,44650,43503
Michigan,Lapeer County,1,4220,2187,2033
Michigan,Lapeer County,2,5059,2609,2450
Michigan,Lapeer County,3,6049,3092,2957
Michigan,Lapeer County,4,6281,3395,2886
Michigan,Lapeer County,5,5203,2779,2424
Michigan,Lapeer County,6,4215,2249,1966
Michigan,Lapeer County,7,4499,2257,2242
Michigan,Lapeer County,8,4683,2389,2294
Michigan,Lapeer County,9,5693,2831,2862
Michigan,Lapeer County,10,6820,3438,3382
Michigan,Lapeer County,11,7644,3879,3765
Michigan,Lapeer County,12,7613,3902,3711
Michigan,Lapeer County,13,6130,3094,3036
Michigan,Lapeer County,14,4917,2440,2477
Michigan,Lapeer County,15,3713,1831,1882
Michigan,Lapeer County,16,2399,1137,1262
Michigan,Lapeer County,17,1543,661,882
Michigan,Lapeer County,18,1472,480,992
Michigan,Leelanau County,0,21915,10784,11131
Michigan,Leelanau County,1,822,408,414
Michigan,Leelanau County,2,1024,501,523
Michigan,Leelanau County,3,1145,607,538
Michigan,Leelanau County,4,1230,640,590
Michigan,Leelanau County,5,1046,566,480
Michigan,Leelanau County,6,882,452,430
Michigan,Leelanau County,7,899,460,439
Michigan,Leelanau County,8,850,424,426
Michigan,Leelanau County,9,992,503,489
Michigan,Leelanau County,10,1136,545,591
Michigan,Leelanau County,11,1650,758,892
Michigan,Leelanau County,12,1964,969,995
Michigan,Leelanau County,13,2198,1047,1151
Michigan,Leelanau County,14,1877,933,944
Michigan,Leelanau County,15,1494,741,753
Michigan,Leelanau County,16,1078,526,552
Michigan,Leelanau County,17,766,356,410
Michigan,Leelanau County,18,862,348,514
Michigan,Lenawee County,0,99047,50143,48904
Michigan,Lenawee County,1,5509,2802,2707
Michigan,Lenawee County,2,5905,3078,2827
Michigan,Lenawee County,3,6204,3217,2987
Michigan,Lenawee County,4,6939,3643,3296
Michigan,Lenawee County,5,6619,3577,3042
Michigan,Lenawee County,6,5470,2953,2517
Michigan,Lenawee County,7,5610,3032,2578
Michigan,Lenawee County,8,5669,2992,2677
Michigan,Lenawee County,9,6431,3359,3072
Michigan,Lenawee County,10,6508,3353,3155
Michigan,Lenawee County,11,7386,3694,3692
Michigan,Lenawee County,12,7427,3757,3670
Michigan,Lenawee County,13,6766,3303,3463
Michigan,Lenawee County,14,5701,2798,2903
Michigan,Lenawee County,15,4034,1855,2179
Michigan,Lenawee County,16,2735,1246,1489
Michigan,Lenawee County,17,2038,776,1262
Michigan,Lenawee County,18,2096,708,1388
Michigan,Livingston County,0,185596,92883,92713
Michigan,Livingston County,1,9248,4765,4483
Michigan,Livingston County,2,11130,5698,5432
Michigan,Livingston County,3,13621,7021,6600
Michigan,Livingston County,4,13410,7000,6410
Michigan,Livingston County,5,10493,5572,4921
Michigan,Livingston County,6,8972,4623,4349
Michigan,Livingston County,7,9687,4837,4850
Michigan,Livingston County,8,10007,5003,5004
Michigan,Livingston County,9,12585,6174,6411
Michigan,Livingston County,10,15003,7441,7562
Michigan,Livingston County,11,16498,8257,8241
Michigan,Livingston County,12,15213,7657,7556
Michigan,Livingston County,13,12492,6124,6368
Michigan,Livingston County,14,9764,4849,4915
Michigan,Livingston County,15,7210,3508,3702
Michigan,Livingston County,16,4352,2067,2285
Michigan,Livingston County,17,2820,1183,1637
Michigan,Livingston County,18,3091,1104,1987
Michigan,Luce County,0,6426,3761,2665
Michigan,Luce County,1,268,138,130
Michigan,Luce County,2,289,148,141
Michigan,Luce County,3,304,162,142
Michigan,Luce County,4,319,175,144
Michigan,Luce County,5,379,277,102
Michigan,Luce County,6,350,250,100
Michigan,Luce County,7,465,326,139
Michigan,Luce County,8,428,301,127
Michigan,Luce County,9,454,298,156
Michigan,Luce County,10,424,268,156
Michigan,Luce County,11,471,291,180
Michigan,Luce County,12,549,296,253
Michigan,Luce County,13,434,220,214
Michigan,Luce County,14,383,214,169
Michigan,Luce County,15,335,149,186
Michigan,Luce County,16,262,125,137
Michigan,Luce County,17,161,65,96
Michigan,Luce County,18,151,58,93
Michigan,Mackinac County,0,11042,5675,5367
Michigan,Mackinac County,1,421,244,177
Michigan,Mackinac County,2,492,278,214
Michigan,Mackinac County,3,586,313,273
Michigan,Mackinac County,4,576,310,266
Michigan,Mackinac County,5,483,257,226
Michigan,Mackinac County,6,483,246,237
Michigan,Mackinac County,7,481,247,234
Michigan,Mackinac County,8,516,254,262
Michigan,Mackinac County,9,618,325,293
Michigan,Mackinac County,10,663,353,310
Michigan,Mackinac County,11,911,463,448
Michigan,Mackinac County,12,973,477,496
Michigan,Mackinac County,13,1027,513,514
Michigan,Mackinac County,14,859,453,406
Michigan,Mackinac County,15,761,395,366
Michigan,Mackinac County,16,523,266,257
Michigan,Mackinac County,17,336,160,176
Michigan,Mackinac County,18,333,121,212
Michigan,Macomb County,0,860112,418341,441771
Michigan,Macomb County,1,46612,23717,22895
Michigan,Macomb County,2,50925,26071,24854
Michigan,Macomb County,3,55580,28576,27004
Michigan,Macomb County,4,54049,27989,26060
Michigan,Macomb County,5,54990,27671,27319
Michigan,Macomb County,6,54132,27032,27100
Michigan,Macomb County,7,51868,25618,26250
Michigan,Macomb County,8,51746,25454,26292
Michigan,Macomb County,9,58799,28807,29992
Michigan,Macomb County,10,62624,30560,32064
Michigan,Macomb County,11,67178,33075,34103
Michigan,Macomb County,12,64638,31491,33147
Michigan,Macomb County,13,53017,25445,27572
Michigan,Macomb County,14,42515,19780,22735
Michigan,Macomb County,15,31319,14086,17233
Michigan,Macomb County,16,22654,9581,13073
Michigan,Macomb County,17,17567,6820,10747
Michigan,Macomb County,18,19899,6568,13331
Michigan,Manistee County,0,24420,12636,11784
Michigan,Manistee County,1,916,444,472
Michigan,Manistee County,2,1130,558,572
Michigan,Manistee County,3,1417,726,691
Michigan,Manistee County,4,1340,690,650
Michigan,Manistee County,5,1366,869,497
Michigan,Manistee County,6,1255,779,476
Michigan,Manistee County,7,1177,665,512
Michigan,Manistee County,8,1121,609,512
Michigan,Manistee County,9,1349,720,629
Michigan,Manistee County,10,1526,839,687
Michigan,Manistee County,11,1900,937,963
Michigan,Manistee County,12,2101,1025,1076
Michigan,Manistee County,13,2114,1067,1047
Michigan,Manistee County,14,1834,929,905
Michigan,Manistee County,15,1452,694,758
Michigan,Manistee County,16,1025,475,550
Michigan,Manistee County,17,701,350,351
Michigan,Manistee County,18,696,260,436
Michigan,Marquette County,0,67676,34121,33555
Michigan,Marquette County,1,3313,1694,1619
Michigan,Marquette County,2,3503,1763,1740
Michigan,Marquette County,3,3339,1678,1661
Michigan,Marquette County,4,4969,2450,2519
Michigan,Marquette County,5,7688,3881,3807
Michigan,Marquette County,6,4009,2143,1866
Michigan,Marquette County,7,4076,2171,1905
Michigan,Marquette County,8,3659,1888,1771
Michigan,Marquette County,9,3539,1888,1651
Michigan,Marquette County,10,3774,1938,1836
Michigan,Marquette County,11,4577,2296,2281
Michigan,Marquette County,12,5092,2524,2568
Michigan,Marquette County,13,4923,2504,2419
Michigan,Marquette County,14,3787,1954,1833
Michigan,Marquette County,15,2520,1255,1265
Michigan,Marquette County,16,1945,898,1047
Michigan,Marquette County,17,1364,599,765
Michigan,Marquette County,18,1599,597,1002
Michigan,Mason County,0,28824,14291,14533
Michigan,Mason County,1,1515,798,717
Michigan,Mason County,2,1667,850,817
Michigan,Mason County,3,1698,869,829
Michigan,Mason County,4,1653,898,755
Michigan,Mason County,5,1653,857,796
Michigan,Mason County,6,1421,723,698
Michigan,Mason County,7,1554,767,787
Michigan,Mason County,8,1415,706,709
Michigan,Mason County,9,1564,775,789
Michigan,Mason County,10,1712,866,846
Michigan,Mason County,11,2107,1014,1093
Michigan,Mason County,12,2421,1202,1219
Michigan,Mason County,13,2345,1154,1191
Michigan,Mason County,14,1970,985,985
Michigan,Mason County,15,1540,735,805
Michigan,Mason County,16,1132,547,585
Michigan,Mason County,17,686,289,397
Michigan,Mason County,18,771,256,515
Michigan,Mecosta County,0,43186,21632,21554
Michigan,Mecosta County,1,2084,1056,1028
Michigan,Mecosta County,2,2223,1115,1108
Michigan,Mecosta County,3,2410,1205,1205
Michigan,Mecosta County,4,4231,2104,2127
Michigan,Mecosta County,5,5852,3199,2653
Michigan,Mecosta County,6,2589,1390,1199
Michigan,Mecosta County,7,2070,1069,1001
Michigan,Mecosta County,8,1939,987,952
Michigan,Mecosta County,9,2014,968,1046
Michigan,Mecosta County,10,2219,1108,1111
Michigan,Mecosta County,11,2709,1338,1371
Michigan,Mecosta County,12,2805,1385,1420
Michigan,Mecosta County,13,2745,1343,1402
Michigan,Mecosta County,14,2382,1144,1238
Michigan,Mecosta County,15,1984,969,1015
Michigan,Mecosta County,16,1316,616,700
Michigan,Mecosta County,17,868,382,486
Michigan,Mecosta County,18,746,254,492
Michigan,Menominee County,0,23714,11992,11722
Michigan,Menominee County,1,1125,571,554
Michigan,Menominee County,2,1226,642,584
Michigan,Menominee County,3,1415,728,687
Michigan,Menominee County,4,1399,723,676
Michigan,Menominee County,5,1145,597,548
Michigan,Menominee County,6,1037,540,497
Michigan,Menominee County,7,1166,621,545
Michigan,Menominee County,8,1212,620,592
Michigan,Menominee County,9,1265,666,599
Michigan,Menominee County,10,1590,816,774
Michigan,Menominee County,11,1929,967,962
Michigan,Menominee County,12,2096,1079,1017
Michigan,Menominee County,13,1988,997,991
Michigan,Menominee County,14,1609,810,799
Michigan,Menominee County,15,1175,579,596
Michigan,Menominee County,16,907,446,461
Michigan,Menominee County,17,647,288,359
Michigan,Menominee County,18,783,302,481
Michigan,Midland County,0,83427,41057,42370
Michigan,Midland County,1,4324,2179,2145
Michigan,Midland County,2,4921,2470,2451
Michigan,Midland County,3,5555,2821,2734
Michigan,Midland County,4,5661,2966,2695
Michigan,Midland County,5,5455,2862,2593
Michigan,Midland County,6,4966,2584,2382
Michigan,Midland County,7,4809,2418,2391
Michigan,Midland County,8,4644,2330,2314
Michigan,Midland County,9,5101,2501,2600
Michigan,Midland County,10,5897,2897,3000
Michigan,Midland County,11,6752,3354,3398
Michigan,Midland County,12,6298,3134,3164
Michigan,Midland County,13,5355,2534,2821
Michigan,Midland County,14,4076,1948,2128
Michigan,Midland County,15,3210,1475,1735
Michigan,Midland County,16,2499,1116,1383
Michigan,Midland County,17,1844,729,1115
Michigan,Midland County,18,2060,739,1321
Michigan,Missaukee County,0,15037,7636,7401
Michigan,Missaukee County,1,919,471,448
Michigan,Missaukee County,2,923,474,449
Michigan,Missaukee County,3,1001,526,475
Michigan,Missaukee County,4,961,518,443
Michigan,Missaukee County,5,826,428,398
Michigan,Missaukee County,6,813,407,406
Michigan,Missaukee County,7,804,413,391
Michigan,Missaukee County,8,705,351,354
Michigan,Missaukee County,9,830,416,414
Michigan,Missaukee County,10,945,486,459
Michigan,Missaukee County,11,1167,590,577
Michigan,Missaukee County,12,1203,625,578
Michigan,Missaukee County,13,1064,550,514
Michigan,Missaukee County,14,953,475,478
Michigan,Missaukee County,15,696,373,323
Michigan,Missaukee County,16,542,239,303
Michigan,Missaukee County,17,346,169,177
Michigan,Missaukee County,18,339,125,214
Michigan,Monroe County,0,149824,73973,75851
Michigan,Monroe County,1,8035,4069,3966
Michigan,Monroe County,2,8892,4503,4389
Michigan,Monroe County,3,10128,5130,4998
Michigan,Monroe County,4,9974,5141,4833
Michigan,Monroe County,5,9165,4679,4486
Michigan,Monroe County,6,8220,4221,3999
Michigan,Monroe County,7,8317,4128,4189
Michigan,Monroe County,8,8511,4174,4337
Michigan,Monroe County,9,9615,4758,4857
Michigan,Monroe County,10,10707,5302,5405
Michigan,Monroe County,11,12236,6120,6116
Michigan,Monroe County,12,12164,6089,6075
Michigan,Monroe County,13,10280,5164,5116
Michigan,Monroe County,14,7942,3907,4035
Michigan,Monroe County,15,5734,2721,3013
Michigan,Monroe County,16,3979,1726,2253
Michigan,Monroe County,17,2866,1153,1713
Michigan,Monroe County,18,3059,988,2071
Michigan,Montcalm County,0,62893,32411,30482
Michigan,Montcalm County,1,3552,1822,1730
Michigan,Montcalm County,2,3940,2025,1915
Michigan,Montcalm County,3,4243,2164,2079
Michigan,Montcalm County,4,4137,2194,1943
Michigan,Montcalm County,5,3749,2011,1738
Michigan,Montcalm County,6,3559,1909,1650
Michigan,Montcalm County,7,3877,2067,1810
Michigan,Montcalm County,8,3771,2039,1732
Michigan,Montcalm County,9,4131,2229,1902
Michigan,Montcalm County,10,4394,2339,2055
Michigan,Montcalm County,11,4750,2547,2203
Michigan,Montcalm County,12,4747,2430,2317
Michigan,Montcalm County,13,3950,1995,1955
Michigan,Montcalm County,14,3290,1635,1655
Michigan,Montcalm County,15,2550,1217,1333
Michigan,Montcalm County,16,1892,865,1027
Michigan,Montcalm County,17,1195,496,699
Michigan,Montcalm County,18,1166,427,739
Michigan,Montmorency County,0,9300,4745,4555
Michigan,Montmorency County,1,338,200,138
Michigan,Montmorency County,2,370,208,162
Michigan,Montmorency County,3,429,240,189
Michigan,Montmorency County,4,428,217,211
Michigan,Montmorency County,5,350,162,188
Michigan,Montmorency County,6,328,182,146
Michigan,Montmorency County,7,356,178,178
Michigan,Montmorency County,8,380,199,181
Michigan,Montmorency County,9,424,229,195
Michigan,Montmorency County,10,526,270,256
Michigan,Montmorency County,11,703,328,375
Michigan,Montmorency County,12,955,479,476
Michigan,Montmorency County,13,975,501,474
Michigan,Montmorency County,14,886,464,422
Michigan,Montmorency County,15,701,350,351
Michigan,Montmorency County,16,513,253,260
Michigan,Montmorency County,17,330,165,165
Michigan,Montmorency County,18,308,120,188
Michigan,Muskegon County,0,172344,85688,86656
Michigan,Muskegon County,1,10596,5369,5227
Michigan,Muskegon County,2,11330,5812,5518
Michigan,Muskegon County,3,11783,5936,5847
Michigan,Muskegon County,4,11407,5845,5562
Michigan,Muskegon County,5,11385,5862,5523
Michigan,Muskegon County,6,10588,5451,5137
Michigan,Muskegon County,7,10916,5497,5419
Michigan,Muskegon County,8,10223,5247,4976
Michigan,Muskegon County,9,10338,5424,4914
Michigan,Muskegon County,10,11002,5625,5377
Michigan,Muskegon County,11,12876,6387,6489
Michigan,Muskegon County,12,12762,6346,6416
Michigan,Muskegon County,13,11130,5426,5704
Michigan,Muskegon County,14,8694,4113,4581
Michigan,Muskegon County,15,6180,2903,3277
Michigan,Muskegon County,16,4419,1952,2467
Michigan,Muskegon County,17,3264,1305,1959
Michigan,Muskegon County,18,3451,1188,2263
Michigan,Newaygo County,0,47900,24110,23790
Michigan,Newaygo County,1,2754,1408,1346
Michigan,Newaygo County,2,3040,1522,1518
Michigan,Newaygo County,3,3216,1671,1545
Michigan,Newaygo County,4,3175,1682,1493
Michigan,Newaygo County,5,2786,1490,1296
Michigan,Newaygo County,6,2562,1286,1276
Michigan,Newaygo County,7,2549,1250,1299
Michigan,Newaygo County,8,2513,1265,1248
Michigan,Newaygo County,9,2691,1374,1317
Michigan,Newaygo County,10,3056,1492,1564
Michigan,Newaygo County,11,3895,1996,1899
Michigan,Newaygo County,12,3721,1831,1890
Michigan,Newaygo County,13,3363,1694,1669
Michigan,Newaygo County,14,2827,1476,1351
Michigan,Newaygo County,15,2174,1068,1106
Michigan,Newaygo County,16,1590,784,806
Michigan,Newaygo County,17,1046,488,558
Michigan,Newaygo County,18,942,333,609
Michigan,Oakland County,0,1237868,601601,636267
Michigan,Oakland County,1,68027,35099,32928
Michigan,Oakland County,2,73209,37331,35878
Michigan,Oakland County,3,80903,41261,39642
Michigan,Oakland County,4,79826,41150,38676
Michigan,Oakland County,5,73360,37217,36143
Michigan,Oakland County,6,74953,37516,37437
Michigan,Oakland County,7,76987,37989,38998
Michigan,Oakland County,8,74769,36643,38126
Michigan,Oakland County,9,85843,41583,44260
Michigan,Oakland County,10,90251,43789,46462
Michigan,Oakland County,11,98275,47671,50604
Michigan,Oakland County,12,95385,45812,49573
Michigan,Oakland County,13,79778,37872,41906
Michigan,Oakland County,14,63253,29658,33595
Michigan,Oakland County,15,44146,20479,23667
Michigan,Oakland County,16,29048,12608,16440
Michigan,Oakland County,17,22439,8872,13567
Michigan,Oakland County,18,27416,9051,18365
Michigan,Oceana County,0,26221,13203,13018
Michigan,Oceana County,1,1632,795,837
Michigan,Oceana County,2,1799,960,839
Michigan,Oceana County,3,1778,903,875
Michigan,Oceana County,4,1680,873,807
Michigan,Oceana County,5,1443,768,675
Michigan,Oceana County,6,1315,669,646
Michigan,Oceana County,7,1362,684,678
Michigan,Oceana County,8,1319,648,671
Michigan,Oceana County,9,1389,706,683
Michigan,Oceana County,10,1629,820,809
Michigan,Oceana County,11,2054,1057,997
Michigan,Oceana County,12,1958,1005,953
Michigan,Oceana County,13,1854,915,939
Michigan,Oceana County,14,1648,817,831
Michigan,Oceana County,15,1321,652,669
Michigan,Oceana County,16,911,445,466
Michigan,Oceana County,17,587,267,320
Michigan,Oceana County,18,542,219,323
Michigan,Ogemaw County,0,21039,10445,10594
Michigan,Ogemaw County,1,981,529,452
Michigan,Ogemaw County,2,1042,526,516
Michigan,Ogemaw County,3,1146,572,574
Michigan,Ogemaw County,4,1203,618,585
Michigan,Ogemaw County,5,1075,543,532
Michigan,Ogemaw County,6,913,457,456
Michigan,Ogemaw County,7,1008,519,489
Michigan,Ogemaw County,8,995,479,516
Michigan,Ogemaw County,9,1076,536,540
Michigan,Ogemaw County,10,1136,552,584
Michigan,Ogemaw County,11,1645,798,847
Michigan,Ogemaw County,12,1904,957,947
Michigan,Ogemaw County,13,1796,888,908
Michigan,Ogemaw County,14,1615,795,820
Michigan,Ogemaw County,15,1403,710,693
Michigan,Ogemaw County,16,990,501,489
Michigan,Ogemaw County,17,555,272,283
Michigan,Ogemaw County,18,556,193,363
Michigan,Ontonagon County,0,6172,3150,3022
Michigan,Ontonagon County,1,151,87,64
Michigan,Ontonagon County,2,214,115,99
Michigan,Ontonagon County,3,273,137,136
Michigan,Ontonagon County,4,285,148,137
Michigan,Ontonagon County,5,180,93,87
Michigan,Ontonagon County,6,164,88,76
Michigan,Ontonagon County,7,204,101,103
Michigan,Ontonagon County,8,215,116,99
Michigan,Ontonagon County,9,276,135,141
Michigan,Ontonagon County,10,385,191,194
Michigan,Ontonagon County,11,545,272,273
Michigan,Ontonagon County,12,631,319,312
Michigan,Ontonagon County,13,668,347,321
Michigan,Ontonagon County,14,633,341,292
Michigan,Ontonagon County,15,532,273,259
Michigan,Ontonagon County,16,410,213,197
Michigan,Ontonagon County,17,202,103,99
Michigan,Ontonagon County,18,204,71,133
Michigan,Osceola County,0,23169,11720,11449
Michigan,Osceola County,1,1317,677,640
Michigan,Osceola County,2,1460,778,682
Michigan,Osceola County,3,1609,853,756
Michigan,Osceola County,4,1559,815,744
Michigan,Osceola County,5,1263,673,590
Michigan,Osceola County,6,1201,611,590
Michigan,Osceola County,7,1219,605,614
Michigan,Osceola County,8,1181,599,582
Michigan,Osceola County,9,1335,669,666
Michigan,Osceola County,10,1428,772,656
Michigan,Osceola County,11,1728,861,867
Michigan,Osceola County,12,1798,873,925
Michigan,Osceola County,13,1636,837,799
Michigan,Osceola County,14,1437,712,725
Michigan,Osceola County,15,1143,560,583
Michigan,Osceola County,16,876,427,449
Michigan,Osceola County,17,553,238,315
Michigan,Osceola County,18,426,160,266
Michigan,Oscoda County,0,8371,4297,4074
Michigan,Oscoda County,1,378,237,141
Michigan,Oscoda County,2,441,230,211
Michigan,Oscoda County,3,472,269,203
Michigan,Oscoda County,4,461,232,229
Michigan,Oscoda County,5,370,192,178
Michigan,Oscoda County,6,357,169,188
Michigan,Oscoda County,7,349,181,168
Michigan,Oscoda County,8,305,152,153
Michigan,Oscoda County,9,404,211,193
Michigan,Oscoda County,10,441,220,221
Michigan,Oscoda County,11,656,333,323
Michigan,Oscoda County,12,791,396,395
Michigan,Oscoda County,13,759,381,378
Michigan,Oscoda County,14,713,367,346
Michigan,Oscoda County,15,597,309,288
Michigan,Oscoda County,16,392,209,183
Michigan,Oscoda County,17,273,120,153
Michigan,Oscoda County,18,212,89,123
Michigan,Otsego County,0,24158,11948,12210
Michigan,Otsego County,1,1297,681,616
Michigan,Otsego County,2,1389,687,702
Michigan,Otsego County,3,1504,781,723
Michigan,Otsego County,4,1498,748,750
Michigan,Otsego County,5,1399,711,688
Michigan,Otsego County,6,1233,607,626
Michigan,Otsego County,7,1195,595,600
Michigan,Otsego County,8,1210,594,616
Michigan,Otsego County,9,1415,684,731
Michigan,Otsego County,10,1697,850,847
Michigan,Otsego County,11,1878,945,933
Michigan,Otsego County,12,1951,991,960
Michigan,Otsego County,13,1748,861,887
Michigan,Otsego County,14,1574,786,788
Michigan,Otsego County,15,1141,521,620
Michigan,Otsego County,16,863,419,444
Michigan,Otsego County,17,581,261,320
Michigan,Otsego County,18,585,226,359
Michigan,Ottawa County,0,276292,136311,139981
Michigan,Ottawa County,1,17490,9083,8407
Michigan,Ottawa County,2,19215,9899,9316
Michigan,Ottawa County,3,19844,10139,9705
Michigan,Ottawa County,4,23651,11459,12192
Michigan,Ottawa County,5,26002,12980,13022
Michigan,Ottawa County,6,15753,7911,7842
Michigan,Ottawa County,7,16802,8353,8449
Michigan,Ottawa County,8,16060,8061,7999
Michigan,Ottawa County,9,16392,8172,8220
Michigan,Ottawa County,10,17196,8561,8635
Michigan,Ottawa County,11,18864,9370,9494
Michigan,Ottawa County,12,17290,8540,8750
Michigan,Ottawa County,13,15188,7408,7780
Michigan,Ottawa County,14,11865,5707,6158
Michigan,Ottawa County,15,8749,4097,4652
Michigan,Ottawa County,16,6138,2810,3328
Michigan,Ottawa County,17,4558,1978,2580
Michigan,Ottawa County,18,5235,1783,3452
Michigan,Presque Isle County,0,13004,6479,6525
Michigan,Presque Isle County,1,470,227,243
Michigan,Presque Isle County,2,540,262,278
Michigan,Presque Isle County,3,663,318,345
Michigan,Presque Isle County,4,688,346,342
Michigan,Presque Isle County,5,531,281,250
Michigan,Presque Isle County,6,430,225,205
Michigan,Presque Isle County,7,529,264,265
Michigan,Presque Isle County,8,526,260,266
Michigan,Presque Isle County,9,628,322,306
Michigan,Presque Isle County,10,705,356,349
Michigan,Presque Isle County,11,1035,512,523
Michigan,Presque Isle County,12,1193,590,603
Michigan,Presque Isle County,13,1336,682,654
Michigan,Presque Isle County,14,1097,574,523
Michigan,Presque Isle County,15,915,458,457
Michigan,Presque Isle County,16,679,346,333
Michigan,Presque Isle County,17,513,246,267
Michigan,Presque Isle County,18,526,210,316
Michigan,Roscommon County,0,23955,11957,11998
Michigan,Roscommon County,1,896,443,453
Michigan,Roscommon County,2,1003,528,475
Michigan,Roscommon County,3,1056,546,510
Michigan,Roscommon County,4,1057,561,496
Michigan,Roscommon County,5,1005,519,486
Michigan,Roscommon County,6,906,418,488
Michigan,Roscommon County,7,890,453,437
Michigan,Roscommon County,8,908,436,472
Michigan,Roscommon County,9,1119,586,533
Michigan,Roscommon County,10,1348,665,683
Michigan,Roscommon County,11,1859,928,931
Michigan,Roscommon County,12,2288,1093,1195
Michigan,Roscommon County,13,2437,1237,1200
Michigan,Roscommon County,14,2380,1193,1187
Michigan,Roscommon County,15,1936,1015,921
Michigan,Roscommon County,16,1367,671,696
Michigan,Roscommon County,17,845,416,429
Michigan,Roscommon County,18,655,249,406
Michigan,Saginaw County,0,195012,94486,100526
Michigan,Saginaw County,1,11272,5891,5381
Michigan,Saginaw County,2,11501,5924,5577
Michigan,Saginaw County,3,12337,6223,6114
Michigan,Saginaw County,4,13621,6932,6689
Michigan,Saginaw County,5,14354,7148,7206
Michigan,Saginaw County,6,11834,5975,5859
Michigan,Saginaw County,7,10656,5308,5348
Michigan,Saginaw County,8,10318,5089,5229
Michigan,Saginaw County,9,11499,5510,5989
Michigan,Saginaw County,10,12415,6152,6263
Michigan,Saginaw County,11,13968,6739,7229
Michigan,Saginaw County,12,14568,6932,7636
Michigan,Saginaw County,13,12972,6101,6871
Michigan,Saginaw County,14,10652,5011,5641
Michigan,Saginaw County,15,8019,3684,4335
Michigan,Saginaw County,16,5800,2533,3267
Michigan,Saginaw County,17,4354,1721,2633
Michigan,Saginaw County,18,4872,1613,3259
Michigan,Sanilac County,0,41587,20627,20960
Michigan,Sanilac County,1,2217,1152,1065
Michigan,Sanilac County,2,2500,1255,1245
Michigan,Sanilac County,3,2792,1408,1384
Michigan,Sanilac County,4,2677,1348,1329
Michigan,Sanilac County,5,2216,1151,1065
Michigan,Sanilac County,6,2008,1006,1002
Michigan,Sanilac County,7,2089,1074,1015
Michigan,Sanilac County,8,2126,1065,1061
Michigan,Sanilac County,9,2421,1237,1184
Michigan,Sanilac County,10,2694,1291,1403
Michigan,Sanilac County,11,3260,1680,1580
Michigan,Sanilac County,12,3357,1683,1674
Michigan,Sanilac County,13,3117,1571,1546
Michigan,Sanilac County,14,2490,1199,1291
Michigan,Sanilac County,15,2049,977,1072
Michigan,Sanilac County,16,1576,712,864
Michigan,Sanilac County,17,1021,451,570
Michigan,Sanilac County,18,977,367,610
Michigan,Schoolcraft County,0,8171,4039,4132
Michigan,Schoolcraft County,1,366,175,191
Michigan,Schoolcraft County,2,395,202,193
Michigan,Schoolcraft County,3,422,221,201
Michigan,Schoolcraft County,4,490,253,237
Michigan,Schoolcraft County,5,360,180,180
Michigan,Schoolcraft County,6,302,153,149
Michigan,Schoolcraft County,7,340,183,157
Michigan,Schoolcraft County,8,379,187,192
Michigan,Schoolcraft County,9,445,217,228
Michigan,Schoolcraft County,10,514,261,253
Michigan,Schoolcraft County,11,696,319,377
Michigan,Schoolcraft County,12,740,353,387
Michigan,Schoolcraft County,13,755,392,363
Michigan,Schoolcraft County,14,636,330,306
Michigan,Schoolcraft County,15,465,241,224
Michigan,Schoolcraft County,16,359,165,194
Michigan,Schoolcraft County,17,263,114,149
Michigan,Schoolcraft County,18,244,93,151
Michigan,Shiawassee County,0,68933,34096,34837
Michigan,Shiawassee County,1,3566,1845,1721
Michigan,Shiawassee County,2,4040,2088,1952
Michigan,Shiawassee County,3,4695,2366,2329
Michigan,Shiawassee County,4,4933,2561,2372
Michigan,Shiawassee County,5,4298,2224,2074
Michigan,Shiawassee County,6,3622,1820,1802
Michigan,Shiawassee County,7,3721,1869,1852
Michigan,Shiawassee County,8,3863,1941,1922
Michigan,Shiawassee County,9,4350,2207,2143
Michigan,Shiawassee County,10,4938,2441,2497
Michigan,Shiawassee County,11,5608,2799,2809
Michigan,Shiawassee County,12,5354,2609,2745
Michigan,Shiawassee County,13,4627,2231,2396
Michigan,Shiawassee County,14,3778,1836,1942
Michigan,Shiawassee County,15,2817,1321,1496
Michigan,Shiawassee County,16,1991,906,1085
Michigan,Shiawassee County,17,1356,588,768
Michigan,Shiawassee County,18,1376,444,932
Michigan,Tuscola County,0,54000,27037,26963
Michigan,Tuscola County,1,2708,1382,1326
Michigan,Tuscola County,2,3097,1635,1462
Michigan,Tuscola County,3,3390,1771,1619
Michigan,Tuscola County,4,3560,1899,1661
Michigan,Tuscola County,5,3210,1615,1595
Michigan,Tuscola County,6,2806,1474,1332
Michigan,Tuscola County,7,2906,1476,1430
Michigan,Tuscola County,8,2886,1467,1419
Michigan,Tuscola County,9,3280,1668,1612
Michigan,Tuscola County,10,3607,1796,1811
Michigan,Tuscola County,11,4373,2225,2148
Michigan,Tuscola County,12,4388,2188,2200
Michigan,Tuscola County,13,3887,1942,1945
Michigan,Tuscola County,14,3202,1552,1650
Michigan,Tuscola County,15,2518,1200,1318
Michigan,Tuscola County,16,1814,848,966
Michigan,Tuscola County,17,1194,496,698
Michigan,Tuscola County,18,1174,403,771
Michigan,Van Buren County,0,75199,37208,37991
Michigan,Van Buren County,1,4780,2403,2377
Michigan,Van Buren County,2,4886,2429,2457
Michigan,Van Buren County,3,5230,2721,2509
Michigan,Van Buren County,4,5142,2692,2450
Michigan,Van Buren County,5,4276,2203,2073
Michigan,Van Buren County,6,3804,1924,1880
Michigan,Van Buren County,7,4319,2155,2164
Michigan,Van Buren County,8,4210,2082,2128
Michigan,Van Buren County,9,4533,2194,2339
Michigan,Van Buren County,10,4943,2472,2471
Michigan,Van Buren County,11,5783,2860,2923
Michigan,Van Buren County,12,5961,2933,3028
Michigan,Van Buren County,13,5291,2630,2661
Michigan,Van Buren County,14,4150,2026,2124
Michigan,Van Buren County,15,3058,1484,1574
Michigan,Van Buren County,16,2004,926,1078
Michigan,Van Buren County,17,1393,566,827
Michigan,Van Buren County,18,1436,508,928
Michigan,Washtenaw County,0,356874,176051,180823
Michigan,Washtenaw County,1,18753,9432,9321
Michigan,Washtenaw County,2,19311,9850,9461
Michigan,Washtenaw County,3,19985,10266,9719
Michigan,Washtenaw County,4,30379,15328,15051
Michigan,Washtenaw County,5,46652,23762,22890
Michigan,Washtenaw County,6,26586,13652,12934
Michigan,Washtenaw County,7,23768,11979,11789
Michigan,Washtenaw County,8,20483,10364,10119
Michigan,Washtenaw County,9,21236,10483,10753
Michigan,Washtenaw County,10,21940,10712,11228
Michigan,Washtenaw County,11,23093,11295,11798
Michigan,Washtenaw County,12,22092,10529,11563
Michigan,Washtenaw County,13,19718,9299,10419
Michigan,Washtenaw County,14,15417,7353,8064
Michigan,Washtenaw County,15,10414,4795,5619
Michigan,Washtenaw County,16,6617,2982,3635
Michigan,Washtenaw County,17,4826,2016,2810
Michigan,Washtenaw County,18,5604,1954,3650
Michigan,Wayne County,0,1764804,848544,916260
Michigan,Wayne County,1,115149,59139,56010
Michigan,Wayne County,2,115331,58749,56582
Michigan,Wayne County,3,120456,61420,59036
Michigan,Wayne County,4,117885,59841,58044
Michigan,Wayne County,5,130286,64441,65845
Michigan,Wayne County,6,116713,57049,59664
Michigan,Wayne County,7,106569,51071,55498
Michigan,Wayne County,8,103794,49289,54505
Michigan,Wayne County,9,116906,56281,60625
Michigan,Wayne County,10,117649,57551,60098
Michigan,Wayne County,11,126479,61560,64919
Michigan,Wayne County,12,127527,61005,66522
Michigan,Wayne County,13,106349,49660,56689
Michigan,Wayne County,14,80722,36849,43873
Michigan,Wayne County,15,55649,24595,31054
Michigan,Wayne County,16,39485,16173,23312
Michigan,Wayne County,17,31341,11794,19547
Michigan,Wayne County,18,36514,12077,24437
Michigan,Wexford County,0,32886,16413,16473
Michigan,Wexford County,1,2027,1018,1009
Michigan,Wexford County,2,2273,1151,1122
Michigan,Wexford County,3,2130,1065,1065
Michigan,Wexford County,4,1939,1027,912
Michigan,Wexford County,5,1892,980,912
Michigan,Wexford County,6,1835,943,892
Michigan,Wexford County,7,1918,965,953
Michigan,Wexford County,8,1725,829,896
Michigan,Wexford County,9,1912,988,924
Michigan,Wexford County,10,2134,1103,1031
Michigan,Wexford County,11,2519,1232,1287
Michigan,Wexford County,12,2541,1252,1289
Michigan,Wexford County,13,2263,1143,1120
Michigan,Wexford County,14,1868,953,915
Michigan,Wexford County,15,1495,697,798
Michigan,Wexford County,16,1003,485,518
Michigan,Wexford County,17,715,317,398
Michigan,Wexford County,18,697,265,432
Minnesota,Aitkin County,0,15771,7973,7798
Minnesota,Aitkin County,1,647,337,310
Minnesota,Aitkin County,2,797,422,375
Minnesota,Aitkin County,3,789,392,397
Minnesota,Aitkin County,4,788,401,387
Minnesota,Aitkin County,5,599,302,297
Minnesota,Aitkin County,6,534,260,274
Minnesota,Aitkin County,7,647,328,319
Minnesota,Aitkin County,8,616,317,299
Minnesota,Aitkin County,9,714,361,353
Minnesota,Aitkin County,10,839,420,419
Minnesota,Aitkin County,11,1213,612,601
Minnesota,Aitkin County,12,1363,711,652
Minnesota,Aitkin County,13,1484,749,735
Minnesota,Aitkin County,14,1491,759,732
Minnesota,Aitkin County,15,1352,689,663
Minnesota,Aitkin County,16,883,446,437
Minnesota,Aitkin County,17,529,268,261
Minnesota,Aitkin County,18,486,199,287
Minnesota,Anoka County,0,341864,171034,170830
Minnesota,Anoka County,1,21332,11085,10247
Minnesota,Anoka County,2,23350,11886,11464
Minnesota,Anoka County,3,24143,12363,11780
Minnesota,Anoka County,4,22386,11611,10775
Minnesota,Anoka County,5,20039,10199,9840
Minnesota,Anoka County,6,21483,10973,10510
Minnesota,Anoka County,7,23894,12001,11893
Minnesota,Anoka County,8,22459,11429,11030
Minnesota,Anoka County,9,23477,11909,11568
Minnesota,Anoka County,10,25434,12695,12739
Minnesota,Anoka County,11,28797,14488,14309
Minnesota,Anoka County,12,24824,12511,12313
Minnesota,Anoka County,13,19513,9483,10030
Minnesota,Anoka County,14,15011,7142,7869
Minnesota,Anoka County,15,10344,4968,5376
Minnesota,Anoka County,16,6689,2955,3734
Minnesota,Anoka County,17,4479,1911,2568
Minnesota,Anoka County,18,4210,1425,2785
Minnesota,Becker County,0,33259,16664,16595
Minnesota,Becker County,1,2105,986,1119
Minnesota,Becker County,2,2321,1174,1147
Minnesota,Becker County,3,2337,1192,1145
Minnesota,Becker County,4,2097,1070,1027
Minnesota,Becker County,5,1611,838,773
Minnesota,Becker County,6,1641,810,831
Minnesota,Becker County,7,1902,969,933
Minnesota,Becker County,8,1841,962,879
Minnesota,Becker County,9,1689,859,830
Minnesota,Becker County,10,1898,1002,896
Minnesota,Becker County,11,2352,1213,1139
Minnesota,Becker County,12,2578,1298,1280
Minnesota,Becker County,13,2461,1233,1228
Minnesota,Becker County,14,2121,1061,1060
Minnesota,Becker County,15,1536,783,753
Minnesota,Becker County,16,1145,549,596
Minnesota,Becker County,17,848,383,465
Minnesota,Becker County,18,776,282,494
Minnesota,Beltrami County,0,45664,22791,22873
Minnesota,Beltrami County,1,3540,1801,1739
Minnesota,Beltrami County,2,3331,1737,1594
Minnesota,Beltrami County,3,2988,1548,1440
Minnesota,Beltrami County,4,3516,1782,1734
Minnesota,Beltrami County,5,4567,2336,2231
Minnesota,Beltrami County,6,2880,1515,1365
Minnesota,Beltrami County,7,2827,1450,1377
Minnesota,Beltrami County,8,2395,1190,1205
Minnesota,Beltrami County,9,2225,1084,1141
Minnesota,Beltrami County,10,2282,1123,1159
Minnesota,Beltrami County,11,2869,1408,1461
Minnesota,Beltrami County,12,2986,1454,1532
Minnesota,Beltrami County,13,2689,1304,1385
Minnesota,Beltrami County,14,2157,1089,1068
Minnesota,Beltrami County,15,1495,716,779
Minnesota,Beltrami County,16,1187,563,624
Minnesota,Beltrami County,17,812,359,453
Minnesota,Beltrami County,18,918,332,586
Minnesota,Benton County,0,39506,19809,19697
Minnesota,Benton County,1,2706,1384,1322
Minnesota,Benton County,2,2817,1428,1389
Minnesota,Benton County,3,2723,1368,1355
Minnesota,Benton County,4,2305,1185,1120
Minnesota,Benton County,5,2611,1323,1288
Minnesota,Benton County,6,3156,1611,1545
Minnesota,Benton County,7,3125,1626,1499
Minnesota,Benton County,8,2500,1298,1202
Minnesota,Benton County,9,2361,1221,1140
Minnesota,Benton County,10,2557,1343,1214
Minnesota,Benton County,11,2776,1401,1375
Minnesota,Benton County,12,2410,1251,1159
Minnesota,Benton County,13,2113,1054,1059
Minnesota,Benton County,14,1600,766,834
Minnesota,Benton County,15,1205,561,644
Minnesota,Benton County,16,872,398,474
Minnesota,Benton County,17,718,288,430
Minnesota,Benton County,18,951,303,648
Minnesota,Big Stone County,0,5127,2505,2622
Minnesota,Big Stone County,1,313,145,168
Minnesota,Big Stone County,2,284,134,150
Minnesota,Big Stone County,3,283,142,141
Minnesota,Big Stone County,4,285,157,128
Minnesota,Big Stone County,5,244,125,119
Minnesota,Big Stone County,6,192,102,90
Minnesota,Big Stone County,7,269,146,123
Minnesota,Big Stone County,8,215,101,114
Minnesota,Big Stone County,9,233,117,116
Minnesota,Big Stone County,10,269,125,144
Minnesota,Big Stone County,11,424,229,195
Minnesota,Big Stone County,12,422,214,208
Minnesota,Big Stone County,13,378,198,180
Minnesota,Big Stone County,14,315,156,159
Minnesota,Big Stone County,15,270,116,154
Minnesota,Big Stone County,16,251,120,131
Minnesota,Big Stone County,17,234,99,135
Minnesota,Big Stone County,18,246,79,167
Minnesota,Blue Earth County,0,65385,32932,32453
Minnesota,Blue Earth County,1,3660,1922,1738
Minnesota,Blue Earth County,2,3783,1932,1851
Minnesota,Blue Earth County,3,3492,1847,1645
Minnesota,Blue Earth County,4,5485,2610,2875
Minnesota,Blue Earth County,5,10224,5289,4935
Minnesota,Blue Earth County,6,5061,2755,2306
Minnesota,Blue Earth County,7,4334,2286,2048
Minnesota,Blue Earth County,8,3503,1810,1693
Minnesota,Blue Earth County,9,3098,1601,1497
Minnesota,Blue Earth County,10,3285,1688,1597
Minnesota,Blue Earth County,11,3678,1825,1853
Minnesota,Blue Earth County,12,3873,1896,1977
Minnesota,Blue Earth County,13,3432,1724,1708
Minnesota,Blue Earth County,14,2559,1285,1274
Minnesota,Blue Earth County,15,1844,876,968
Minnesota,Blue Earth County,16,1435,633,802
Minnesota,Blue Earth County,17,1188,491,697
Minnesota,Blue Earth County,18,1451,462,989
Minnesota,Brown County,0,25292,12632,12660
Minnesota,Brown County,1,1396,744,652
Minnesota,Brown County,2,1551,862,689
Minnesota,Brown County,3,1591,854,737
Minnesota,Brown County,4,1675,868,807
Minnesota,Brown County,5,1759,872,887
Minnesota,Brown County,6,1283,681,602
Minnesota,Brown County,7,1437,736,701
Minnesota,Brown County,8,1225,637,588
Minnesota,Brown County,9,1253,633,620
Minnesota,Brown County,10,1499,746,753
Minnesota,Brown County,11,1909,950,959
Minnesota,Brown County,12,1994,983,1011
Minnesota,Brown County,13,1652,861,791
Minnesota,Brown County,14,1347,672,675
Minnesota,Brown County,15,1056,486,570
Minnesota,Brown County,16,863,394,469
Minnesota,Brown County,17,825,325,500
Minnesota,Brown County,18,977,328,649
Minnesota,Carlton County,0,35571,18542,17029
Minnesota,Carlton County,1,2016,1017,999
Minnesota,Carlton County,2,2335,1198,1137
Minnesota,Carlton County,3,2349,1237,1112
Minnesota,Carlton County,4,2174,1167,1007
Minnesota,Carlton County,5,1960,1118,842
Minnesota,Carlton County,6,1972,1081,891
Minnesota,Carlton County,7,2237,1227,1010
Minnesota,Carlton County,8,2191,1222,969
Minnesota,Carlton County,9,2307,1245,1062
Minnesota,Carlton County,10,2439,1314,1125
Minnesota,Carlton County,11,2771,1466,1305
Minnesota,Carlton County,12,2777,1448,1329
Minnesota,Carlton County,13,2261,1162,1099
Minnesota,Carlton County,14,1762,913,849
Minnesota,Carlton County,15,1372,653,719
Minnesota,Carlton County,16,1064,496,568
Minnesota,Carlton County,17,801,359,442
Minnesota,Carlton County,18,783,219,564
Minnesota,Carver County,0,97338,48291,49047
Minnesota,Carver County,1,6295,3136,3159
Minnesota,Carver County,2,7697,3930,3767
Minnesota,Carver County,3,8318,4259,4059
Minnesota,Carver County,4,7503,3817,3686
Minnesota,Carver County,5,5179,2583,2596
Minnesota,Carver County,6,4658,2298,2360
Minnesota,Carver County,7,6295,3143,3152
Minnesota,Carver County,8,6630,3225,3405
Minnesota,Carver County,9,7155,3549,3606
Minnesota,Carver County,10,7967,3928,4039
Minnesota,Carver County,11,8335,4214,4121
Minnesota,Carver County,12,6753,3456,3297
Minnesota,Carver County,13,4863,2447,2416
Minnesota,Carver County,14,3328,1619,1709
Minnesota,Carver County,15,2283,1071,1212
Minnesota,Carver County,16,1536,696,840
Minnesota,Carver County,17,1229,494,735
Minnesota,Carver County,18,1314,426,888
Minnesota,Cass County,0,28559,14477,14082
Minnesota,Cass County,1,1593,836,757
Minnesota,Cass County,2,1796,931,865
Minnesota,Cass County,3,1635,849,786
Minnesota,Cass County,4,1512,762,750
Minnesota,Cass County,5,1378,696,682
Minnesota,Cass County,6,1217,612,605
Minnesota,Cass County,7,1310,635,675
Minnesota,Cass County,8,1335,710,625
Minnesota,Cass County,9,1389,695,694
Minnesota,Cass County,10,1657,853,804
Minnesota,Cass County,11,2170,1099,1071
Minnesota,Cass County,12,2337,1189,1148
Minnesota,Cass County,13,2440,1214,1226
Minnesota,Cass County,14,2260,1170,1090
Minnesota,Cass County,15,1902,965,937
Minnesota,Cass County,16,1187,639,548
Minnesota,Cass County,17,743,355,388
Minnesota,Cass County,18,698,267,431
Minnesota,Chippewa County,0,12110,5979,6131
Minnesota,Chippewa County,1,716,367,349
Minnesota,Chippewa County,2,797,415,382
Minnesota,Chippewa County,3,763,384,379
Minnesota,Chippewa County,4,779,421,358
Minnesota,Chippewa County,5,694,342,352
Minnesota,Chippewa County,6,651,352,299
Minnesota,Chippewa County,7,726,373,353
Minnesota,Chippewa County,8,616,321,295
Minnesota,Chippewa County,9,583,279,304
Minnesota,Chippewa County,10,716,347,369
Minnesota,Chippewa County,11,869,442,427
Minnesota,Chippewa County,12,884,433,451
Minnesota,Chippewa County,13,869,437,432
Minnesota,Chippewa County,14,652,323,329
Minnesota,Chippewa County,15,525,255,270
Minnesota,Chippewa County,16,415,191,224
Minnesota,Chippewa County,17,374,143,231
Minnesota,Chippewa County,18,481,154,327
Minnesota,Chisago County,0,54025,27926,26099
Minnesota,Chisago County,1,2932,1546,1386
Minnesota,Chisago County,2,3446,1765,1681
Minnesota,Chisago County,3,3900,1990,1910
Minnesota,Chisago County,4,3719,1913,1806
Minnesota,Chisago County,5,3047,1689,1358
Minnesota,Chisago County,6,2950,1673,1277
Minnesota,Chisago County,7,3347,1782,1565
Minnesota,Chisago County,8,3205,1708,1497
Minnesota,Chisago County,9,3778,1947,1831
Minnesota,Chisago County,10,4352,2275,2077
Minnesota,Chisago County,11,4680,2416,2264
Minnesota,Chisago County,12,4015,2012,2003
Minnesota,Chisago County,13,3128,1614,1514
Minnesota,Chisago County,14,2524,1248,1276
Minnesota,Chisago County,15,1897,973,924
Minnesota,Chisago County,16,1233,607,626
Minnesota,Chisago County,17,881,399,482
Minnesota,Chisago County,18,991,369,622
Minnesota,Clay County,0,61286,30260,31026
Minnesota,Clay County,1,4078,2044,2034
Minnesota,Clay County,2,4120,2138,1982
Minnesota,Clay County,3,3794,1899,1895
Minnesota,Clay County,4,5317,2495,2822
Minnesota,Clay County,5,7015,3317,3698
Minnesota,Clay County,6,4377,2371,2006
Minnesota,Clay County,7,4229,2140,2089
Minnesota,Clay County,8,3668,1877,1791
Minnesota,Clay County,9,3341,1723,1618
Minnesota,Clay County,10,3172,1596,1576
Minnesota,Clay County,11,3732,1865,1867
Minnesota,Clay County,12,3631,1803,1828
Minnesota,Clay County,13,3059,1536,1523
Minnesota,Clay County,14,2254,1103,1151
Minnesota,Clay County,15,1701,809,892
Minnesota,Clay County,16,1409,647,762
Minnesota,Clay County,17,1072,447,625
Minnesota,Clay County,18,1317,450,867
Minnesota,Clearwater County,0,8791,4431,4360
Minnesota,Clearwater County,1,530,265,265
Minnesota,Clearwater County,2,642,308,334
Minnesota,Clearwater County,3,634,340,294
Minnesota,Clearwater County,4,552,295,257
Minnesota,Clearwater County,5,445,240,205
Minnesota,Clearwater County,6,426,226,200
Minnesota,Clearwater County,7,464,237,227
Minnesota,Clearwater County,8,486,257,229
Minnesota,Clearwater County,9,500,246,254
Minnesota,Clearwater County,10,492,267,225
Minnesota,Clearwater County,11,651,319,332
Minnesota,Clearwater County,12,664,328,336
Minnesota,Clearwater County,13,591,287,304
Minnesota,Clearwater County,14,510,271,239
Minnesota,Clearwater County,15,423,203,220
Minnesota,Clearwater County,16,340,167,173
Minnesota,Clearwater County,17,204,86,118
Minnesota,Clearwater County,18,237,89,148
Minnesota,Cook County,0,5233,2591,2642
Minnesota,Cook County,1,211,107,104
Minnesota,Cook County,2,239,128,111
Minnesota,Cook County,3,248,125,123
Minnesota,Cook County,4,246,122,124
Minnesota,Cook County,5,207,104,103
Minnesota,Cook County,6,238,114,124
Minnesota,Cook County,7,265,133,132
Minnesota,Cook County,8,257,140,117
Minnesota,Cook County,9,276,135,141
Minnesota,Cook County,10,323,152,171
Minnesota,Cook County,11,413,198,215
Minnesota,Cook County,12,511,259,252
Minnesota,Cook County,13,527,249,278
Minnesota,Cook County,14,469,247,222
Minnesota,Cook County,15,332,173,159
Minnesota,Cook County,16,193,98,95
Minnesota,Cook County,17,138,65,73
Minnesota,Cook County,18,140,42,98
Minnesota,Cottonwood County,0,11633,5753,5880
Minnesota,Cottonwood County,1,768,403,365
Minnesota,Cottonwood County,2,727,369,358
Minnesota,Cottonwood County,3,792,409,383
Minnesota,Cottonwood County,4,719,381,338
Minnesota,Cottonwood County,5,618,319,299
Minnesota,Cottonwood County,6,547,308,239
Minnesota,Cottonwood County,7,590,277,313
Minnesota,Cottonwood County,8,600,308,292
Minnesota,Cottonwood County,9,584,279,305
Minnesota,Cottonwood County,10,696,356,340
Minnesota,Cottonwood County,11,751,388,363
Minnesota,Cottonwood County,12,860,441,419
Minnesota,Cottonwood County,13,768,376,392
Minnesota,Cottonwood County,14,697,336,361
Minnesota,Cottonwood County,15,551,266,285
Minnesota,Cottonwood County,16,453,203,250
Minnesota,Cottonwood County,17,429,174,255
Minnesota,Cottonwood County,18,483,160,323
Minnesota,Crow Wing County,0,63265,31579,31686
Minnesota,Crow Wing County,1,3732,1901,1831
Minnesota,Crow Wing County,2,4041,2045,1996
Minnesota,Crow Wing County,3,3979,2080,1899
Minnesota,Crow Wing County,4,3503,1831,1672
Minnesota,Crow Wing County,5,3433,1716,1717
Minnesota,Crow Wing County,6,3293,1700,1593
Minnesota,Crow Wing County,7,3752,1871,1881
Minnesota,Crow Wing County,8,3330,1714,1616
Minnesota,Crow Wing County,9,3314,1696,1618
Minnesota,Crow Wing County,10,3771,1889,1882
Minnesota,Crow Wing County,11,4744,2419,2325
Minnesota,Crow Wing County,12,4685,2235,2450
Minnesota,Crow Wing County,13,4582,2287,2295
Minnesota,Crow Wing County,14,4116,2079,2037
Minnesota,Crow Wing County,15,3405,1647,1758
Minnesota,Crow Wing County,16,2303,1130,1173
Minnesota,Crow Wing County,17,1626,731,895
Minnesota,Crow Wing County,18,1656,608,1048
Minnesota,Dakota County,0,412529,202796,209733
Minnesota,Dakota County,1,27001,13847,13154
Minnesota,Dakota County,2,28802,14669,14133
Minnesota,Dakota County,3,29524,15072,14452
Minnesota,Dakota County,4,27175,14028,13147
Minnesota,Dakota County,5,23779,12090,11689
Minnesota,Dakota County,6,26210,13086,13124
Minnesota,Dakota County,7,29089,14380,14709
Minnesota,Dakota County,8,27120,13483,13637
Minnesota,Dakota County,9,27746,13734,14012
Minnesota,Dakota County,10,29547,14412,15135
Minnesota,Dakota County,11,33557,16292,17265
Minnesota,Dakota County,12,29644,14548,15096
Minnesota,Dakota County,13,23369,11192,12177
Minnesota,Dakota County,14,17451,8167,9284
Minnesota,Dakota County,15,11940,5473,6467
Minnesota,Dakota County,16,8048,3530,4518
Minnesota,Dakota County,17,5960,2491,3469
Minnesota,Dakota County,18,6567,2302,4265
Minnesota,Dodge County,0,20353,10178,10175
Minnesota,Dodge County,1,1300,696,604
Minnesota,Dodge County,2,1570,799,771
Minnesota,Dodge County,3,1715,872,843
Minnesota,Dodge County,4,1500,737,763
Minnesota,Dodge County,5,1084,550,534
Minnesota,Dodge County,6,1067,526,541
Minnesota,Dodge County,7,1243,636,607
Minnesota,Dodge County,8,1365,682,683
Minnesota,Dodge County,9,1392,701,691
Minnesota,Dodge County,10,1413,714,699
Minnesota,Dodge County,11,1487,764,723
Minnesota,Dodge County,12,1379,692,687
Minnesota,Dodge County,13,1156,600,556
Minnesota,Dodge County,14,784,370,414
Minnesota,Dodge County,15,646,317,329
Minnesota,Dodge County,16,476,227,249
Minnesota,Dodge County,17,367,146,221
Minnesota,Dodge County,18,409,149,260
Minnesota,Douglas County,0,36790,18400,18390
Minnesota,Douglas County,1,1980,1025,955
Minnesota,Douglas County,2,2225,1143,1082
Minnesota,Douglas County,3,2245,1142,1103
Minnesota,Douglas County,4,2031,1064,967
Minnesota,Douglas County,5,2129,1166,963
Minnesota,Douglas County,6,2055,1044,1011
Minnesota,Douglas County,7,2182,1139,1043
Minnesota,Douglas County,8,1958,1017,941
Minnesota,Douglas County,9,1935,976,959
Minnesota,Douglas County,10,2072,1057,1015
Minnesota,Douglas County,11,2618,1303,1315
Minnesota,Douglas County,12,2783,1342,1441
Minnesota,Douglas County,13,2614,1328,1286
Minnesota,Douglas County,14,2352,1127,1225
Minnesota,Douglas County,15,1959,959,1000
Minnesota,Douglas County,16,1404,678,726
Minnesota,Douglas County,17,1034,458,576
Minnesota,Douglas County,18,1214,432,782
Minnesota,Faribault County,0,14192,7019,7173
Minnesota,Faribault County,1,804,423,381
Minnesota,Faribault County,2,856,434,422
Minnesota,Faribault County,3,846,439,407
Minnesota,Faribault County,4,883,456,427
Minnesota,Faribault County,5,672,354,318
Minnesota,Faribault County,6,670,344,326
Minnesota,Faribault County,7,788,393,395
Minnesota,Faribault County,8,770,403,367
Minnesota,Faribault County,9,668,336,332
Minnesota,Faribault County,10,814,402,412
Minnesota,Faribault County,11,999,503,496
Minnesota,Faribault County,12,1225,633,592
Minnesota,Faribault County,13,1009,524,485
Minnesota,Faribault County,14,836,418,418
Minnesota,Faribault County,15,698,311,387
Minnesota,Faribault County,16,569,253,316
Minnesota,Faribault County,17,475,198,277
Minnesota,Faribault County,18,610,195,415
Minnesota,Fillmore County,0,20776,10389,10387
Minnesota,Fillmore County,1,1284,706,578
Minnesota,Fillmore County,2,1456,756,700
Minnesota,Fillmore County,3,1383,710,673
Minnesota,Fillmore County,4,1225,624,601
Minnesota,Fillmore County,5,1059,530,529
Minnesota,Fillmore County,6,958,503,455
Minnesota,Fillmore County,7,1187,614,573
Minnesota,Fillmore County,8,1133,558,575
Minnesota,Fillmore County,9,1145,592,553
Minnesota,Fillmore County,10,1188,631,557
Minnesota,Fillmore County,11,1511,754,757
Minnesota,Fillmore County,12,1595,786,809
Minnesota,Fillmore County,13,1424,728,696
Minnesota,Fillmore County,14,1186,587,599
Minnesota,Fillmore County,15,936,466,470
Minnesota,Fillmore County,16,727,337,390
Minnesota,Fillmore County,17,599,258,341
Minnesota,Fillmore County,18,780,249,531
Minnesota,Freeborn County,0,30840,15312,15528
Minnesota,Freeborn County,1,1793,927,866
Minnesota,Freeborn County,2,1948,974,974
Minnesota,Freeborn County,3,1903,990,913
Minnesota,Freeborn County,4,1701,863,838
Minnesota,Freeborn County,5,1593,813,780
Minnesota,Freeborn County,6,1636,837,799
Minnesota,Freeborn County,7,1746,913,833
Minnesota,Freeborn County,8,1599,827,772
Minnesota,Freeborn County,9,1641,859,782
Minnesota,Freeborn County,10,1850,911,939
Minnesota,Freeborn County,11,2335,1183,1152
Minnesota,Freeborn County,12,2389,1224,1165
Minnesota,Freeborn County,13,2082,1052,1030
Minnesota,Freeborn County,14,1845,905,940
Minnesota,Freeborn County,15,1488,692,796
Minnesota,Freeborn County,16,1236,542,694
Minnesota,Freeborn County,17,958,406,552
Minnesota,Freeborn County,18,1097,394,703
Minnesota,Goodhue County,0,46423,23141,23282
Minnesota,Goodhue County,1,2688,1368,1320
Minnesota,Goodhue County,2,2982,1528,1454
Minnesota,Goodhue County,3,3002,1576,1426
Minnesota,Goodhue County,4,2937,1548,1389
Minnesota,Goodhue County,5,2401,1250,1151
Minnesota,Goodhue County,6,2349,1182,1167
Minnesota,Goodhue County,7,2742,1401,1341
Minnesota,Goodhue County,8,2588,1309,1279
Minnesota,Goodhue County,9,2624,1310,1314
Minnesota,Goodhue County,10,2878,1427,1451
Minnesota,Goodhue County,11,3825,1942,1883
Minnesota,Goodhue County,12,3621,1805,1816
Minnesota,Goodhue County,13,3200,1614,1586
Minnesota,Goodhue County,14,2610,1309,1301
Minnesota,Goodhue County,15,1928,911,1017
Minnesota,Goodhue County,16,1470,685,785
Minnesota,Goodhue County,17,1148,493,655
Minnesota,Goodhue County,18,1430,483,947
Minnesota,Grant County,0,5956,2955,3001
Minnesota,Grant County,1,337,168,169
Minnesota,Grant County,2,404,195,209
Minnesota,Grant County,3,347,176,171
Minnesota,Grant County,4,306,151,155
Minnesota,Grant County,5,284,151,133
Minnesota,Grant County,6,268,145,123
Minnesota,Grant County,7,354,172,182
Minnesota,Grant County,8,314,165,149
Minnesota,Grant County,9,306,168,138
Minnesota,Grant County,10,309,149,160
Minnesota,Grant County,11,437,212,225
Minnesota,Grant County,12,478,234,244
Minnesota,Grant County,13,426,208,218
Minnesota,Grant County,14,377,199,178
Minnesota,Grant County,15,338,169,169
Minnesota,Grant County,16,226,109,117
Minnesota,Grant County,17,192,94,98
Minnesota,Grant County,18,253,90,163
Minnesota,Hennepin County,0,1212064,596829,615235
Minnesota,Hennepin County,1,80204,40893,39311
Minnesota,Hennepin County,2,75509,38319,37190
Minnesota,Hennepin County,3,72288,36898,35390
Minnesota,Hennepin County,4,70815,35980,34835
Minnesota,Hennepin County,5,79289,39560,39729
Minnesota,Hennepin County,6,106148,53215,52933
Minnesota,Hennepin County,7,101108,50694,50414
Minnesota,Hennepin County,8,82325,41749,40576
Minnesota,Hennepin County,9,76346,38581,37765
Minnesota,Hennepin County,10,78028,38905,39123
Minnesota,Hennepin County,11,86446,42966,43480
Minnesota,Hennepin County,12,82274,40320,41954
Minnesota,Hennepin County,13,69808,33534,36274
Minnesota,Hennepin County,14,50783,23802,26981
Minnesota,Hennepin County,15,33717,15319,18398
Minnesota,Hennepin County,16,24075,10339,13736
Minnesota,Hennepin County,17,18915,7618,11297
Minnesota,Hennepin County,18,23986,8137,15849
Minnesota,Houston County,0,18738,9323,9415
Minnesota,Houston County,1,939,479,460
Minnesota,Houston County,2,1171,620,551
Minnesota,Houston County,3,1225,628,597
Minnesota,Houston County,4,1082,569,513
Minnesota,Houston County,5,1000,497,503
Minnesota,Houston County,6,827,442,385
Minnesota,Houston County,7,1079,544,535
Minnesota,Houston County,8,993,518,475
Minnesota,Houston County,9,1063,530,533
Minnesota,Houston County,10,1144,538,606
Minnesota,Houston County,11,1582,752,830
Minnesota,Houston County,12,1635,840,795
Minnesota,Houston County,13,1368,716,652
Minnesota,Houston County,14,1080,525,555
Minnesota,Houston County,15,795,400,395
Minnesota,Houston County,16,595,270,325
Minnesota,Houston County,17,535,225,310
Minnesota,Houston County,18,625,230,395
Minnesota,Hubbard County,0,20573,10345,10228
Minnesota,Hubbard County,1,1177,603,574
Minnesota,Hubbard County,2,1285,644,641
Minnesota,Hubbard County,3,1155,581,574
Minnesota,Hubbard County,4,1099,582,517
Minnesota,Hubbard County,5,822,435,387
Minnesota,Hubbard County,6,831,427,404
Minnesota,Hubbard County,7,1040,525,515
Minnesota,Hubbard County,8,971,483,488
Minnesota,Hubbard County,9,1065,537,528
Minnesota,Hubbard County,10,1208,610,598
Minnesota,Hubbard County,11,1670,844,826
Minnesota,Hubbard County,12,1655,831,824
Minnesota,Hubbard County,13,1731,851,880
Minnesota,Hubbard County,14,1588,821,767
Minnesota,Hubbard County,15,1276,628,648
Minnesota,Hubbard County,16,926,463,463
Minnesota,Hubbard County,17,591,281,310
Minnesota,Hubbard County,18,483,199,284
Minnesota,Isanti County,0,38413,19353,19060
Minnesota,Isanti County,1,2294,1163,1131
Minnesota,Isanti County,2,2704,1391,1313
Minnesota,Isanti County,3,2668,1402,1266
Minnesota,Isanti County,4,2583,1319,1264
Minnesota,Isanti County,5,2126,1078,1048
Minnesota,Isanti County,6,2261,1143,1118
Minnesota,Isanti County,7,2525,1285,1240
Minnesota,Isanti County,8,2278,1168,1110
Minnesota,Isanti County,9,2446,1219,1227
Minnesota,Isanti County,10,2669,1376,1293
Minnesota,Isanti County,11,3238,1695,1543
Minnesota,Isanti County,12,2811,1465,1346
Minnesota,Isanti County,13,2217,1129,1088
Minnesota,Isanti County,14,1787,857,930
Minnesota,Isanti County,15,1450,675,775
Minnesota,Isanti County,16,1021,488,533
Minnesota,Isanti County,17,609,258,351
Minnesota,Isanti County,18,726,242,484
Minnesota,Itasca County,0,45589,23046,22543
Minnesota,Itasca County,1,2466,1281,1185
Minnesota,Itasca County,2,2682,1451,1231
Minnesota,Itasca County,3,2764,1411,1353
Minnesota,Itasca County,4,2742,1444,1298
Minnesota,Itasca County,5,2309,1237,1072
Minnesota,Itasca County,6,2038,1085,953
Minnesota,Itasca County,7,2446,1243,1203
Minnesota,Itasca County,8,2385,1228,1157
Minnesota,Itasca County,9,2492,1241,1251
Minnesota,Itasca County,10,2654,1301,1353
Minnesota,Itasca County,11,3391,1699,1692
Minnesota,Itasca County,12,3783,1891,1892
Minnesota,Itasca County,13,3861,1937,1924
Minnesota,Itasca County,14,3050,1576,1474
Minnesota,Itasca County,15,2426,1201,1225
Minnesota,Itasca County,16,1618,807,811
Minnesota,Itasca County,17,1191,509,682
Minnesota,Itasca County,18,1291,504,787
Minnesota,Jackson County,0,10269,5231,5038
Minnesota,Jackson County,1,615,329,286
Minnesota,Jackson County,2,635,318,317
Minnesota,Jackson County,3,662,349,313
Minnesota,Jackson County,4,608,322,286
Minnesota,Jackson County,5,577,312,265
Minnesota,Jackson County,6,519,284,235
Minnesota,Jackson County,7,605,297,308
Minnesota,Jackson County,8,520,274,246
Minnesota,Jackson County,9,598,301,297
Minnesota,Jackson County,10,567,300,267
Minnesota,Jackson County,11,812,450,362
Minnesota,Jackson County,12,800,401,399
Minnesota,Jackson County,13,709,360,349
Minnesota,Jackson County,14,524,262,262
Minnesota,Jackson County,15,425,212,213
Minnesota,Jackson County,16,373,162,211
Minnesota,Jackson County,17,319,138,181
Minnesota,Jackson County,18,401,160,241
Minnesota,Kanabec County,0,15930,8094,7836
Minnesota,Kanabec County,1,776,410,366
Minnesota,Kanabec County,2,1020,502,518
Minnesota,Kanabec County,3,1051,557,494
Minnesota,Kanabec County,4,972,506,466
Minnesota,Kanabec County,5,811,444,367
Minnesota,Kanabec County,6,741,377,364
Minnesota,Kanabec County,7,905,465,440
Minnesota,Kanabec County,8,904,453,451
Minnesota,Kanabec County,9,983,475,508
Minnesota,Kanabec County,10,963,506,457
Minnesota,Kanabec County,11,1278,654,624
Minnesota,Kanabec County,12,1386,711,675
Minnesota,Kanabec County,13,1182,640,542
Minnesota,Kanabec County,14,946,465,481
Minnesota,Kanabec County,15,784,382,402
Minnesota,Kanabec County,16,561,273,288
Minnesota,Kanabec County,17,356,172,184
Minnesota,Kanabec County,18,311,102,209
Minnesota,Kandiyohi County,0,42285,21158,21127
Minnesota,Kandiyohi County,1,2711,1372,1339
Minnesota,Kandiyohi County,2,2888,1502,1386
Minnesota,Kandiyohi County,3,2772,1429,1343
Minnesota,Kandiyohi County,4,2516,1344,1172
Minnesota,Kandiyohi County,5,2841,1504,1337
Minnesota,Kandiyohi County,6,2476,1270,1206
Minnesota,Kandiyohi County,7,2654,1411,1243
Minnesota,Kandiyohi County,8,2253,1167,1086
Minnesota,Kandiyohi County,9,2284,1113,1171
Minnesota,Kandiyohi County,10,2372,1199,1173
Minnesota,Kandiyohi County,11,2977,1468,1509
Minnesota,Kandiyohi County,12,3301,1626,1675
Minnesota,Kandiyohi County,13,2870,1441,1429
Minnesota,Kandiyohi County,14,2114,1034,1080
Minnesota,Kandiyohi County,15,1682,816,866
Minnesota,Kandiyohi County,16,1270,579,691
Minnesota,Kandiyohi County,17,975,423,552
Minnesota,Kandiyohi County,18,1329,460,869
Minnesota,Kittson County,0,4435,2238,2197
Minnesota,Kittson County,1,231,121,110
Minnesota,Kittson County,2,243,118,125
Minnesota,Kittson County,3,276,143,133
Minnesota,Kittson County,4,304,150,154
Minnesota,Kittson County,5,219,118,101
Minnesota,Kittson County,6,179,98,81
Minnesota,Kittson County,7,181,103,78
Minnesota,Kittson County,8,187,90,97
Minnesota,Kittson County,9,245,121,124
Minnesota,Kittson County,10,259,142,117
Minnesota,Kittson County,11,363,189,174
Minnesota,Kittson County,12,369,192,177
Minnesota,Kittson County,13,379,197,182
Minnesota,Kittson County,14,277,154,123
Minnesota,Kittson County,15,206,102,104
Minnesota,Kittson County,16,185,86,99
Minnesota,Kittson County,17,137,58,79
Minnesota,Kittson County,18,195,56,139
Minnesota,Koochiching County,0,12856,6401,6455
Minnesota,Koochiching County,1,508,240,268
Minnesota,Koochiching County,2,656,338,318
Minnesota,Koochiching County,3,789,390,399
Minnesota,Koochiching County,4,782,388,394
Minnesota,Koochiching County,5,650,338,312
Minnesota,Koochiching County,6,562,300,262
Minnesota,Koochiching County,7,619,302,317
Minnesota,Koochiching County,8,604,317,287
Minnesota,Koochiching County,9,714,339,375
Minnesota,Koochiching County,10,811,425,386
Minnesota,Koochiching County,11,998,494,504
Minnesota,Koochiching County,12,1212,626,586
Minnesota,Koochiching County,13,1152,594,558
Minnesota,Koochiching County,14,881,455,426
Minnesota,Koochiching County,15,640,315,325
Minnesota,Koochiching County,16,534,264,270
Minnesota,Koochiching County,17,370,156,214
Minnesota,Koochiching County,18,374,120,254
Minnesota,Lac qui Parle County,0,6891,3451,3440
Minnesota,Lac qui Parle County,1,361,204,157
Minnesota,Lac qui Parle County,2,377,190,187
Minnesota,Lac qui Parle County,3,407,202,205
Minnesota,Lac qui Parle County,4,413,209,204
Minnesota,Lac qui Parle County,5,310,160,150
Minnesota,Lac qui Parle County,6,256,136,120
Minnesota,Lac qui Parle County,7,325,167,158
Minnesota,Lac qui Parle County,8,310,153,157
Minnesota,Lac qui Parle County,9,305,165,140
Minnesota,Lac qui Parle County,10,376,203,173
Minnesota,Lac qui Parle County,11,542,266,276
Minnesota,Lac qui Parle County,12,621,320,301
Minnesota,Lac qui Parle County,13,573,294,279
Minnesota,Lac qui Parle County,14,429,224,205
Minnesota,Lac qui Parle County,15,353,170,183
Minnesota,Lac qui Parle County,16,294,145,149
Minnesota,Lac qui Parle County,17,283,127,156
Minnesota,Lac qui Parle County,18,356,116,240
Minnesota,Lake County,0,10680,5431,5249
Minnesota,Lake County,1,531,282,249
Minnesota,Lake County,2,572,275,297
Minnesota,Lake County,3,546,290,256
Minnesota,Lake County,4,543,282,261
Minnesota,Lake County,5,455,216,239
Minnesota,Lake County,6,534,293,241
Minnesota,Lake County,7,524,275,249
Minnesota,Lake County,8,514,265,249
Minnesota,Lake County,9,510,268,242
Minnesota,Lake County,10,602,290,312
Minnesota,Lake County,11,847,415,432
Minnesota,Lake County,12,953,502,451
Minnesota,Lake County,13,926,495,431
Minnesota,Lake County,14,728,367,361
Minnesota,Lake County,15,610,313,297
Minnesota,Lake County,16,482,234,248
Minnesota,Lake County,17,371,181,190
Minnesota,Lake County,18,432,188,244
Minnesota,Lake of the Woods County,0,3918,1994,1924
Minnesota,Lake of the Woods County,1,175,104,71
Minnesota,Lake of the Woods County,2,204,96,108
Minnesota,Lake of the Woods County,3,221,111,110
Minnesota,Lake of the Woods County,4,194,96,98
Minnesota,Lake of the Woods County,5,170,91,79
Minnesota,Lake of the Woods County,6,150,76,74
Minnesota,Lake of the Woods County,7,179,94,85
Minnesota,Lake of the Woods County,8,191,90,101
Minnesota,Lake of the Woods County,9,183,92,91
Minnesota,Lake of the Woods County,10,249,127,122
Minnesota,Lake of the Woods County,11,348,193,155
Minnesota,Lake of the Woods County,12,417,212,205
Minnesota,Lake of the Woods County,13,375,189,186
Minnesota,Lake of the Woods County,14,282,158,124
Minnesota,Lake of the Woods County,15,209,101,108
Minnesota,Lake of the Woods County,16,162,87,75
Minnesota,Lake of the Woods County,17,101,49,52
Minnesota,Lake of the Woods County,18,108,28,80
Minnesota,Le Sueur County,0,27770,14001,13769
Minnesota,Le Sueur County,1,1588,825,763
Minnesota,Le Sueur County,2,1922,1003,919
Minnesota,Le Sueur County,3,2061,1066,995
Minnesota,Le Sueur County,4,1846,910,936
Minnesota,Le Sueur County,5,1441,686,755
Minnesota,Le Sueur County,6,1369,687,682
Minnesota,Le Sueur County,7,1757,897,860
Minnesota,Le Sueur County,8,1652,847,805
Minnesota,Le Sueur County,9,1723,869,854
Minnesota,Le Sueur County,10,1934,1024,910
Minnesota,Le Sueur County,11,2173,1138,1035
Minnesota,Le Sueur County,12,2070,1092,978
Minnesota,Le Sueur County,13,1789,914,875
Minnesota,Le Sueur County,14,1432,707,725
Minnesota,Le Sueur County,15,1085,525,560
Minnesota,Le Sueur County,16,787,379,408
Minnesota,Le Sueur County,17,571,248,323
Minnesota,Le Sueur County,18,570,184,386
Minnesota,Lincoln County,0,5788,2912,2876
Minnesota,Lincoln County,1,320,176,144
Minnesota,Lincoln County,2,393,210,183
Minnesota,Lincoln County,3,382,208,174
Minnesota,Lincoln County,4,305,143,162
Minnesota,Lincoln County,5,241,127,114
Minnesota,Lincoln County,6,301,151,150
Minnesota,Lincoln County,7,273,131,142
Minnesota,Lincoln County,8,315,166,149
Minnesota,Lincoln County,9,298,163,135
Minnesota,Lincoln County,10,303,156,147
Minnesota,Lincoln County,11,383,205,178
Minnesota,Lincoln County,12,432,236,196
Minnesota,Lincoln County,13,400,196,204
Minnesota,Lincoln County,14,316,154,162
Minnesota,Lincoln County,15,307,149,158
Minnesota,Lincoln County,16,288,129,159
Minnesota,Lincoln County,17,223,104,119
Minnesota,Lincoln County,18,308,108,200
Minnesota,Lyon County,0,25665,12734,12931
Minnesota,Lyon County,1,1840,948,892
Minnesota,Lyon County,2,1792,917,875
Minnesota,Lyon County,3,1694,831,863
Minnesota,Lyon County,4,1968,991,977
Minnesota,Lyon County,5,1846,905,941
Minnesota,Lyon County,6,1824,950,874
Minnesota,Lyon County,7,1735,878,857
Minnesota,Lyon County,8,1519,821,698
Minnesota,Lyon County,9,1399,712,687
Minnesota,Lyon County,10,1405,708,697
Minnesota,Lyon County,11,1736,882,854
Minnesota,Lyon County,12,1778,850,928
Minnesota,Lyon County,13,1428,728,700
Minnesota,Lyon County,14,1042,512,530
Minnesota,Lyon County,15,790,384,406
Minnesota,Lyon County,16,610,282,328
Minnesota,Lyon County,17,541,199,342
Minnesota,Lyon County,18,718,236,482
Minnesota,McLeod County,0,35882,17804,18078
Minnesota,McLeod County,1,2201,1105,1096
Minnesota,McLeod County,2,2331,1223,1108
Minnesota,McLeod County,3,2507,1278,1229
Minnesota,McLeod County,4,2290,1156,1134
Minnesota,McLeod County,5,2015,1017,998
Minnesota,McLeod County,6,1987,1024,963
Minnesota,McLeod County,7,2181,1118,1063
Minnesota,McLeod County,8,2002,1053,949
Minnesota,McLeod County,9,2282,1165,1117
Minnesota,McLeod County,10,2392,1202,1190
Minnesota,McLeod County,11,2737,1384,1353
Minnesota,McLeod County,12,2537,1273,1264
Minnesota,McLeod County,13,2166,1067,1099
Minnesota,McLeod County,14,1830,893,937
Minnesota,McLeod County,15,1484,692,792
Minnesota,McLeod County,16,1093,504,589
Minnesota,McLeod County,17,787,319,468
Minnesota,McLeod County,18,1060,331,729
Minnesota,Mahnomen County,0,5505,2763,2742
Minnesota,Mahnomen County,1,563,308,255
Minnesota,Mahnomen County,2,460,243,217
Minnesota,Mahnomen County,3,436,228,208
Minnesota,Mahnomen County,4,351,186,165
Minnesota,Mahnomen County,5,311,127,184
Minnesota,Mahnomen County,6,251,120,131
Minnesota,Mahnomen County,7,321,154,167
Minnesota,Mahnomen County,8,276,141,135
Minnesota,Mahnomen County,9,278,149,129
Minnesota,Mahnomen County,10,281,136,145
Minnesota,Mahnomen County,11,344,176,168
Minnesota,Mahnomen County,12,388,214,174
Minnesota,Mahnomen County,13,320,161,159
Minnesota,Mahnomen County,14,301,151,150
Minnesota,Mahnomen County,15,214,98,116
Minnesota,Mahnomen County,16,175,87,88
Minnesota,Mahnomen County,17,118,48,70
Minnesota,Mahnomen County,18,117,36,81
Minnesota,Marshall County,0,9417,4778,4639
Minnesota,Marshall County,1,573,273,300
Minnesota,Marshall County,2,587,278,309
Minnesota,Marshall County,3,625,307,318
Minnesota,Marshall County,4,584,317,267
Minnesota,Marshall County,5,478,270,208
Minnesota,Marshall County,6,462,216,246
Minnesota,Marshall County,7,554,307,247
Minnesota,Marshall County,8,474,248,226
Minnesota,Marshall County,9,526,284,242
Minnesota,Marshall County,10,541,279,262
Minnesota,Marshall County,11,736,382,354
Minnesota,Marshall County,12,718,380,338
Minnesota,Marshall County,13,677,354,323
Minnesota,Marshall County,14,516,271,245
Minnesota,Marshall County,15,429,212,217
Minnesota,Marshall County,16,365,169,196
Minnesota,Marshall County,17,250,109,141
Minnesota,Marshall County,18,322,122,200
Minnesota,Martin County,0,20220,9951,10269
Minnesota,Martin County,1,1093,553,540
Minnesota,Martin County,2,1264,633,631
Minnesota,Martin County,3,1240,591,649
Minnesota,Martin County,4,1170,602,568
Minnesota,Martin County,5,1078,542,536
Minnesota,Martin County,6,1007,515,492
Minnesota,Martin County,7,1131,594,537
Minnesota,Martin County,8,971,489,482
Minnesota,Martin County,9,1048,526,522
Minnesota,Martin County,10,1123,572,551
Minnesota,Martin County,11,1529,742,787
Minnesota,Martin County,12,1689,881,808
Minnesota,Martin County,13,1493,778,715
Minnesota,Martin County,14,1173,589,584
Minnesota,Martin County,15,917,437,480
Minnesota,Martin County,16,759,347,412
Minnesota,Martin County,17,613,253,360
Minnesota,Martin County,18,922,307,615
Minnesota,Meeker County,0,23107,11773,11334
Minnesota,Meeker County,1,1438,767,671
Minnesota,Meeker County,2,1644,858,786
Minnesota,Meeker County,3,1599,795,804
Minnesota,Meeker County,4,1515,821,694
Minnesota,Meeker County,5,1168,605,563
Minnesota,Meeker County,6,1126,569,557
Minnesota,Meeker County,7,1296,673,623
Minnesota,Meeker County,8,1283,645,638
Minnesota,Meeker County,9,1294,647,647
Minnesota,Meeker County,10,1388,754,634
Minnesota,Meeker County,11,1769,890,879
Minnesota,Meeker County,12,1759,919,840
Minnesota,Meeker County,13,1677,884,793
Minnesota,Meeker County,14,1233,607,626
Minnesota,Meeker County,15,964,488,476
Minnesota,Meeker County,16,738,363,375
Minnesota,Meeker County,17,584,254,330
Minnesota,Meeker County,18,632,234,398
Minnesota,Mille Lacs County,0,25884,12954,12930
Minnesota,Mille Lacs County,1,1645,853,792
Minnesota,Mille Lacs County,2,1801,930,871
Minnesota,Mille Lacs County,3,1735,908,827
Minnesota,Mille Lacs County,4,1652,871,781
Minnesota,Mille Lacs County,5,1338,699,639
Minnesota,Mille Lacs County,6,1356,652,704
Minnesota,Mille Lacs County,7,1595,805,790
Minnesota,Mille Lacs County,8,1465,759,706
Minnesota,Mille Lacs County,9,1539,755,784
Minnesota,Mille Lacs County,10,1633,844,789
Minnesota,Mille Lacs County,11,2025,1025,1000
Minnesota,Mille Lacs County,12,1845,943,902
Minnesota,Mille Lacs County,13,1603,805,798
Minnesota,Mille Lacs County,14,1318,663,655
Minnesota,Mille Lacs County,15,1211,554,657
Minnesota,Mille Lacs County,16,820,394,426
Minnesota,Mille Lacs County,17,630,289,341
Minnesota,Mille Lacs County,18,673,205,468
Minnesota,Morrison County,0,32810,16549,16261
Minnesota,Morrison County,1,1983,1029,954
Minnesota,Morrison County,2,2283,1170,1113
Minnesota,Morrison County,3,2133,1125,1008
Minnesota,Morrison County,4,2022,1048,974
Minnesota,Morrison County,5,1717,860,857
Minnesota,Morrison County,6,1721,888,833
Minnesota,Morrison County,7,2021,1042,979
Minnesota,Morrison County,8,1879,953,926
Minnesota,Morrison County,9,1824,922,902
Minnesota,Morrison County,10,2106,1128,978
Minnesota,Morrison County,11,2554,1293,1261
Minnesota,Morrison County,12,2600,1307,1293
Minnesota,Morrison County,13,2218,1176,1042
Minnesota,Morrison County,14,1676,846,830
Minnesota,Morrison County,15,1383,667,716
Minnesota,Morrison County,16,1007,456,551
Minnesota,Morrison County,17,803,341,462
Minnesota,Morrison County,18,880,298,582
Minnesota,Mower County,0,39323,19671,19652
Minnesota,Mower County,1,2720,1418,1302
Minnesota,Mower County,2,2788,1390,1398
Minnesota,Mower County,3,2735,1451,1284
Minnesota,Mower County,4,2423,1246,1177
Minnesota,Mower County,5,2336,1234,1102
Minnesota,Mower County,6,2223,1107,1116
Minnesota,Mower County,7,2431,1251,1180
Minnesota,Mower County,8,2172,1109,1063
Minnesota,Mower County,9,2383,1257,1126
Minnesota,Mower County,10,2360,1223,1137
Minnesota,Mower County,11,2736,1374,1362
Minnesota,Mower County,12,2685,1378,1307
Minnesota,Mower County,13,2403,1238,1165
Minnesota,Mower County,14,1885,938,947
Minnesota,Mower County,15,1400,652,748
Minnesota,Mower County,16,1146,485,661
Minnesota,Mower County,17,1089,439,650
Minnesota,Mower County,18,1408,481,927
Minnesota,Murray County,0,8470,4249,4221
Minnesota,Murray County,1,489,261,228
Minnesota,Murray County,2,519,269,250
Minnesota,Murray County,3,510,262,248
Minnesota,Murray County,4,494,245,249
Minnesota,Murray County,5,397,205,192
Minnesota,Murray County,6,367,193,174
Minnesota,Murray County,7,423,218,205
Minnesota,Murray County,8,430,215,215
Minnesota,Murray County,9,396,199,197
Minnesota,Murray County,10,478,256,222
Minnesota,Murray County,11,619,319,300
Minnesota,Murray County,12,677,324,353
Minnesota,Murray County,13,650,339,311
Minnesota,Murray County,14,557,288,269
Minnesota,Murray County,15,466,230,236
Minnesota,Murray County,16,358,173,185
Minnesota,Murray County,17,301,135,166
Minnesota,Murray County,18,339,118,221
Minnesota,Nicollet County,0,33093,16608,16485
Minnesota,Nicollet County,1,1868,965,903
Minnesota,Nicollet County,2,2121,1091,1030
Minnesota,Nicollet County,3,2069,1016,1053
Minnesota,Nicollet County,4,2634,1280,1354
Minnesota,Nicollet County,5,2975,1523,1452
Minnesota,Nicollet County,6,2347,1218,1129
Minnesota,Nicollet County,7,2350,1262,1088
Minnesota,Nicollet County,8,1950,993,957
Minnesota,Nicollet County,9,1830,955,875
Minnesota,Nicollet County,10,1874,989,885
Minnesota,Nicollet County,11,2253,1150,1103
Minnesota,Nicollet County,12,2235,1090,1145
Minnesota,Nicollet County,13,1991,993,998
Minnesota,Nicollet County,14,1512,770,742
Minnesota,Nicollet County,15,1007,470,537
Minnesota,Nicollet County,16,789,355,434
Minnesota,Nicollet County,17,572,238,334
Minnesota,Nicollet County,18,716,250,466
Minnesota,Nobles County,0,21590,11106,10484
Minnesota,Nobles County,1,1740,909,831
Minnesota,Nobles County,2,1603,816,787
Minnesota,Nobles County,3,1474,780,694
Minnesota,Nobles County,4,1417,743,674
Minnesota,Nobles County,5,1448,756,692
Minnesota,Nobles County,6,1378,777,601
Minnesota,Nobles County,7,1411,745,666
Minnesota,Nobles County,8,1202,613,589
Minnesota,Nobles County,9,1206,655,551
Minnesota,Nobles County,10,1254,665,589
Minnesota,Nobles County,11,1389,736,653
Minnesota,Nobles County,12,1463,759,704
Minnesota,Nobles County,13,1211,638,573
Minnesota,Nobles County,14,934,467,467
Minnesota,Nobles County,15,726,359,367
Minnesota,Nobles County,16,592,269,323
Minnesota,Nobles County,17,501,210,291
Minnesota,Nobles County,18,641,209,432
Minnesota,Norman County,0,6639,3285,3354
Minnesota,Norman County,1,353,173,180
Minnesota,Norman County,2,410,202,208
Minnesota,Norman County,3,478,256,222
Minnesota,Norman County,4,465,227,238
Minnesota,Norman County,5,324,166,158
Minnesota,Norman County,6,250,120,130
Minnesota,Norman County,7,341,174,167
Minnesota,Norman County,8,343,171,172
Minnesota,Norman County,9,377,190,187
Minnesota,Norman County,10,364,185,179
Minnesota,Norman County,11,538,264,274
Minnesota,Norman County,12,497,247,250
Minnesota,Norman County,13,454,253,201
Minnesota,Norman County,14,379,193,186
Minnesota,Norman County,15,318,155,163
Minnesota,Norman County,16,268,120,148
Minnesota,Norman County,17,207,93,114
Minnesota,Norman County,18,273,96,177
Minnesota,Olmsted County,0,150287,73549,76738
Minnesota,Olmsted County,1,10599,5470,5129
Minnesota,Olmsted County,2,10713,5527,5186
Minnesota,Olmsted County,3,10027,4992,5035
Minnesota,Olmsted County,4,8822,4523,4299
Minnesota,Olmsted County,5,8552,4198,4354
Minnesota,Olmsted County,6,10523,5093,5430
Minnesota,Olmsted County,7,11868,5898,5970
Minnesota,Olmsted County,8,9901,5010,4891
Minnesota,Olmsted County,9,9015,4522,4493
Minnesota,Olmsted County,10,9215,4560,4655
Minnesota,Olmsted County,11,11087,5404,5683
Minnesota,Olmsted County,12,10534,5040,5494
Minnesota,Olmsted County,13,8411,4053,4358
Minnesota,Olmsted County,14,6301,2952,3349
Minnesota,Olmsted County,15,4933,2261,2672
Minnesota,Olmsted County,16,3752,1697,2055
Minnesota,Olmsted County,17,2813,1217,1596
Minnesota,Olmsted County,18,3221,1132,2089
Minnesota,Otter Tail County,0,57635,28992,28643
Minnesota,Otter Tail County,1,3347,1706,1641
Minnesota,Otter Tail County,2,3392,1793,1599
Minnesota,Otter Tail County,3,3376,1748,1628
Minnesota,Otter Tail County,4,3420,1820,1600
Minnesota,Otter Tail County,5,2932,1555,1377
Minnesota,Otter Tail County,6,2589,1358,1231
Minnesota,Otter Tail County,7,3083,1554,1529
Minnesota,Otter Tail County,8,2779,1468,1311
Minnesota,Otter Tail County,9,2705,1357,1348
Minnesota,Otter Tail County,10,3331,1665,1666
Minnesota,Otter Tail County,11,4495,2251,2244
Minnesota,Otter Tail County,12,4821,2476,2345
Minnesota,Otter Tail County,13,4421,2242,2179
Minnesota,Otter Tail County,14,3814,1952,1862
Minnesota,Otter Tail County,15,3093,1514,1579
Minnesota,Otter Tail County,16,2342,1103,1239
Minnesota,Otter Tail County,17,1704,766,938
Minnesota,Otter Tail County,18,1991,664,1327
Minnesota,Pennington County,0,14058,6995,7063
Minnesota,Pennington County,1,942,489,453
Minnesota,Pennington County,2,892,462,430
Minnesota,Pennington County,3,842,412,430
Minnesota,Pennington County,4,872,466,406
Minnesota,Pennington County,5,903,471,432
Minnesota,Pennington County,6,980,512,468
Minnesota,Pennington County,7,949,473,476
Minnesota,Pennington County,8,813,416,397
Minnesota,Pennington County,9,849,448,401
Minnesota,Pennington County,10,836,444,392
Minnesota,Pennington County,11,984,484,500
Minnesota,Pennington County,12,1027,510,517
Minnesota,Pennington County,13,868,446,422
Minnesota,Pennington County,14,680,301,379
Minnesota,Pennington County,15,543,259,284
Minnesota,Pennington County,16,379,168,211
Minnesota,Pennington County,17,273,102,171
Minnesota,Pennington County,18,426,132,294
Minnesota,Pine County,0,29095,15495,13600
Minnesota,Pine County,1,1419,709,710
Minnesota,Pine County,2,1688,875,813
Minnesota,Pine County,3,1800,929,871
Minnesota,Pine County,4,1613,869,744
Minnesota,Pine County,5,1478,858,620
Minnesota,Pine County,6,1611,942,669
Minnesota,Pine County,7,1897,1093,804
Minnesota,Pine County,8,1726,1019,707
Minnesota,Pine County,9,1727,968,759
Minnesota,Pine County,10,1973,1089,884
Minnesota,Pine County,11,2447,1315,1132
Minnesota,Pine County,12,2336,1218,1118
Minnesota,Pine County,13,2019,1053,966
Minnesota,Pine County,14,1621,808,813
Minnesota,Pine County,15,1436,692,744
Minnesota,Pine County,16,1016,488,528
Minnesota,Pine County,17,693,352,341
Minnesota,Pine County,18,595,218,377
Minnesota,Pipestone County,0,9281,4501,4780
Minnesota,Pipestone County,1,598,282,316
Minnesota,Pipestone County,2,658,339,319
Minnesota,Pipestone County,3,660,331,329
Minnesota,Pipestone County,4,557,292,265
Minnesota,Pipestone County,5,490,245,245
Minnesota,Pipestone County,6,463,226,237
Minnesota,Pipestone County,7,503,268,235
Minnesota,Pipestone County,8,449,230,219
Minnesota,Pipestone County,9,517,258,259
Minnesota,Pipestone County,10,529,268,261
Minnesota,Pipestone County,11,699,349,350
Minnesota,Pipestone County,12,703,354,349
Minnesota,Pipestone County,13,567,289,278
Minnesota,Pipestone County,14,481,218,263
Minnesota,Pipestone County,15,339,158,181
Minnesota,Pipestone County,16,353,151,202
Minnesota,Pipestone County,17,287,104,183
Minnesota,Pipestone County,18,428,139,289
Minnesota,Polk County,0,31704,15886,15818
Minnesota,Polk County,1,2037,1034,1003
Minnesota,Polk County,2,2088,1049,1039
Minnesota,Polk County,3,2065,1018,1047
Minnesota,Polk County,4,2189,1131,1058
Minnesota,Polk County,5,2259,1212,1047
Minnesota,Polk County,6,1940,1043,897
Minnesota,Polk County,7,1917,983,934
Minnesota,Polk County,8,1615,846,769
Minnesota,Polk County,9,1730,879,851
Minnesota,Polk County,10,1859,947,912
Minnesota,Polk County,11,2329,1186,1143
Minnesota,Polk County,12,2305,1182,1123
Minnesota,Polk County,13,1962,1007,955
Minnesota,Polk County,14,1590,833,757
Minnesota,Polk County,15,1183,545,638
Minnesota,Polk County,16,958,422,536
Minnesota,Polk County,17,734,323,411
Minnesota,Polk County,18,944,246,698
Minnesota,Pope County,0,10984,5565,5419
Minnesota,Pope County,1,640,345,295
Minnesota,Pope County,2,675,355,320
Minnesota,Pope County,3,621,333,288
Minnesota,Pope County,4,604,319,285
Minnesota,Pope County,5,516,263,253
Minnesota,Pope County,6,561,293,268
Minnesota,Pope County,7,626,343,283
Minnesota,Pope County,8,558,280,278
Minnesota,Pope County,9,573,304,269
Minnesota,Pope County,10,582,300,282
Minnesota,Pope County,11,787,401,386
Minnesota,Pope County,12,897,441,456
Minnesota,Pope County,13,850,451,399
Minnesota,Pope County,14,736,380,356
Minnesota,Pope County,15,560,276,284
Minnesota,Pope County,16,454,192,262
Minnesota,Pope County,17,315,134,181
Minnesota,Pope County,18,429,155,274
Minnesota,Ramsey County,0,532655,259197,273458
Minnesota,Ramsey County,1,37827,19288,18539
Minnesota,Ramsey County,2,35010,17754,17256
Minnesota,Ramsey County,3,32539,16656,15883
Minnesota,Ramsey County,4,34807,17544,17263
Minnesota,Ramsey County,5,41774,20654,21120
Minnesota,Ramsey County,6,46150,22740,23410
Minnesota,Ramsey County,7,41063,20344,20719
Minnesota,Ramsey County,8,32401,16294,16107
Minnesota,Ramsey County,9,30023,14875,15148
Minnesota,Ramsey County,10,31255,15519,15736
Minnesota,Ramsey County,11,35069,17081,17988
Minnesota,Ramsey County,12,34901,16640,18261
Minnesota,Ramsey County,13,30862,14663,16199
Minnesota,Ramsey County,14,22454,10427,12027
Minnesota,Ramsey County,15,15226,6834,8392
Minnesota,Ramsey County,16,11148,4688,6460
Minnesota,Ramsey County,17,8993,3579,5414
Minnesota,Ramsey County,18,11153,3617,7536
Minnesota,Red Lake County,0,4043,2056,1987
Minnesota,Red Lake County,1,300,160,140
Minnesota,Red Lake County,2,271,144,127
Minnesota,Red Lake County,3,302,150,152
Minnesota,Red Lake County,4,203,104,99
Minnesota,Red Lake County,5,175,96,79
Minnesota,Red Lake County,6,182,93,89
Minnesota,Red Lake County,7,251,127,124
Minnesota,Red Lake County,8,238,119,119
Minnesota,Red Lake County,9,213,111,102
Minnesota,Red Lake County,10,229,118,111
Minnesota,Red Lake County,11,299,149,150
Minnesota,Red Lake County,12,341,178,163
Minnesota,Red Lake County,13,291,162,129
Minnesota,Red Lake County,14,216,110,106
Minnesota,Red Lake County,15,169,80,89
Minnesota,Red Lake County,16,154,72,82
Minnesota,Red Lake County,17,116,53,63
Minnesota,Red Lake County,18,93,30,63
Minnesota,Redwood County,0,15515,7755,7760
Minnesota,Redwood County,1,986,492,494
Minnesota,Redwood County,2,1054,529,525
Minnesota,Redwood County,3,1101,588,513
Minnesota,Redwood County,4,967,512,455
Minnesota,Redwood County,5,813,414,399
Minnesota,Redwood County,6,750,395,355
Minnesota,Redwood County,7,846,449,397
Minnesota,Redwood County,8,787,420,367
Minnesota,Redwood County,9,798,378,420
Minnesota,Redwood County,10,912,494,418
Minnesota,Redwood County,11,1167,575,592
Minnesota,Redwood County,12,1117,588,529
Minnesota,Redwood County,13,1029,518,511
Minnesota,Redwood County,14,833,389,444
Minnesota,Redwood County,15,715,349,366
Minnesota,Redwood County,16,568,267,301
Minnesota,Redwood County,17,438,201,237
Minnesota,Redwood County,18,634,197,437
Minnesota,Renville County,0,15025,7664,7361
Minnesota,Renville County,1,865,459,406
Minnesota,Renville County,2,932,470,462
Minnesota,Renville County,3,977,501,476
Minnesota,Renville County,4,953,488,465
Minnesota,Renville County,5,737,410,327
Minnesota,Renville County,6,729,384,345
Minnesota,Renville County,7,833,456,377
Minnesota,Renville County,8,753,384,369
Minnesota,Renville County,9,807,425,382
Minnesota,Renville County,10,906,445,461
Minnesota,Renville County,11,1184,609,575
Minnesota,Renville County,12,1273,685,588
Minnesota,Renville County,13,1016,555,461
Minnesota,Renville County,14,788,399,389
Minnesota,Renville County,15,676,329,347
Minnesota,Renville County,16,545,265,280
Minnesota,Renville County,17,449,187,262
Minnesota,Renville County,18,602,213,389
Minnesota,Rice County,0,65151,33224,31927
Minnesota,Rice County,1,3791,1909,1882
Minnesota,Rice County,2,4144,2054,2090
Minnesota,Rice County,3,4173,2150,2023
Minnesota,Rice County,4,5672,2827,2845
Minnesota,Rice County,5,6419,3329,3090
Minnesota,Rice County,6,3494,1949,1545
Minnesota,Rice County,7,3932,2187,1745
Minnesota,Rice County,8,3718,2019,1699
Minnesota,Rice County,9,3895,2045,1850
Minnesota,Rice County,10,4164,2223,1941
Minnesota,Rice County,11,4547,2378,2169
Minnesota,Rice County,12,4423,2250,2173
Minnesota,Rice County,13,3588,1770,1818
Minnesota,Rice County,14,2883,1404,1479
Minnesota,Rice County,15,2137,1023,1114
Minnesota,Rice County,16,1647,749,898
Minnesota,Rice County,17,1227,542,685
Minnesota,Rice County,18,1297,416,881
Minnesota,Rock County,0,9553,4686,4867
Minnesota,Rock County,1,616,301,315
Minnesota,Rock County,2,661,332,329
Minnesota,Rock County,3,701,365,336
Minnesota,Rock County,4,610,333,277
Minnesota,Rock County,5,485,239,246
Minnesota,Rock County,6,411,213,198
Minnesota,Rock County,7,516,260,256
Minnesota,Rock County,8,583,292,291
Minnesota,Rock County,9,546,275,271
Minnesota,Rock County,10,497,246,251
Minnesota,Rock County,11,672,331,341
Minnesota,Rock County,12,686,339,347
Minnesota,Rock County,13,613,314,299
Minnesota,Rock County,14,523,266,257
Minnesota,Rock County,15,418,201,217
Minnesota,Rock County,16,347,146,201
Minnesota,Rock County,17,281,111,170
Minnesota,Rock County,18,387,122,265
Minnesota,Roseau County,0,15679,8015,7664
Minnesota,Roseau County,1,941,453,488
Minnesota,Roseau County,2,1057,516,541
Minnesota,Roseau County,3,1151,598,553
Minnesota,Roseau County,4,1101,582,519
Minnesota,Roseau County,5,853,442,411
Minnesota,Roseau County,6,735,410,325
Minnesota,Roseau County,7,843,437,406
Minnesota,Roseau County,8,882,470,412
Minnesota,Roseau County,9,969,491,478
Minnesota,Roseau County,10,1122,594,528
Minnesota,Roseau County,11,1374,719,655
Minnesota,Roseau County,12,1218,643,575
Minnesota,Roseau County,13,970,499,471
Minnesota,Roseau County,14,755,383,372
Minnesota,Roseau County,15,604,304,300
Minnesota,Roseau County,16,439,213,226
Minnesota,Roseau County,17,290,125,165
Minnesota,Roseau County,18,375,136,239
Minnesota,Scott County,0,139672,69625,70047
Minnesota,Scott County,1,10278,5255,5023
Minnesota,Scott County,2,11512,5796,5716
Minnesota,Scott County,3,11795,6041,5754
Minnesota,Scott County,4,9891,5051,4840
Minnesota,Scott County,5,6999,3557,3442
Minnesota,Scott County,6,7655,3809,3846
Minnesota,Scott County,7,10180,4949,5231
Minnesota,Scott County,8,10481,5162,5319
Minnesota,Scott County,9,11155,5537,5618
Minnesota,Scott County,10,11164,5681,5483
Minnesota,Scott County,11,10872,5506,5366
Minnesota,Scott County,12,8457,4356,4101
Minnesota,Scott County,13,6281,3095,3186
Minnesota,Scott County,14,4574,2167,2407
Minnesota,Scott County,15,3256,1526,1730
Minnesota,Scott County,16,2168,1006,1162
Minnesota,Scott County,17,1428,624,804
Minnesota,Scott County,18,1526,507,1019
Minnesota,Sherburne County,0,91126,46640,44486
Minnesota,Sherburne County,1,6153,3135,3018
Minnesota,Sherburne County,2,6953,3520,3433
Minnesota,Sherburne County,3,7396,3764,3632
Minnesota,Sherburne County,4,6565,3464,3101
Minnesota,Sherburne County,5,5409,2912,2497
Minnesota,Sherburne County,6,5802,3099,2703
Minnesota,Sherburne County,7,6461,3349,3112
Minnesota,Sherburne County,8,6285,3251,3034
Minnesota,Sherburne County,9,6826,3479,3347
Minnesota,Sherburne County,10,6955,3618,3337
Minnesota,Sherburne County,11,7029,3633,3396
Minnesota,Sherburne County,12,5670,2910,2760
Minnesota,Sherburne County,13,4325,2180,2145
Minnesota,Sherburne County,14,3340,1662,1678
Minnesota,Sherburne County,15,2301,1121,1180
Minnesota,Sherburne County,16,1504,730,774
Minnesota,Sherburne County,17,996,450,546
Minnesota,Sherburne County,18,1156,363,793
Minnesota,Sibley County,0,14918,7498,7420
Minnesota,Sibley County,1,900,496,404
Minnesota,Sibley County,2,1049,532,517
Minnesota,Sibley County,3,1086,561,525
Minnesota,Sibley County,4,951,485,466
Minnesota,Sibley County,5,771,398,373
Minnesota,Sibley County,6,723,370,353
Minnesota,Sibley County,7,885,453,432
Minnesota,Sibley County,8,888,464,424
Minnesota,Sibley County,9,851,423,428
Minnesota,Sibley County,10,949,483,466
Minnesota,Sibley County,11,1242,628,614
Minnesota,Sibley County,12,1087,577,510
Minnesota,Sibley County,13,926,494,432
Minnesota,Sibley County,14,710,346,364
Minnesota,Sibley County,15,600,271,329
Minnesota,Sibley County,16,484,227,257
Minnesota,Sibley County,17,402,159,243
Minnesota,Sibley County,18,414,131,283
Minnesota,Stearns County,0,152912,77038,75874
Minnesota,Stearns County,1,9384,4742,4642
Minnesota,Stearns County,2,9741,4951,4790
Minnesota,Stearns County,3,9684,4957,4727
Minnesota,Stearns County,4,12631,6366,6265
Minnesota,Stearns County,5,17197,8798,8399
Minnesota,Stearns County,6,9523,5065,4458
Minnesota,Stearns County,7,9756,5059,4697
Minnesota,Stearns County,8,8531,4437,4094
Minnesota,Stearns County,9,8216,4180,4036
Minnesota,Stearns County,10,9122,4574,4548
Minnesota,Stearns County,11,10509,5298,5211
Minnesota,Stearns County,12,9663,4889,4774
Minnesota,Stearns County,13,8322,4196,4126
Minnesota,Stearns County,14,6402,3189,3213
Minnesota,Stearns County,15,4641,2171,2470
Minnesota,Stearns County,16,3787,1774,2013
Minnesota,Stearns County,17,2934,1324,1610
Minnesota,Stearns County,18,2869,1068,1801
Minnesota,Steele County,0,36573,18044,18529
Minnesota,Steele County,1,2446,1168,1278
Minnesota,Steele County,2,2631,1310,1321
Minnesota,Steele County,3,2608,1314,1294
Minnesota,Steele County,4,2368,1213,1155
Minnesota,Steele County,5,2037,1066,971
Minnesota,Steele County,6,2032,1032,1000
Minnesota,Steele County,7,2355,1202,1153
Minnesota,Steele County,8,2052,983,1069
Minnesota,Steele County,9,2205,1145,1060
Minnesota,Steele County,10,2430,1212,1218
Minnesota,Steele County,11,2789,1397,1392
Minnesota,Steele County,12,2474,1258,1216
Minnesota,Steele County,13,2283,1177,1106
Minnesota,Steele County,14,1690,817,873
Minnesota,Steele County,15,1293,611,682
Minnesota,Steele County,16,1061,485,576
Minnesota,Steele County,17,805,305,500
Minnesota,Steele County,18,1014,349,665
Minnesota,Stevens County,0,9800,4872,4928
Minnesota,Stevens County,1,518,256,262
Minnesota,Stevens County,2,614,317,297
Minnesota,Stevens County,3,572,319,253
Minnesota,Stevens County,4,1068,487,581
Minnesota,Stevens County,5,1260,622,638
Minnesota,Stevens County,6,561,316,245
Minnesota,Stevens County,7,565,307,258
Minnesota,Stevens County,8,463,248,215
Minnesota,Stevens County,9,409,204,205
Minnesota,Stevens County,10,445,224,221
Minnesota,Stevens County,11,558,282,276
Minnesota,Stevens County,12,606,296,310
Minnesota,Stevens County,13,559,293,266
Minnesota,Stevens County,14,393,196,197
Minnesota,Stevens County,15,324,155,169
Minnesota,Stevens County,16,267,130,137
Minnesota,Stevens County,17,260,100,160
Minnesota,Stevens County,18,358,120,238
Minnesota,Swift County,0,9436,4775,4661
Minnesota,Swift County,1,562,304,258
Minnesota,Swift County,2,568,291,277
Minnesota,Swift County,3,568,288,280
Minnesota,Swift County,4,525,291,234
Minnesota,Swift County,5,514,268,246
Minnesota,Swift County,6,451,242,209
Minnesota,Swift County,7,543,276,267
Minnesota,Swift County,8,473,246,227
Minnesota,Swift County,9,499,252,247
Minnesota,Swift County,10,610,318,292
Minnesota,Swift County,11,703,364,339
Minnesota,Swift County,12,756,408,348
Minnesota,Swift County,13,647,335,312
Minnesota,Swift County,14,569,292,277
Minnesota,Swift County,15,382,183,199
Minnesota,Swift County,16,344,143,201
Minnesota,Swift County,17,318,136,182
Minnesota,Swift County,18,404,138,266
Minnesota,Todd County,0,24264,12430,11834
Minnesota,Todd County,1,1678,833,845
Minnesota,Todd County,2,1587,867,720
Minnesota,Todd County,3,1545,818,727
Minnesota,Todd County,4,1574,787,787
Minnesota,Todd County,5,1306,699,607
Minnesota,Todd County,6,1143,615,528
Minnesota,Todd County,7,1260,636,624
Minnesota,Todd County,8,1195,645,550
Minnesota,Todd County,9,1265,664,601
Minnesota,Todd County,10,1448,715,733
Minnesota,Todd County,11,1890,946,944
Minnesota,Todd County,12,1934,1026,908
Minnesota,Todd County,13,1792,958,834
Minnesota,Todd County,14,1420,701,719
Minnesota,Todd County,15,1180,580,600
Minnesota,Todd County,16,854,407,447
Minnesota,Todd County,17,599,287,312
Minnesota,Todd County,18,594,246,348
Minnesota,Traverse County,0,3387,1685,1702
Minnesota,Traverse County,1,162,84,78
Minnesota,Traverse County,2,185,96,89
Minnesota,Traverse County,3,208,112,96
Minnesota,Traverse County,4,224,113,111
Minnesota,Traverse County,5,164,85,79
Minnesota,Traverse County,6,139,77,62
Minnesota,Traverse County,7,173,90,83
Minnesota,Traverse County,8,163,88,75
Minnesota,Traverse County,9,153,76,77
Minnesota,Traverse County,10,194,96,98
Minnesota,Traverse County,11,247,126,121
Minnesota,Traverse County,12,265,136,129
Minnesota,Traverse County,13,240,126,114
Minnesota,Traverse County,14,182,89,93
Minnesota,Traverse County,15,178,84,94
Minnesota,Traverse County,16,157,68,89
Minnesota,Traverse County,17,165,72,93
Minnesota,Traverse County,18,188,67,121
Minnesota,Wabasha County,0,21362,10644,10718
Minnesota,Wabasha County,1,1272,639,633
Minnesota,Wabasha County,2,1349,674,675
Minnesota,Wabasha County,3,1327,675,652
Minnesota,Wabasha County,4,1280,624,656
Minnesota,Wabasha County,5,1109,566,543
Minnesota,Wabasha County,6,1050,530,520
Minnesota,Wabasha County,7,1197,620,577
Minnesota,Wabasha County,8,1154,598,556
Minnesota,Wabasha County,9,1261,631,630
Minnesota,Wabasha County,10,1452,732,720
Minnesota,Wabasha County,11,1734,854,880
Minnesota,Wabasha County,12,1680,857,823
Minnesota,Wabasha County,13,1504,781,723
Minnesota,Wabasha County,14,1289,644,645
Minnesota,Wabasha County,15,930,441,489
Minnesota,Wabasha County,16,670,323,347
Minnesota,Wabasha County,17,480,217,263
Minnesota,Wabasha County,18,624,238,386
Minnesota,Wadena County,0,13757,6818,6939
Minnesota,Wadena County,1,849,419,430
Minnesota,Wadena County,2,974,470,504
Minnesota,Wadena County,3,932,479,453
Minnesota,Wadena County,4,829,418,411
Minnesota,Wadena County,5,829,449,380
Minnesota,Wadena County,6,638,340,298
Minnesota,Wadena County,7,722,360,362
Minnesota,Wadena County,8,712,354,358
Minnesota,Wadena County,9,713,369,344
Minnesota,Wadena County,10,739,384,355
Minnesota,Wadena County,11,1000,507,493
Minnesota,Wadena County,12,968,499,469
Minnesota,Wadena County,13,886,437,449
Minnesota,Wadena County,14,764,392,372
Minnesota,Wadena County,15,711,345,366
Minnesota,Wadena County,16,537,252,285
Minnesota,Wadena County,17,436,189,247
Minnesota,Wadena County,18,518,155,363
Minnesota,Waseca County,0,19025,8998,10027
Minnesota,Waseca County,1,1136,617,519
Minnesota,Waseca County,2,1224,602,622
Minnesota,Waseca County,3,1297,662,635
Minnesota,Waseca County,4,1148,581,567
Minnesota,Waseca County,5,1032,490,542
Minnesota,Waseca County,6,1148,487,661
Minnesota,Waseca County,7,1355,548,807
Minnesota,Waseca County,8,1251,568,683
Minnesota,Waseca County,9,1185,542,643
Minnesota,Waseca County,10,1199,568,631
Minnesota,Waseca County,11,1357,668,689
Minnesota,Waseca County,12,1385,653,732
Minnesota,Waseca County,13,1226,609,617
Minnesota,Waseca County,14,953,505,448
Minnesota,Waseca County,15,652,310,342
Minnesota,Waseca County,16,503,217,286
Minnesota,Waseca County,17,409,173,236
Minnesota,Waseca County,18,565,198,367
Minnesota,Washington County,0,249283,123317,125966
Minnesota,Washington County,1,15260,7732,7528
Minnesota,Washington County,2,17339,8794,8545
Minnesota,Washington County,3,18627,9457,9170
Minnesota,Washington County,4,17424,8856,8568
Minnesota,Washington County,5,14007,7403,6604
Minnesota,Washington County,6,13688,6967,6721
Minnesota,Washington County,7,16045,7999,8046
Minnesota,Washington County,8,15531,7675,7856
Minnesota,Washington County,9,16799,8358,8441
Minnesota,Washington County,10,18824,9083,9741
Minnesota,Washington County,11,20521,10125,10396
Minnesota,Washington County,12,18476,9089,9387
Minnesota,Washington County,13,14814,7244,7570
Minnesota,Washington County,14,11449,5576,5873
Minnesota,Washington County,15,7652,3634,4018
Minnesota,Washington County,16,5244,2388,2856
Minnesota,Washington County,17,3645,1568,2077
Minnesota,Washington County,18,3938,1369,2569
Minnesota,Watonwan County,0,11083,5513,5570
Minnesota,Watonwan County,1,759,396,363
Minnesota,Watonwan County,2,733,358,375
Minnesota,Watonwan County,3,784,407,377
Minnesota,Watonwan County,4,720,342,378
Minnesota,Watonwan County,5,625,323,302
Minnesota,Watonwan County,6,532,289,243
Minnesota,Watonwan County,7,652,338,314
Minnesota,Watonwan County,8,639,326,313
Minnesota,Watonwan County,9,569,284,285
Minnesota,Watonwan County,10,643,308,335
Minnesota,Watonwan County,11,730,368,362
Minnesota,Watonwan County,12,852,425,427
Minnesota,Watonwan County,13,719,394,325
Minnesota,Watonwan County,14,519,255,264
Minnesota,Watonwan County,15,476,235,241
Minnesota,Watonwan County,16,390,172,218
Minnesota,Watonwan County,17,322,140,182
Minnesota,Watonwan County,18,419,153,266
Minnesota,Wilkin County,0,6495,3316,3179
Minnesota,Wilkin County,1,377,196,181
Minnesota,Wilkin County,2,424,211,213
Minnesota,Wilkin County,3,405,242,163
Minnesota,Wilkin County,4,444,217,227
Minnesota,Wilkin County,5,345,173,172
Minnesota,Wilkin County,6,318,178,140
Minnesota,Wilkin County,7,369,178,191
Minnesota,Wilkin County,8,338,180,158
Minnesota,Wilkin County,9,371,179,192
Minnesota,Wilkin County,10,410,218,192
Minnesota,Wilkin County,11,578,305,273
Minnesota,Wilkin County,12,538,279,259
Minnesota,Wilkin County,13,403,218,185
Minnesota,Wilkin County,14,327,149,178
Minnesota,Wilkin County,15,255,125,130
Minnesota,Wilkin County,16,229,98,131
Minnesota,Wilkin County,17,196,93,103
Minnesota,Wilkin County,18,168,77,91
Minnesota,Winona County,0,51097,25249,25848
Minnesota,Winona County,1,2247,1179,1068
Minnesota,Winona County,2,2700,1343,1357
Minnesota,Winona County,3,2608,1374,1234
Minnesota,Winona County,4,5026,2302,2724
Minnesota,Winona County,5,7684,3806,3878
Minnesota,Winona County,6,2877,1497,1380
Minnesota,Winona County,7,2827,1461,1366
Minnesota,Winona County,8,2440,1260,1180
Minnesota,Winona County,9,2453,1269,1184
Minnesota,Winona County,10,2722,1368,1354
Minnesota,Winona County,11,3256,1600,1656
Minnesota,Winona County,12,3449,1741,1708
Minnesota,Winona County,13,3100,1573,1527
Minnesota,Winona County,14,2445,1211,1234
Minnesota,Winona County,15,1706,832,874
Minnesota,Winona County,16,1391,665,726
Minnesota,Winona County,17,980,408,572
Minnesota,Winona County,18,1186,360,826
Minnesota,Wright County,0,129918,65367,64551
Minnesota,Wright County,1,9552,4909,4643
Minnesota,Wright County,2,10902,5590,5312
Minnesota,Wright County,3,10779,5531,5248
Minnesota,Wright County,4,9006,4594,4412
Minnesota,Wright County,5,6445,3282,3163
Minnesota,Wright County,6,7077,3557,3520
Minnesota,Wright County,7,9223,4559,4664
Minnesota,Wright County,8,9291,4633,4658
Minnesota,Wright County,9,9444,4823,4621
Minnesota,Wright County,10,9546,4861,4685
Minnesota,Wright County,11,9769,5031,4738
Minnesota,Wright County,12,7939,4078,3861
Minnesota,Wright County,13,6342,3156,3186
Minnesota,Wright County,14,5048,2414,2634
Minnesota,Wright County,15,3696,1786,1910
Minnesota,Wright County,16,2488,1190,1298
Minnesota,Wright County,17,1602,745,857
Minnesota,Wright County,18,1769,628,1141
Minnesota,Yellow Medicine County,0,10109,5152,4957
Minnesota,Yellow Medicine County,1,650,322,328
Minnesota,Yellow Medicine County,2,655,337,318
Minnesota,Yellow Medicine County,3,639,349,290
Minnesota,Yellow Medicine County,4,650,371,279
Minnesota,Yellow Medicine County,5,526,280,246
Minnesota,Yellow Medicine County,6,525,299,226
Minnesota,Yellow Medicine County,7,584,304,280
Minnesota,Yellow Medicine County,8,514,264,250
Minnesota,Yellow Medicine County,9,505,259,246
Minnesota,Yellow Medicine County,10,598,296,302
Minnesota,Yellow Medicine County,11,734,362,372
Minnesota,Yellow Medicine County,12,843,428,415
Minnesota,Yellow Medicine County,13,658,367,291
Minnesota,Yellow Medicine County,14,510,244,266
Minnesota,Yellow Medicine County,15,442,216,226
Minnesota,Yellow Medicine County,16,353,161,192
Minnesota,Yellow Medicine County,17,301,146,155
Minnesota,Yellow Medicine County,18,422,147,275
Mississippi,Adams County,0,31737,16014,15723
Mississippi,Adams County,1,1829,942,887
Mississippi,Adams County,2,1888,943,945
Mississippi,Adams County,3,1853,912,941
Mississippi,Adams County,4,1802,952,850
Mississippi,Adams County,5,2014,1004,1010
Mississippi,Adams County,6,2067,1152,915
Mississippi,Adams County,7,2048,1195,853
Mississippi,Adams County,8,1977,1147,830
Mississippi,Adams County,9,1906,1075,831
Mississippi,Adams County,10,1861,1008,853
Mississippi,Adams County,11,2367,1173,1194
Mississippi,Adams County,12,2559,1221,1338
Mississippi,Adams County,13,2267,1092,1175
Mississippi,Adams County,14,1654,755,899
Mississippi,Adams County,15,1236,555,681
Mississippi,Adams County,16,985,399,586
Mississippi,Adams County,17,701,247,454
Mississippi,Adams County,18,723,242,481
Mississippi,Alcorn County,0,37380,18281,19099
Mississippi,Alcorn County,1,2329,1244,1085
Mississippi,Alcorn County,2,2479,1251,1228
Mississippi,Alcorn County,3,2543,1322,1221
Mississippi,Alcorn County,4,2313,1222,1091
Mississippi,Alcorn County,5,2289,1134,1155
Mississippi,Alcorn County,6,2177,1103,1074
Mississippi,Alcorn County,7,2346,1120,1226
Mississippi,Alcorn County,8,2306,1165,1141
Mississippi,Alcorn County,9,2507,1240,1267
Mississippi,Alcorn County,10,2417,1232,1185
Mississippi,Alcorn County,11,2562,1285,1277
Mississippi,Alcorn County,12,2557,1226,1331
Mississippi,Alcorn County,13,2173,986,1187
Mississippi,Alcorn County,14,2133,975,1158
Mississippi,Alcorn County,15,1652,730,922
Mississippi,Alcorn County,16,1171,520,651
Mississippi,Alcorn County,17,769,320,449
Mississippi,Alcorn County,18,657,206,451
Mississippi,Amite County,0,12629,6144,6485
Mississippi,Amite County,1,745,394,351
Mississippi,Amite County,2,792,385,407
Mississippi,Amite County,3,702,349,353
Mississippi,Amite County,4,664,366,298
Mississippi,Amite County,5,706,366,340
Mississippi,Amite County,6,654,321,333
Mississippi,Amite County,7,635,305,330
Mississippi,Amite County,8,617,297,320
Mississippi,Amite County,9,655,332,323
Mississippi,Amite County,10,743,362,381
Mississippi,Amite County,11,1000,465,535
Mississippi,Amite County,12,1087,541,546
Mississippi,Amite County,13,976,483,493
Mississippi,Amite County,14,800,377,423
Mississippi,Amite County,15,721,333,388
Mississippi,Amite County,16,481,244,237
Mississippi,Amite County,17,319,110,209
Mississippi,Amite County,18,332,114,218
Mississippi,Attala County,0,19163,9051,10112
Mississippi,Attala County,1,1338,675,663
Mississippi,Attala County,2,1420,693,727
Mississippi,Attala County,3,1308,632,676
Mississippi,Attala County,4,1173,625,548
Mississippi,Attala County,5,1132,555,577
Mississippi,Attala County,6,1008,461,547
Mississippi,Attala County,7,1073,504,569
Mississippi,Attala County,8,983,475,508
Mississippi,Attala County,9,1104,508,596
Mississippi,Attala County,10,1168,524,644
Mississippi,Attala County,11,1250,606,644
Mississippi,Attala County,12,1304,639,665
Mississippi,Attala County,13,1163,572,591
Mississippi,Attala County,14,1175,538,637
Mississippi,Attala County,15,900,427,473
Mississippi,Attala County,16,711,297,414
Mississippi,Attala County,17,451,167,284
Mississippi,Attala County,18,502,153,349
Mississippi,Benton County,0,8296,4151,4145
Mississippi,Benton County,1,433,239,194
Mississippi,Benton County,2,515,279,236
Mississippi,Benton County,3,568,314,254
Mississippi,Benton County,4,505,254,251
Mississippi,Benton County,5,507,285,222
Mississippi,Benton County,6,465,225,240
Mississippi,Benton County,7,470,227,243
Mississippi,Benton County,8,513,234,279
Mississippi,Benton County,9,508,249,259
Mississippi,Benton County,10,599,297,302
Mississippi,Benton County,11,642,330,312
Mississippi,Benton County,12,590,282,308
Mississippi,Benton County,13,494,245,249
Mississippi,Benton County,14,517,254,263
Mississippi,Benton County,15,373,182,191
Mississippi,Benton County,16,253,113,140
Mississippi,Benton County,17,192,97,95
Mississippi,Benton County,18,152,45,107
Mississippi,Bolivar County,0,33768,15806,17962
Mississippi,Bolivar County,1,2523,1306,1217
Mississippi,Bolivar County,2,2450,1183,1267
Mississippi,Bolivar County,3,2265,1113,1152
Mississippi,Bolivar County,4,2446,1216,1230
Mississippi,Bolivar County,5,2821,1376,1445
Mississippi,Bolivar County,6,2491,1234,1257
Mississippi,Bolivar County,7,2269,1132,1137
Mississippi,Bolivar County,8,1854,877,977
Mississippi,Bolivar County,9,1921,846,1075
Mississippi,Bolivar County,10,1889,857,1032
Mississippi,Bolivar County,11,2158,993,1165
Mississippi,Bolivar County,12,2077,904,1173
Mississippi,Bolivar County,13,1984,881,1103
Mississippi,Bolivar County,14,1671,768,903
Mississippi,Bolivar County,15,1161,507,654
Mississippi,Bolivar County,16,754,305,449
Mississippi,Bolivar County,17,465,167,298
Mississippi,Bolivar County,18,569,141,428
Mississippi,Calhoun County,0,14745,7085,7660
Mississippi,Calhoun County,1,926,493,433
Mississippi,Calhoun County,2,1029,560,469
Mississippi,Calhoun County,3,1003,502,501
Mississippi,Calhoun County,4,918,468,450
Mississippi,Calhoun County,5,868,404,464
Mississippi,Calhoun County,6,790,402,388
Mississippi,Calhoun County,7,832,414,418
Mississippi,Calhoun County,8,784,363,421
Mississippi,Calhoun County,9,987,476,511
Mississippi,Calhoun County,10,987,466,521
Mississippi,Calhoun County,11,1024,452,572
Mississippi,Calhoun County,12,1032,499,533
Mississippi,Calhoun County,13,966,484,482
Mississippi,Calhoun County,14,790,380,410
Mississippi,Calhoun County,15,626,299,327
Mississippi,Calhoun County,16,485,198,287
Mississippi,Calhoun County,17,339,122,217
Mississippi,Calhoun County,18,359,103,256
Mississippi,Carroll County,0,10254,5232,5022
Mississippi,Carroll County,1,439,245,194
Mississippi,Carroll County,2,625,327,298
Mississippi,Carroll County,3,614,298,316
Mississippi,Carroll County,4,540,305,235
Mississippi,Carroll County,5,607,330,277
Mississippi,Carroll County,6,529,307,222
Mississippi,Carroll County,7,567,307,260
Mississippi,Carroll County,8,554,272,282
Mississippi,Carroll County,9,631,328,303
Mississippi,Carroll County,10,643,322,321
Mississippi,Carroll County,11,749,379,370
Mississippi,Carroll County,12,838,420,418
Mississippi,Carroll County,13,764,385,379
Mississippi,Carroll County,14,741,369,372
Mississippi,Carroll County,15,578,271,307
Mississippi,Carroll County,16,394,199,195
Mississippi,Carroll County,17,207,84,123
Mississippi,Carroll County,18,234,84,150
Mississippi,Chickasaw County,0,17313,8323,8990
Mississippi,Chickasaw County,1,1169,551,618
Mississippi,Chickasaw County,2,1235,612,623
Mississippi,Chickasaw County,3,1191,595,596
Mississippi,Chickasaw County,4,1166,591,575
Mississippi,Chickasaw County,5,1237,625,612
Mississippi,Chickasaw County,6,1056,518,538
Mississippi,Chickasaw County,7,1024,524,500
Mississippi,Chickasaw County,8,1006,517,489
Mississippi,Chickasaw County,9,1013,528,485
Mississippi,Chickasaw County,10,1086,482,604
Mississippi,Chickasaw County,11,1212,571,641
Mississippi,Chickasaw County,12,1177,563,614
Mississippi,Chickasaw County,13,1043,507,536
Mississippi,Chickasaw County,14,830,380,450
Mississippi,Chickasaw County,15,655,290,365
Mississippi,Chickasaw County,16,532,232,300
Mississippi,Chickasaw County,17,366,155,211
Mississippi,Chickasaw County,18,315,82,233
Mississippi,Choctaw County,0,8294,4013,4281
Mississippi,Choctaw County,1,466,248,218
Mississippi,Choctaw County,2,550,277,273
Mississippi,Choctaw County,3,516,269,247
Mississippi,Choctaw County,4,524,284,240
Mississippi,Choctaw County,5,474,217,257
Mississippi,Choctaw County,6,456,240,216
Mississippi,Choctaw County,7,427,216,211
Mississippi,Choctaw County,8,466,207,259
Mississippi,Choctaw County,9,468,229,239
Mississippi,Choctaw County,10,518,254,264
Mississippi,Choctaw County,11,644,329,315
Mississippi,Choctaw County,12,599,299,300
Mississippi,Choctaw County,13,593,272,321
Mississippi,Choctaw County,14,496,246,250
Mississippi,Choctaw County,15,398,168,230
Mississippi,Choctaw County,16,319,132,187
Mississippi,Choctaw County,17,195,54,141
Mississippi,Choctaw County,18,185,72,113
Mississippi,Claiborne County,0,9080,4309,4771
Mississippi,Claiborne County,1,558,286,272
Mississippi,Claiborne County,2,537,262,275
Mississippi,Claiborne County,3,551,278,273
Mississippi,Claiborne County,4,904,442,462
Mississippi,Claiborne County,5,1150,554,596
Mississippi,Claiborne County,6,537,249,288
Mississippi,Claiborne County,7,477,236,241
Mississippi,Claiborne County,8,474,227,247
Mississippi,Claiborne County,9,430,186,244
Mississippi,Claiborne County,10,422,210,212
Mississippi,Claiborne County,11,527,244,283
Mississippi,Claiborne County,12,582,279,303
Mississippi,Claiborne County,13,632,341,291
Mississippi,Claiborne County,14,420,191,229
Mississippi,Claiborne County,15,276,122,154
Mississippi,Claiborne County,16,272,111,161
Mississippi,Claiborne County,17,169,52,117
Mississippi,Claiborne County,18,162,39,123
Mississippi,Clarke County,0,16299,7711,8588
Mississippi,Clarke County,1,897,443,454
Mississippi,Clarke County,2,1073,542,531
Mississippi,Clarke County,3,1127,558,569
Mississippi,Clarke County,4,1038,549,489
Mississippi,Clarke County,5,969,480,489
Mississippi,Clarke County,6,879,413,466
Mississippi,Clarke County,7,924,429,495
Mississippi,Clarke County,8,897,422,475
Mississippi,Clarke County,9,1011,468,543
Mississippi,Clarke County,10,1025,486,539
Mississippi,Clarke County,11,1154,539,615
Mississippi,Clarke County,12,1203,571,632
Mississippi,Clarke County,13,1093,509,584
Mississippi,Clarke County,14,988,467,521
Mississippi,Clarke County,15,760,349,411
Mississippi,Clarke County,16,557,241,316
Mississippi,Clarke County,17,387,145,242
Mississippi,Clarke County,18,317,100,217
Mississippi,Clay County,0,20225,9504,10721
Mississippi,Clay County,1,1242,635,607
Mississippi,Clay County,2,1417,705,712
Mississippi,Clay County,3,1362,703,659
Mississippi,Clay County,4,1331,648,683
Mississippi,Clay County,5,1446,710,736
Mississippi,Clay County,6,1227,586,641
Mississippi,Clay County,7,1189,555,634
Mississippi,Clay County,8,1151,516,635
Mississippi,Clay County,9,1179,555,624
Mississippi,Clay County,10,1179,544,635
Mississippi,Clay County,11,1420,633,787
Mississippi,Clay County,12,1495,694,801
Mississippi,Clay County,13,1285,589,696
Mississippi,Clay County,14,1119,544,575
Mississippi,Clay County,15,719,333,386
Mississippi,Clay County,16,612,271,341
Mississippi,Clay County,17,437,167,270
Mississippi,Clay County,18,415,116,299
Mississippi,Coahoma County,0,24807,11437,13370
Mississippi,Coahoma County,1,2043,1023,1020
Mississippi,Coahoma County,2,1857,944,913
Mississippi,Coahoma County,3,1805,891,914
Mississippi,Coahoma County,4,1911,963,948
Mississippi,Coahoma County,5,1972,917,1055
Mississippi,Coahoma County,6,1562,727,835
Mississippi,Coahoma County,7,1546,660,886
Mississippi,Coahoma County,8,1338,579,759
Mississippi,Coahoma County,9,1332,572,760
Mississippi,Coahoma County,10,1393,617,776
Mississippi,Coahoma County,11,1647,717,930
Mississippi,Coahoma County,12,1647,756,891
Mississippi,Coahoma County,13,1444,683,761
Mississippi,Coahoma County,14,1070,534,536
Mississippi,Coahoma County,15,778,307,471
Mississippi,Coahoma County,16,604,251,353
Mississippi,Coahoma County,17,412,154,258
Mississippi,Coahoma County,18,446,142,304
Mississippi,Copiah County,0,28797,13929,14868
Mississippi,Copiah County,1,1831,976,855
Mississippi,Copiah County,2,1971,991,980
Mississippi,Copiah County,3,1869,957,912
Mississippi,Copiah County,4,2148,1113,1035
Mississippi,Copiah County,5,2179,1127,1052
Mississippi,Copiah County,6,1660,796,864
Mississippi,Copiah County,7,1749,858,891
Mississippi,Copiah County,8,1633,782,851
Mississippi,Copiah County,9,1594,746,848
Mississippi,Copiah County,10,1655,746,909
Mississippi,Copiah County,11,2108,1027,1081
Mississippi,Copiah County,12,2095,1020,1075
Mississippi,Copiah County,13,1856,867,989
Mississippi,Copiah County,14,1476,712,764
Mississippi,Copiah County,15,1092,499,593
Mississippi,Copiah County,16,781,335,446
Mississippi,Copiah County,17,547,205,342
Mississippi,Copiah County,18,553,172,381
Mississippi,Covington County,0,19442,9510,9932
Mississippi,Covington County,1,1390,701,689
Mississippi,Covington County,2,1344,696,648
Mississippi,Covington County,3,1318,695,623
Mississippi,Covington County,4,1196,609,587
Mississippi,Covington County,5,1317,682,635
Mississippi,Covington County,6,1179,552,627
Mississippi,Covington County,7,1238,622,616
Mississippi,Covington County,8,1053,508,545
Mississippi,Covington County,9,1110,549,561
Mississippi,Covington County,10,1233,583,650
Mississippi,Covington County,11,1315,650,665
Mississippi,Covington County,12,1293,652,641
Mississippi,Covington County,13,1149,536,613
Mississippi,Covington County,14,1028,480,548
Mississippi,Covington County,15,821,373,448
Mississippi,Covington County,16,645,278,367
Mississippi,Covington County,17,417,186,231
Mississippi,Covington County,18,396,158,238
Mississippi,DeSoto County,0,170913,82881,88032
Mississippi,DeSoto County,1,10780,5440,5340
Mississippi,DeSoto County,2,12710,6438,6272
Mississippi,DeSoto County,3,13724,7095,6629
Mississippi,DeSoto County,4,12726,6533,6193
Mississippi,DeSoto County,5,10607,5444,5163
Mississippi,DeSoto County,6,10406,5030,5376
Mississippi,DeSoto County,7,11510,5420,6090
Mississippi,DeSoto County,8,12225,5719,6506
Mississippi,DeSoto County,9,13383,6397,6986
Mississippi,DeSoto County,10,11899,5796,6103
Mississippi,DeSoto County,11,11894,5760,6134
Mississippi,DeSoto County,12,10252,4970,5282
Mississippi,DeSoto County,13,8592,4016,4576
Mississippi,DeSoto County,14,7345,3417,3928
Mississippi,DeSoto County,15,5260,2408,2852
Mississippi,DeSoto County,16,3515,1546,1969
Mississippi,DeSoto County,17,2174,831,1343
Mississippi,DeSoto County,18,1911,621,1290
Mississippi,Forrest County,0,76330,36452,39878
Mississippi,Forrest County,1,5221,2676,2545
Mississippi,Forrest County,2,5057,2565,2492
Mississippi,Forrest County,3,4591,2450,2141
Mississippi,Forrest County,4,5743,2550,3193
Mississippi,Forrest County,5,9583,4361,5222
Mississippi,Forrest County,6,5971,3085,2886
Mississippi,Forrest County,7,5362,2636,2726
Mississippi,Forrest County,8,4345,2151,2194
Mississippi,Forrest County,9,4244,2140,2104
Mississippi,Forrest County,10,4121,1941,2180
Mississippi,Forrest County,11,4522,2126,2396
Mississippi,Forrest County,12,4281,2058,2223
Mississippi,Forrest County,13,3595,1631,1964
Mississippi,Forrest County,14,3123,1448,1675
Mississippi,Forrest County,15,2398,1050,1348
Mississippi,Forrest County,16,1694,729,965
Mississippi,Forrest County,17,1229,486,743
Mississippi,Forrest County,18,1250,369,881
Mississippi,Franklin County,0,7833,3819,4014
Mississippi,Franklin County,1,441,216,225
Mississippi,Franklin County,2,569,298,271
Mississippi,Franklin County,3,552,284,268
Mississippi,Franklin County,4,528,280,248
Mississippi,Franklin County,5,416,209,207
Mississippi,Franklin County,6,399,203,196
Mississippi,Franklin County,7,442,204,238
Mississippi,Franklin County,8,418,187,231
Mississippi,Franklin County,9,464,221,243
Mississippi,Franklin County,10,475,228,247
Mississippi,Franklin County,11,561,269,292
Mississippi,Franklin County,12,617,315,302
Mississippi,Franklin County,13,553,283,270
Mississippi,Franklin County,14,419,193,226
Mississippi,Franklin County,15,316,152,164
Mississippi,Franklin County,16,281,138,143
Mississippi,Franklin County,17,198,73,125
Mississippi,Franklin County,18,184,66,118
Mississippi,George County,0,23303,11772,11531
Mississippi,George County,1,1694,857,837
Mississippi,George County,2,1658,830,828
Mississippi,George County,3,1696,842,854
Mississippi,George County,4,1584,815,769
Mississippi,George County,5,1648,887,761
Mississippi,George County,6,1421,748,673
Mississippi,George County,7,1440,760,680
Mississippi,George County,8,1408,724,684
Mississippi,George County,9,1576,843,733
Mississippi,George County,10,1509,760,749
Mississippi,George County,11,1599,822,777
Mississippi,George County,12,1469,752,717
Mississippi,George County,13,1231,580,651
Mississippi,George County,14,1238,587,651
Mississippi,George County,15,950,455,495
Mississippi,George County,16,614,280,334
Mississippi,George County,17,328,144,184
Mississippi,George County,18,240,86,154
Mississippi,Greene County,0,14326,8523,5803
Mississippi,Greene County,1,681,368,313
Mississippi,Greene County,2,840,421,419
Mississippi,Greene County,3,838,457,381
Mississippi,Greene County,4,766,383,383
Mississippi,Greene County,5,1094,721,373
Mississippi,Greene County,6,1221,892,329
Mississippi,Greene County,7,1184,846,338
Mississippi,Greene County,8,1082,723,359
Mississippi,Greene County,9,1093,702,391
Mississippi,Greene County,10,1049,687,362
Mississippi,Greene County,11,974,582,392
Mississippi,Greene County,12,911,501,410
Mississippi,Greene County,13,741,400,341
Mississippi,Greene County,14,640,318,322
Mississippi,Greene County,15,488,254,234
Mississippi,Greene County,16,350,143,207
Mississippi,Greene County,17,214,79,135
Mississippi,Greene County,18,160,46,114
Mississippi,Grenada County,0,21666,10249,11417
Mississippi,Grenada County,1,1350,668,682
Mississippi,Grenada County,2,1487,777,710
Mississippi,Grenada County,3,1421,728,693
Mississippi,Grenada County,4,1401,721,680
Mississippi,Grenada County,5,1477,707,770
Mississippi,Grenada County,6,1234,573,661
Mississippi,Grenada County,7,1256,576,680
Mississippi,Grenada County,8,1287,599,688
Mississippi,Grenada County,9,1348,618,730
Mississippi,Grenada County,10,1427,669,758
Mississippi,Grenada County,11,1523,725,798
Mississippi,Grenada County,12,1514,735,779
Mississippi,Grenada County,13,1352,633,719
Mississippi,Grenada County,14,1191,571,620
Mississippi,Grenada County,15,884,377,507
Mississippi,Grenada County,16,658,281,377
Mississippi,Grenada County,17,428,161,267
Mississippi,Grenada County,18,428,130,298
Mississippi,Hancock County,0,45949,22539,23410
Mississippi,Hancock County,1,2498,1323,1175
Mississippi,Hancock County,2,2830,1404,1426
Mississippi,Hancock County,3,3009,1520,1489
Mississippi,Hancock County,4,2809,1480,1329
Mississippi,Hancock County,5,2627,1339,1288
Mississippi,Hancock County,6,2770,1367,1403
Mississippi,Hancock County,7,2683,1282,1401
Mississippi,Hancock County,8,2572,1238,1334
Mississippi,Hancock County,9,2889,1412,1477
Mississippi,Hancock County,10,3047,1488,1559
Mississippi,Hancock County,11,3511,1714,1797
Mississippi,Hancock County,12,3584,1776,1808
Mississippi,Hancock County,13,3148,1473,1675
Mississippi,Hancock County,14,2782,1345,1437
Mississippi,Hancock County,15,2081,997,1084
Mississippi,Hancock County,16,1492,716,776
Mississippi,Hancock County,17,908,418,490
Mississippi,Hancock County,18,709,247,462
Mississippi,Harrison County,0,199058,98717,100341
Mississippi,Harrison County,1,13957,7203,6754
Mississippi,Harrison County,2,14017,7226,6791
Mississippi,Harrison County,3,13053,6640,6413
Mississippi,Harrison County,4,12765,6836,5929
Mississippi,Harrison County,5,15440,8373,7067
Mississippi,Harrison County,6,14724,7324,7400
Mississippi,Harrison County,7,14048,6852,7196
Mississippi,Harrison County,8,12492,6225,6267
Mississippi,Harrison County,9,12031,5824,6207
Mississippi,Harrison County,10,12031,5864,6167
Mississippi,Harrison County,11,14073,6869,7204
Mississippi,Harrison County,12,13004,6315,6689
Mississippi,Harrison County,13,11080,5197,5883
Mississippi,Harrison County,14,8926,4296,4630
Mississippi,Harrison County,15,6627,3062,3565
Mississippi,Harrison County,16,4596,2105,2491
Mississippi,Harrison County,17,3328,1448,1880
Mississippi,Harrison County,18,2866,1058,1808
Mississippi,Hinds County,0,243729,113973,129756
Mississippi,Hinds County,1,16431,8338,8093
Mississippi,Hinds County,2,17577,8990,8587
Mississippi,Hinds County,3,17117,8646,8471
Mississippi,Hinds County,4,18394,9145,9249
Mississippi,Hinds County,5,20561,9847,10714
Mississippi,Hinds County,6,18470,8561,9909
Mississippi,Hinds County,7,17020,7975,9045
Mississippi,Hinds County,8,14578,6681,7897
Mississippi,Hinds County,9,14238,6481,7757
Mississippi,Hinds County,10,14151,6473,7678
Mississippi,Hinds County,11,16296,7473,8823
Mississippi,Hinds County,12,15941,7280,8661
Mississippi,Hinds County,13,13585,6181,7404
Mississippi,Hinds County,14,9892,4517,5375
Mississippi,Hinds County,15,6883,2900,3983
Mississippi,Hinds County,16,5017,1984,3033
Mississippi,Hinds County,17,3687,1363,2324
Mississippi,Hinds County,18,3891,1138,2753
Mississippi,Holmes County,0,18459,8821,9638
Mississippi,Holmes County,1,1426,734,692
Mississippi,Holmes County,2,1463,787,676
Mississippi,Holmes County,3,1314,684,630
Mississippi,Holmes County,4,1446,695,751
Mississippi,Holmes County,5,1654,866,788
Mississippi,Holmes County,6,1200,608,592
Mississippi,Holmes County,7,1076,506,570
Mississippi,Holmes County,8,961,443,518
Mississippi,Holmes County,9,958,425,533
Mississippi,Holmes County,10,1012,463,549
Mississippi,Holmes County,11,1242,551,691
Mississippi,Holmes County,12,1222,585,637
Mississippi,Holmes County,13,997,438,559
Mississippi,Holmes County,14,772,361,411
Mississippi,Holmes County,15,596,284,312
Mississippi,Holmes County,16,460,179,281
Mississippi,Holmes County,17,288,101,187
Mississippi,Holmes County,18,372,111,261
Mississippi,Humphreys County,0,8741,4115,4626
Mississippi,Humphreys County,1,648,342,306
Mississippi,Humphreys County,2,763,385,378
Mississippi,Humphreys County,3,659,344,315
Mississippi,Humphreys County,4,524,276,248
Mississippi,Humphreys County,5,601,302,299
Mississippi,Humphreys County,6,528,249,279
Mississippi,Humphreys County,7,579,258,321
Mississippi,Humphreys County,8,440,208,232
Mississippi,Humphreys County,9,460,193,267
Mississippi,Humphreys County,10,515,224,291
Mississippi,Humphreys County,11,618,282,336
Mississippi,Humphreys County,12,621,282,339
Mississippi,Humphreys County,13,542,256,286
Mississippi,Humphreys County,14,397,187,210
Mississippi,Humphreys County,15,307,133,174
Mississippi,Humphreys County,16,238,104,134
Mississippi,Humphreys County,17,145,66,79
Mississippi,Humphreys County,18,156,24,132
Mississippi,Issaquena County,0,1397,830,567
Mississippi,Issaquena County,1,45,25,20
Mississippi,Issaquena County,2,50,20,30
Mississippi,Issaquena County,3,61,34,27
Mississippi,Issaquena County,4,112,87,25
Mississippi,Issaquena County,5,141,95,46
Mississippi,Issaquena County,6,156,122,34
Mississippi,Issaquena County,7,83,44,39
Mississippi,Issaquena County,8,82,51,31
Mississippi,Issaquena County,9,69,43,26
Mississippi,Issaquena County,10,104,57,47
Mississippi,Issaquena County,11,110,55,55
Mississippi,Issaquena County,12,124,73,51
Mississippi,Issaquena County,13,68,34,34
Mississippi,Issaquena County,14,50,25,25
Mississippi,Issaquena County,15,50,25,25
Mississippi,Issaquena County,16,47,20,27
Mississippi,Issaquena County,17,32,16,16
Mississippi,Issaquena County,18,13,4,9
Mississippi,Itawamba County,0,23527,11554,11973
Mississippi,Itawamba County,1,1401,706,695
Mississippi,Itawamba County,2,1428,745,683
Mississippi,Itawamba County,3,1446,740,706
Mississippi,Itawamba County,4,1796,890,906
Mississippi,Itawamba County,5,1716,900,816
Mississippi,Itawamba County,6,1377,700,677
Mississippi,Itawamba County,7,1301,651,650
Mississippi,Itawamba County,8,1330,656,674
Mississippi,Itawamba County,9,1578,748,830
Mississippi,Itawamba County,10,1547,781,766
Mississippi,Itawamba County,11,1634,830,804
Mississippi,Itawamba County,12,1505,774,731
Mississippi,Itawamba County,13,1367,674,693
Mississippi,Itawamba County,14,1248,566,682
Mississippi,Itawamba County,15,1119,490,629
Mississippi,Itawamba County,16,753,337,416
Mississippi,Itawamba County,17,491,206,285
Mississippi,Itawamba County,18,490,160,330
Mississippi,Jackson County,0,141137,69361,71776
Mississippi,Jackson County,1,8267,4215,4052
Mississippi,Jackson County,2,9900,5047,4853
Mississippi,Jackson County,3,10163,5173,4990
Mississippi,Jackson County,4,8994,4627,4367
Mississippi,Jackson County,5,9209,4676,4533
Mississippi,Jackson County,6,9133,4538,4595
Mississippi,Jackson County,7,9308,4564,4744
Mississippi,Jackson County,8,8951,4366,4585
Mississippi,Jackson County,9,9291,4491,4800
Mississippi,Jackson County,10,9367,4624,4743
Mississippi,Jackson County,11,10471,5112,5359
Mississippi,Jackson County,12,9895,4881,5014
Mississippi,Jackson County,13,8162,3949,4213
Mississippi,Jackson County,14,6904,3306,3598
Mississippi,Jackson County,15,5197,2446,2751
Mississippi,Jackson County,16,3833,1742,2091
Mississippi,Jackson County,17,2241,971,1270
Mississippi,Jackson County,18,1851,633,1218
Mississippi,Jasper County,0,16601,8087,8514
Mississippi,Jasper County,1,1124,608,516
Mississippi,Jasper County,2,1084,535,549
Mississippi,Jasper County,3,998,489,509
Mississippi,Jasper County,4,1082,539,543
Mississippi,Jasper County,5,1058,526,532
Mississippi,Jasper County,6,855,413,442
Mississippi,Jasper County,7,958,492,466
Mississippi,Jasper County,8,889,413,476
Mississippi,Jasper County,9,954,466,488
Mississippi,Jasper County,10,1028,517,511
Mississippi,Jasper County,11,1176,559,617
Mississippi,Jasper County,12,1272,610,662
Mississippi,Jasper County,13,1135,544,591
Mississippi,Jasper County,14,957,470,487
Mississippi,Jasper County,15,750,361,389
Mississippi,Jasper County,16,604,281,323
Mississippi,Jasper County,17,349,156,193
Mississippi,Jasper County,18,328,108,220
Mississippi,Jefferson County,0,7599,3786,3813
Mississippi,Jefferson County,1,519,247,272
Mississippi,Jefferson County,2,476,264,212
Mississippi,Jefferson County,3,486,254,232
Mississippi,Jefferson County,4,459,227,232
Mississippi,Jefferson County,5,564,313,251
Mississippi,Jefferson County,6,530,293,237
Mississippi,Jefferson County,7,530,282,248
Mississippi,Jefferson County,8,438,233,205
Mississippi,Jefferson County,9,437,224,213
Mississippi,Jefferson County,10,440,207,233
Mississippi,Jefferson County,11,579,286,293
Mississippi,Jefferson County,12,599,293,306
Mississippi,Jefferson County,13,483,224,259
Mississippi,Jefferson County,14,334,156,178
Mississippi,Jefferson County,15,234,103,131
Mississippi,Jefferson County,16,207,83,124
Mississippi,Jefferson County,17,132,50,82
Mississippi,Jefferson County,18,152,47,105
Mississippi,Jefferson Davis County,0,11822,5628,6194
Mississippi,Jefferson Davis County,1,693,351,342
Mississippi,Jefferson Davis County,2,701,341,360
Mississippi,Jefferson Davis County,3,643,340,303
Mississippi,Jefferson Davis County,4,741,390,351
Mississippi,Jefferson Davis County,5,798,385,413
Mississippi,Jefferson Davis County,6,657,317,340
Mississippi,Jefferson Davis County,7,605,296,309
Mississippi,Jefferson Davis County,8,684,350,334
Mississippi,Jefferson Davis County,9,715,340,375
Mississippi,Jefferson Davis County,10,728,350,378
Mississippi,Jefferson Davis County,11,840,374,466
Mississippi,Jefferson Davis County,12,902,425,477
Mississippi,Jefferson Davis County,13,832,387,445
Mississippi,Jefferson Davis County,14,764,343,421
Mississippi,Jefferson Davis County,15,621,291,330
Mississippi,Jefferson Davis County,16,389,194,195
Mississippi,Jefferson Davis County,17,243,89,154
Mississippi,Jefferson Davis County,18,266,65,201
Mississippi,Jones County,0,68290,33156,35134
Mississippi,Jones County,1,4934,2500,2434
Mississippi,Jones County,2,5002,2580,2422
Mississippi,Jones County,3,4766,2449,2317
Mississippi,Jones County,4,4664,2388,2276
Mississippi,Jones County,5,4468,2167,2301
Mississippi,Jones County,6,4189,2021,2168
Mississippi,Jones County,7,4416,2141,2275
Mississippi,Jones County,8,3856,1873,1983
Mississippi,Jones County,9,4085,2047,2038
Mississippi,Jones County,10,3990,1982,2008
Mississippi,Jones County,11,4538,2207,2331
Mississippi,Jones County,12,4750,2303,2447
Mississippi,Jones County,13,4032,1916,2116
Mississippi,Jones County,14,3454,1644,1810
Mississippi,Jones County,15,2550,1141,1409
Mississippi,Jones County,16,1952,831,1121
Mississippi,Jones County,17,1436,556,880
Mississippi,Jones County,18,1208,410,798
Mississippi,Kemper County,0,10163,5097,5066
Mississippi,Kemper County,1,441,242,199
Mississippi,Kemper County,2,658,340,318
Mississippi,Kemper County,3,644,339,305
Mississippi,Kemper County,4,823,436,387
Mississippi,Kemper County,5,813,434,379
Mississippi,Kemper County,6,591,313,278
Mississippi,Kemper County,7,585,329,256
Mississippi,Kemper County,8,549,292,257
Mississippi,Kemper County,9,651,312,339
Mississippi,Kemper County,10,614,291,323
Mississippi,Kemper County,11,685,326,359
Mississippi,Kemper County,12,697,339,358
Mississippi,Kemper County,13,659,319,340
Mississippi,Kemper County,14,571,286,285
Mississippi,Kemper County,15,382,185,197
Mississippi,Kemper County,16,320,134,186
Mississippi,Kemper County,17,244,101,143
Mississippi,Kemper County,18,236,79,157
Mississippi,Lafayette County,0,52930,25821,27109
Mississippi,Lafayette County,1,2850,1449,1401
Mississippi,Lafayette County,2,2717,1437,1280
Mississippi,Lafayette County,3,2576,1310,1266
Mississippi,Lafayette County,4,6003,2834,3169
Mississippi,Lafayette County,5,9440,4575,4865
Mississippi,Lafayette County,6,4019,2095,1924
Mississippi,Lafayette County,7,3264,1681,1583
Mississippi,Lafayette County,8,2991,1489,1502
Mississippi,Lafayette County,9,2803,1429,1374
Mississippi,Lafayette County,10,2449,1186,1263
Mississippi,Lafayette County,11,2692,1277,1415
Mississippi,Lafayette County,12,2695,1313,1382
Mississippi,Lafayette County,13,2475,1151,1324
Mississippi,Lafayette County,14,1994,961,1033
Mississippi,Lafayette County,15,1518,712,806
Mississippi,Lafayette County,16,1026,434,592
Mississippi,Lafayette County,17,732,288,444
Mississippi,Lafayette County,18,686,200,486
Mississippi,Lamar County,0,60099,28944,31155
Mississippi,Lamar County,1,4163,2130,2033
Mississippi,Lamar County,2,4487,2231,2256
Mississippi,Lamar County,3,4311,2162,2149
Mississippi,Lamar County,4,3793,1959,1834
Mississippi,Lamar County,5,4348,2118,2230
Mississippi,Lamar County,6,4743,2236,2507
Mississippi,Lamar County,7,4607,2136,2471
Mississippi,Lamar County,8,4302,2089,2213
Mississippi,Lamar County,9,4164,2064,2100
Mississippi,Lamar County,10,3777,1833,1944
Mississippi,Lamar County,11,3834,1789,2045
Mississippi,Lamar County,12,3549,1676,1873
Mississippi,Lamar County,13,3056,1462,1594
Mississippi,Lamar County,14,2483,1181,1302
Mississippi,Lamar County,15,1717,798,919
Mississippi,Lamar County,16,1233,519,714
Mississippi,Lamar County,17,765,289,476
Mississippi,Lamar County,18,767,272,495
Mississippi,Lauderdale County,0,79739,38628,41111
Mississippi,Lauderdale County,1,5100,2598,2502
Mississippi,Lauderdale County,2,5550,2801,2749
Mississippi,Lauderdale County,3,5380,2754,2626
Mississippi,Lauderdale County,4,5299,2782,2517
Mississippi,Lauderdale County,5,5938,3055,2883
Mississippi,Lauderdale County,6,5252,2664,2588
Mississippi,Lauderdale County,7,5262,2605,2657
Mississippi,Lauderdale County,8,4548,2218,2330
Mississippi,Lauderdale County,9,4905,2332,2573
Mississippi,Lauderdale County,10,4985,2383,2602
Mississippi,Lauderdale County,11,5333,2594,2739
Mississippi,Lauderdale County,12,5327,2579,2748
Mississippi,Lauderdale County,13,4818,2236,2582
Mississippi,Lauderdale County,14,3805,1792,2013
Mississippi,Lauderdale County,15,2801,1248,1553
Mississippi,Lauderdale County,16,2234,953,1281
Mississippi,Lauderdale County,17,1564,539,1025
Mississippi,Lauderdale County,18,1638,495,1143
Mississippi,Lawrence County,0,12502,6130,6372
Mississippi,Lawrence County,1,763,422,341
Mississippi,Lawrence County,2,896,457,439
Mississippi,Lawrence County,3,855,409,446
Mississippi,Lawrence County,4,776,389,387
Mississippi,Lawrence County,5,750,381,369
Mississippi,Lawrence County,6,719,356,363
Mississippi,Lawrence County,7,770,393,377
Mississippi,Lawrence County,8,671,317,354
Mississippi,Lawrence County,9,736,348,388
Mississippi,Lawrence County,10,842,389,453
Mississippi,Lawrence County,11,941,470,471
Mississippi,Lawrence County,12,932,461,471
Mississippi,Lawrence County,13,831,426,405
Mississippi,Lawrence County,14,671,332,339
Mississippi,Lawrence County,15,527,228,299
Mississippi,Lawrence County,16,393,175,218
Mississippi,Lawrence County,17,257,118,139
Mississippi,Lawrence County,18,172,59,113
Mississippi,Leake County,0,23193,12078,11115
Mississippi,Leake County,1,1553,815,738
Mississippi,Leake County,2,1678,918,760
Mississippi,Leake County,3,1854,1169,685
Mississippi,Leake County,4,1937,1345,592
Mississippi,Leake County,5,1590,858,732
Mississippi,Leake County,6,1428,731,697
Mississippi,Leake County,7,1488,743,745
Mississippi,Leake County,8,1356,679,677
Mississippi,Leake County,9,1403,668,735
Mississippi,Leake County,10,1351,658,693
Mississippi,Leake County,11,1427,736,691
Mississippi,Leake County,12,1458,702,756
Mississippi,Leake County,13,1322,618,704
Mississippi,Leake County,14,1114,552,562
Mississippi,Leake County,15,795,360,435
Mississippi,Leake County,16,629,244,385
Mississippi,Leake County,17,447,150,297
Mississippi,Leake County,18,363,132,231
Mississippi,Lee County,0,85246,40711,44535
Mississippi,Lee County,1,5967,2957,3010
Mississippi,Lee County,2,6253,3229,3024
Mississippi,Lee County,3,6187,3233,2954
Mississippi,Lee County,4,5443,2761,2682
Mississippi,Lee County,5,5480,2699,2781
Mississippi,Lee County,6,5335,2494,2841
Mississippi,Lee County,7,5740,2749,2991
Mississippi,Lee County,8,5395,2510,2885
Mississippi,Lee County,9,5694,2795,2899
Mississippi,Lee County,10,5562,2704,2858
Mississippi,Lee County,11,5873,2809,3064
Mississippi,Lee County,12,5501,2538,2963
Mississippi,Lee County,13,4599,2108,2491
Mississippi,Lee County,14,4053,1901,2152
Mississippi,Lee County,15,2998,1326,1672
Mississippi,Lee County,16,2290,952,1338
Mississippi,Lee County,17,1415,532,883
Mississippi,Lee County,18,1461,414,1047
Mississippi,Leflore County,0,31422,15103,16319
Mississippi,Leflore County,1,2323,1197,1126
Mississippi,Leflore County,2,2565,1339,1226
Mississippi,Leflore County,3,2265,1145,1120
Mississippi,Leflore County,4,2319,1153,1166
Mississippi,Leflore County,5,2655,1323,1332
Mississippi,Leflore County,6,2197,1128,1069
Mississippi,Leflore County,7,2082,1025,1057
Mississippi,Leflore County,8,1946,978,968
Mississippi,Leflore County,9,1751,808,943
Mississippi,Leflore County,10,1725,819,906
Mississippi,Leflore County,11,1950,925,1025
Mississippi,Leflore County,12,1996,901,1095
Mississippi,Leflore County,13,1698,775,923
Mississippi,Leflore County,14,1214,573,641
Mississippi,Leflore County,15,931,382,549
Mississippi,Leflore County,16,684,276,408
Mississippi,Leflore County,17,515,167,348
Mississippi,Leflore County,18,606,189,417
Mississippi,Lincoln County,0,34775,16624,18151
Mississippi,Lincoln County,1,2189,1118,1071
Mississippi,Lincoln County,2,2534,1313,1221
Mississippi,Lincoln County,3,2304,1145,1159
Mississippi,Lincoln County,4,2357,1158,1199
Mississippi,Lincoln County,5,2245,1105,1140
Mississippi,Lincoln County,6,1959,967,992
Mississippi,Lincoln County,7,2233,1062,1171
Mississippi,Lincoln County,8,2100,1027,1073
Mississippi,Lincoln County,9,2284,1095,1189
Mississippi,Lincoln County,10,2098,1010,1088
Mississippi,Lincoln County,11,2435,1140,1295
Mississippi,Lincoln County,12,2455,1172,1283
Mississippi,Lincoln County,13,2166,1005,1161
Mississippi,Lincoln County,14,1817,899,918
Mississippi,Lincoln County,15,1296,565,731
Mississippi,Lincoln County,16,928,381,547
Mississippi,Lincoln County,17,701,254,447
Mississippi,Lincoln County,18,674,208,466
Mississippi,Lowndes County,0,59730,28443,31287
Mississippi,Lowndes County,1,3996,1985,2011
Mississippi,Lowndes County,2,4088,2086,2002
Mississippi,Lowndes County,3,4004,2049,1955
Mississippi,Lowndes County,4,3779,1856,1923
Mississippi,Lowndes County,5,4722,2307,2415
Mississippi,Lowndes County,6,4268,2119,2149
Mississippi,Lowndes County,7,3914,1941,1973
Mississippi,Lowndes County,8,3483,1614,1869
Mississippi,Lowndes County,9,3506,1613,1893
Mississippi,Lowndes County,10,3684,1752,1932
Mississippi,Lowndes County,11,4087,1929,2158
Mississippi,Lowndes County,12,4105,1924,2181
Mississippi,Lowndes County,13,3481,1663,1818
Mississippi,Lowndes County,14,2881,1343,1538
Mississippi,Lowndes County,15,1998,940,1058
Mississippi,Lowndes County,16,1538,604,934
Mississippi,Lowndes County,17,1125,425,700
Mississippi,Lowndes County,18,1071,293,778
Mississippi,Madison County,0,101688,48753,52935
Mississippi,Madison County,1,6632,3437,3195
Mississippi,Madison County,2,7519,3944,3575
Mississippi,Madison County,3,7453,3765,3688
Mississippi,Madison County,4,7070,3555,3515
Mississippi,Madison County,5,6394,3152,3242
Mississippi,Madison County,6,6456,3045,3411
Mississippi,Madison County,7,7086,3361,3725
Mississippi,Madison County,8,6795,3186,3609
Mississippi,Madison County,9,6813,3243,3570
Mississippi,Madison County,10,6785,3214,3571
Mississippi,Madison County,11,7512,3577,3935
Mississippi,Madison County,12,6782,3195,3587
Mississippi,Madison County,13,5876,2723,3153
Mississippi,Madison County,14,4626,2229,2397
Mississippi,Madison County,15,2840,1324,1516
Mississippi,Madison County,16,2038,831,1207
Mississippi,Madison County,17,1389,515,874
Mississippi,Madison County,18,1622,457,1165
Mississippi,Marion County,0,25868,12507,13361
Mississippi,Marion County,1,1676,845,831
Mississippi,Marion County,2,1847,907,940
Mississippi,Marion County,3,1717,896,821
Mississippi,Marion County,4,1606,803,803
Mississippi,Marion County,5,1620,806,814
Mississippi,Marion County,6,1584,793,791
Mississippi,Marion County,7,1679,831,848
Mississippi,Marion County,8,1522,787,735
Mississippi,Marion County,9,1582,777,805
Mississippi,Marion County,10,1519,728,791
Mississippi,Marion County,11,1825,879,946
Mississippi,Marion County,12,1773,859,914
Mississippi,Marion County,13,1611,779,832
Mississippi,Marion County,14,1391,663,728
Mississippi,Marion County,15,984,438,546
Mississippi,Marion County,16,779,328,451
Mississippi,Marion County,17,606,234,372
Mississippi,Marion County,18,547,154,393
Mississippi,Marshall County,0,36234,17893,18341
Mississippi,Marshall County,1,2128,1044,1084
Mississippi,Marshall County,2,2307,1155,1152
Mississippi,Marshall County,3,2215,1097,1118
Mississippi,Marshall County,4,2381,1102,1279
Mississippi,Marshall County,5,2544,1258,1286
Mississippi,Marshall County,6,2222,1186,1036
Mississippi,Marshall County,7,2190,1135,1055
Mississippi,Marshall County,8,2180,1167,1013
Mississippi,Marshall County,9,2277,1187,1090
Mississippi,Marshall County,10,2375,1242,1133
Mississippi,Marshall County,11,2777,1400,1377
Mississippi,Marshall County,12,2816,1395,1421
Mississippi,Marshall County,13,2388,1140,1248
Mississippi,Marshall County,14,1878,892,986
Mississippi,Marshall County,15,1408,649,759
Mississippi,Marshall County,16,958,415,543
Mississippi,Marshall County,17,604,247,357
Mississippi,Marshall County,18,586,182,404
Mississippi,Monroe County,0,36003,17296,18707
Mississippi,Monroe County,1,2024,1139,885
Mississippi,Monroe County,2,2448,1232,1216
Mississippi,Monroe County,3,2438,1200,1238
Mississippi,Monroe County,4,2154,1093,1061
Mississippi,Monroe County,5,2323,1158,1165
Mississippi,Monroe County,6,2104,1029,1075
Mississippi,Monroe County,7,2073,1001,1072
Mississippi,Monroe County,8,2051,993,1058
Mississippi,Monroe County,9,2284,1106,1178
Mississippi,Monroe County,10,2380,1145,1235
Mississippi,Monroe County,11,2541,1191,1350
Mississippi,Monroe County,12,2553,1230,1323
Mississippi,Monroe County,13,2297,1088,1209
Mississippi,Monroe County,14,2124,1021,1103
Mississippi,Monroe County,15,1486,653,833
Mississippi,Monroe County,16,1223,530,693
Mississippi,Monroe County,17,754,255,499
Mississippi,Monroe County,18,746,232,514
Mississippi,Montgomery County,0,10400,4972,5428
Mississippi,Montgomery County,1,644,330,314
Mississippi,Montgomery County,2,718,375,343
Mississippi,Montgomery County,3,624,317,307
Mississippi,Montgomery County,4,600,313,287
Mississippi,Montgomery County,5,673,336,337
Mississippi,Montgomery County,6,536,248,288
Mississippi,Montgomery County,7,553,261,292
Mississippi,Montgomery County,8,517,252,265
Mississippi,Montgomery County,9,573,253,320
Mississippi,Montgomery County,10,690,330,360
Mississippi,Montgomery County,11,797,373,424
Mississippi,Montgomery County,12,758,356,402
Mississippi,Montgomery County,13,740,370,370
Mississippi,Montgomery County,14,658,313,345
Mississippi,Montgomery County,15,484,239,245
Mississippi,Montgomery County,16,347,141,206
Mississippi,Montgomery County,17,239,87,152
Mississippi,Montgomery County,18,249,78,171
Mississippi,Neshoba County,0,29465,14090,15375
Mississippi,Neshoba County,1,2183,1066,1117
Mississippi,Neshoba County,2,2501,1292,1209
Mississippi,Neshoba County,3,2324,1194,1130
Mississippi,Neshoba County,4,1991,971,1020
Mississippi,Neshoba County,5,1856,895,961
Mississippi,Neshoba County,6,1756,820,936
Mississippi,Neshoba County,7,1794,864,930
Mississippi,Neshoba County,8,1732,820,912
Mississippi,Neshoba County,9,1776,834,942
Mississippi,Neshoba County,10,1726,807,919
Mississippi,Neshoba County,11,1850,916,934
Mississippi,Neshoba County,12,1932,917,1015
Mississippi,Neshoba County,13,1725,852,873
Mississippi,Neshoba County,14,1429,679,750
Mississippi,Neshoba County,15,970,442,528
Mississippi,Neshoba County,16,785,349,436
Mississippi,Neshoba County,17,560,187,373
Mississippi,Neshoba County,18,575,185,390
Mississippi,Newton County,0,21832,10481,11351
Mississippi,Newton County,1,1480,745,735
Mississippi,Newton County,2,1637,809,828
Mississippi,Newton County,3,1533,789,744
Mississippi,Newton County,4,1641,865,776
Mississippi,Newton County,5,1573,768,805
Mississippi,Newton County,6,1185,554,631
Mississippi,Newton County,7,1257,577,680
Mississippi,Newton County,8,1323,665,658
Mississippi,Newton County,9,1387,660,727
Mississippi,Newton County,10,1333,645,688
Mississippi,Newton County,11,1355,679,676
Mississippi,Newton County,12,1374,636,738
Mississippi,Newton County,13,1215,557,658
Mississippi,Newton County,14,1124,539,585
Mississippi,Newton County,15,866,385,481
Mississippi,Newton County,16,636,275,361
Mississippi,Newton County,17,483,198,285
Mississippi,Newton County,18,430,135,295
Mississippi,Noxubee County,0,11115,5351,5764
Mississippi,Noxubee County,1,770,413,357
Mississippi,Noxubee County,2,772,393,379
Mississippi,Noxubee County,3,765,388,377
Mississippi,Noxubee County,4,788,388,400
Mississippi,Noxubee County,5,841,444,397
Mississippi,Noxubee County,6,709,362,347
Mississippi,Noxubee County,7,655,322,333
Mississippi,Noxubee County,8,558,252,306
Mississippi,Noxubee County,9,645,307,338
Mississippi,Noxubee County,10,633,272,361
Mississippi,Noxubee County,11,759,348,411
Mississippi,Noxubee County,12,842,406,436
Mississippi,Noxubee County,13,630,331,299
Mississippi,Noxubee County,14,540,236,304
Mississippi,Noxubee County,15,412,179,233
Mississippi,Noxubee County,16,360,173,187
Mississippi,Noxubee County,17,204,82,122
Mississippi,Noxubee County,18,232,55,177
Mississippi,Oktibbeha County,0,49414,24516,24898
Mississippi,Oktibbeha County,1,2672,1309,1363
Mississippi,Oktibbeha County,2,2530,1274,1256
Mississippi,Oktibbeha County,3,2372,1231,1141
Mississippi,Oktibbeha County,4,5209,2518,2691
Mississippi,Oktibbeha County,5,11564,6226,5338
Mississippi,Oktibbeha County,6,3791,1970,1821
Mississippi,Oktibbeha County,7,2962,1521,1441
Mississippi,Oktibbeha County,8,2216,1061,1155
Mississippi,Oktibbeha County,9,2108,1027,1081
Mississippi,Oktibbeha County,10,2025,938,1087
Mississippi,Oktibbeha County,11,2448,1125,1323
Mississippi,Oktibbeha County,12,2442,1147,1295
Mississippi,Oktibbeha County,13,2004,943,1061
Mississippi,Oktibbeha County,14,1584,742,842
Mississippi,Oktibbeha County,15,1238,569,669
Mississippi,Oktibbeha County,16,930,430,500
Mississippi,Oktibbeha County,17,651,260,391
Mississippi,Oktibbeha County,18,668,225,443
Mississippi,Panola County,0,34444,16622,17822
Mississippi,Panola County,1,2484,1283,1201
Mississippi,Panola County,2,2485,1301,1184
Mississippi,Panola County,3,2448,1265,1183
Mississippi,Panola County,4,2363,1211,1152
Mississippi,Panola County,5,2439,1205,1234
Mississippi,Panola County,6,2135,1002,1133
Mississippi,Panola County,7,2105,996,1109
Mississippi,Panola County,8,1961,887,1074
Mississippi,Panola County,9,2088,1010,1078
Mississippi,Panola County,10,2167,995,1172
Mississippi,Panola County,11,2434,1181,1253
Mississippi,Panola County,12,2400,1175,1225
Mississippi,Panola County,13,2044,979,1065
Mississippi,Panola County,14,1677,780,897
Mississippi,Panola County,15,1248,552,696
Mississippi,Panola County,16,864,376,488
Mississippi,Panola County,17,581,221,360
Mississippi,Panola County,18,521,203,318
Mississippi,Pearl River County,0,55224,27319,27905
Mississippi,Pearl River County,1,3263,1719,1544
Mississippi,Pearl River County,2,3732,1847,1885
Mississippi,Pearl River County,3,3644,1911,1733
Mississippi,Pearl River County,4,3761,2003,1758
Mississippi,Pearl River County,5,3619,1933,1686
Mississippi,Pearl River County,6,3149,1526,1623
Mississippi,Pearl River County,7,3090,1527,1563
Mississippi,Pearl River County,8,3115,1474,1641
Mississippi,Pearl River County,9,3384,1693,1691
Mississippi,Pearl River County,10,3544,1726,1818
Mississippi,Pearl River County,11,3918,1967,1951
Mississippi,Pearl River County,12,3788,1841,1947
Mississippi,Pearl River County,13,3725,1778,1947
Mississippi,Pearl River County,14,3326,1606,1720
Mississippi,Pearl River County,15,2510,1193,1317
Mississippi,Pearl River County,16,1674,799,875
Mississippi,Pearl River County,17,1111,470,641
Mississippi,Pearl River County,18,871,306,565
Mississippi,Perry County,0,12227,5948,6279
Mississippi,Perry County,1,762,382,380
Mississippi,Perry County,2,842,449,393
Mississippi,Perry County,3,765,402,363
Mississippi,Perry County,4,785,412,373
Mississippi,Perry County,5,792,403,389
Mississippi,Perry County,6,665,300,365
Mississippi,Perry County,7,718,352,366
Mississippi,Perry County,8,697,346,351
Mississippi,Perry County,9,760,363,397
Mississippi,Perry County,10,783,404,379
Mississippi,Perry County,11,909,437,472
Mississippi,Perry County,12,890,429,461
Mississippi,Perry County,13,762,372,390
Mississippi,Perry County,14,708,335,373
Mississippi,Perry County,15,556,240,316
Mississippi,Perry County,16,406,177,229
Mississippi,Perry County,17,243,89,154
Mississippi,Perry County,18,184,56,128
Mississippi,Pike County,0,40058,18995,21063
Mississippi,Pike County,1,2806,1404,1402
Mississippi,Pike County,2,3054,1540,1514
Mississippi,Pike County,3,3085,1609,1476
Mississippi,Pike County,4,2820,1462,1358
Mississippi,Pike County,5,2717,1380,1337
Mississippi,Pike County,6,2179,1047,1132
Mississippi,Pike County,7,2397,1102,1295
Mississippi,Pike County,8,2372,1071,1301
Mississippi,Pike County,9,2316,1042,1274
Mississippi,Pike County,10,2300,1104,1196
Mississippi,Pike County,11,2577,1185,1392
Mississippi,Pike County,12,2630,1237,1393
Mississippi,Pike County,13,2539,1117,1422
Mississippi,Pike County,14,2077,973,1104
Mississippi,Pike County,15,1491,682,809
Mississippi,Pike County,16,1109,484,625
Mississippi,Pike County,17,778,298,480
Mississippi,Pike County,18,811,258,553
Mississippi,Pontotoc County,0,30950,15358,15592
Mississippi,Pontotoc County,1,2098,1108,990
Mississippi,Pontotoc County,2,2432,1262,1170
Mississippi,Pontotoc County,3,2350,1198,1152
Mississippi,Pontotoc County,4,2068,1039,1029
Mississippi,Pontotoc County,5,1912,992,920
Mississippi,Pontotoc County,6,1982,1018,964
Mississippi,Pontotoc County,7,2045,1029,1016
Mississippi,Pontotoc County,8,1908,962,946
Mississippi,Pontotoc County,9,1973,946,1027
Mississippi,Pontotoc County,10,2033,1026,1007
Mississippi,Pontotoc County,11,2235,1094,1141
Mississippi,Pontotoc County,12,1920,981,939
Mississippi,Pontotoc County,13,1677,839,838
Mississippi,Pontotoc County,14,1421,686,735
Mississippi,Pontotoc County,15,1047,461,586
Mississippi,Pontotoc County,16,775,344,431
Mississippi,Pontotoc County,17,527,193,334
Mississippi,Pontotoc County,18,547,180,367
Mississippi,Prentiss County,0,25428,12510,12918
Mississippi,Prentiss County,1,1625,865,760
Mississippi,Prentiss County,2,1667,889,778
Mississippi,Prentiss County,3,1574,837,737
Mississippi,Prentiss County,4,1699,885,814
Mississippi,Prentiss County,5,2017,1042,975
Mississippi,Prentiss County,6,1573,789,784
Mississippi,Prentiss County,7,1505,783,722
Mississippi,Prentiss County,8,1398,691,707
Mississippi,Prentiss County,9,1540,766,774
Mississippi,Prentiss County,10,1687,813,874
Mississippi,Prentiss County,11,1695,848,847
Mississippi,Prentiss County,12,1674,821,853
Mississippi,Prentiss County,13,1460,710,750
Mississippi,Prentiss County,14,1308,596,712
Mississippi,Prentiss County,15,1088,456,632
Mississippi,Prentiss County,16,838,365,473
Mississippi,Prentiss County,17,519,190,329
Mississippi,Prentiss County,18,561,164,397
Mississippi,Quitman County,0,7678,3676,4002
Mississippi,Quitman County,1,523,257,266
Mississippi,Quitman County,2,517,276,241
Mississippi,Quitman County,3,549,300,249
Mississippi,Quitman County,4,505,252,253
Mississippi,Quitman County,5,553,279,274
Mississippi,Quitman County,6,458,233,225
Mississippi,Quitman County,7,421,206,215
Mississippi,Quitman County,8,435,189,246
Mississippi,Quitman County,9,469,203,266
Mississippi,Quitman County,10,499,226,273
Mississippi,Quitman County,11,558,267,291
Mississippi,Quitman County,12,558,280,278
Mississippi,Quitman County,13,485,219,266
Mississippi,Quitman County,14,376,183,193
Mississippi,Quitman County,15,293,130,163
Mississippi,Quitman County,16,216,92,124
Mississippi,Quitman County,17,128,43,85
Mississippi,Quitman County,18,135,41,94
Mississippi,Rankin County,0,148070,71589,76481
Mississippi,Rankin County,1,9346,4782,4564
Mississippi,Rankin County,2,10161,5221,4940
Mississippi,Rankin County,3,10297,5242,5055
Mississippi,Rankin County,4,9398,4824,4574
Mississippi,Rankin County,5,8523,4285,4238
Mississippi,Rankin County,6,10410,4874,5536
Mississippi,Rankin County,7,11173,5459,5714
Mississippi,Rankin County,8,10717,5221,5496
Mississippi,Rankin County,9,10679,5227,5452
Mississippi,Rankin County,10,9779,4761,5018
Mississippi,Rankin County,11,10011,4907,5104
Mississippi,Rankin County,12,9508,4492,5016
Mississippi,Rankin County,13,8343,3857,4486
Mississippi,Rankin County,14,6987,3200,3787
Mississippi,Rankin County,15,4906,2252,2654
Mississippi,Rankin County,16,3459,1482,1977
Mississippi,Rankin County,17,2262,862,1400
Mississippi,Rankin County,18,2111,641,1470
Mississippi,Scott County,0,28461,13889,14572
Mississippi,Scott County,1,2167,1085,1082
Mississippi,Scott County,2,2279,1163,1116
Mississippi,Scott County,3,1982,1065,917
Mississippi,Scott County,4,1843,930,913
Mississippi,Scott County,5,1960,1014,946
Mississippi,Scott County,6,1870,962,908
Mississippi,Scott County,7,1823,886,937
Mississippi,Scott County,8,1766,823,943
Mississippi,Scott County,9,1784,903,881
Mississippi,Scott County,10,1734,845,889
Mississippi,Scott County,11,1912,947,965
Mississippi,Scott County,12,1880,897,983
Mississippi,Scott County,13,1568,728,840
Mississippi,Scott County,14,1362,611,751
Mississippi,Scott County,15,901,404,497
Mississippi,Scott County,16,709,292,417
Mississippi,Scott County,17,469,171,298
Mississippi,Scott County,18,452,163,289
Mississippi,Sharkey County,0,4647,2149,2498
Mississippi,Sharkey County,1,331,143,188
Mississippi,Sharkey County,2,321,159,162
Mississippi,Sharkey County,3,322,176,146
Mississippi,Sharkey County,4,318,150,168
Mississippi,Sharkey County,5,299,145,154
Mississippi,Sharkey County,6,238,105,133
Mississippi,Sharkey County,7,245,111,134
Mississippi,Sharkey County,8,251,118,133
Mississippi,Sharkey County,9,241,111,130
Mississippi,Sharkey County,10,271,119,152
Mississippi,Sharkey County,11,339,144,195
Mississippi,Sharkey County,12,372,166,206
Mississippi,Sharkey County,13,349,165,184
Mississippi,Sharkey County,14,240,119,121
Mississippi,Sharkey County,15,154,68,86
Mississippi,Sharkey County,16,119,68,51
Mississippi,Sharkey County,17,113,39,74
Mississippi,Sharkey County,18,124,43,81
Mississippi,Simpson County,0,27463,13378,14085
Mississippi,Simpson County,1,1766,942,824
Mississippi,Simpson County,2,2046,1078,968
Mississippi,Simpson County,3,1957,1010,947
Mississippi,Simpson County,4,1807,970,837
Mississippi,Simpson County,5,1756,890,866
Mississippi,Simpson County,6,1651,788,863
Mississippi,Simpson County,7,1670,812,858
Mississippi,Simpson County,8,1565,786,779
Mississippi,Simpson County,9,1696,794,902
Mississippi,Simpson County,10,1639,781,858
Mississippi,Simpson County,11,1893,871,1022
Mississippi,Simpson County,12,2027,1004,1023
Mississippi,Simpson County,13,1712,811,901
Mississippi,Simpson County,14,1436,670,766
Mississippi,Simpson County,15,1008,446,562
Mississippi,Simpson County,16,829,343,486
Mississippi,Simpson County,17,499,208,291
Mississippi,Simpson County,18,506,174,332
Mississippi,Smith County,0,16188,7790,8398
Mississippi,Smith County,1,1008,501,507
Mississippi,Smith County,2,1080,529,551
Mississippi,Smith County,3,1147,575,572
Mississippi,Smith County,4,1071,575,496
Mississippi,Smith County,5,1005,504,501
Mississippi,Smith County,6,862,421,441
Mississippi,Smith County,7,903,429,474
Mississippi,Smith County,8,882,403,479
Mississippi,Smith County,9,1028,482,546
Mississippi,Smith County,10,1055,514,541
Mississippi,Smith County,11,1119,531,588
Mississippi,Smith County,12,1194,607,587
Mississippi,Smith County,13,1054,509,545
Mississippi,Smith County,14,888,450,438
Mississippi,Smith County,15,705,329,376
Mississippi,Smith County,16,557,221,336
Mississippi,Smith County,17,355,129,226
Mississippi,Smith County,18,275,81,194
Mississippi,Stone County,0,17875,8914,8961
Mississippi,Stone County,1,986,486,500
Mississippi,Stone County,2,1160,585,575
Mississippi,Stone County,3,1150,562,588
Mississippi,Stone County,4,1571,809,762
Mississippi,Stone County,5,1397,713,684
Mississippi,Stone County,6,1100,580,520
Mississippi,Stone County,7,1101,562,539
Mississippi,Stone County,8,1074,531,543
Mississippi,Stone County,9,1142,579,563
Mississippi,Stone County,10,1151,606,545
Mississippi,Stone County,11,1210,570,640
Mississippi,Stone County,12,1181,585,596
Mississippi,Stone County,13,1103,539,564
Mississippi,Stone County,14,941,491,450
Mississippi,Stone County,15,648,302,346
Mississippi,Stone County,16,476,229,247
Mississippi,Stone County,17,286,119,167
Mississippi,Stone County,18,198,66,132
Mississippi,Sunflower County,0,27496,14514,12982
Mississippi,Sunflower County,1,1739,876,863
Mississippi,Sunflower County,2,1887,916,971
Mississippi,Sunflower County,3,1785,915,870
Mississippi,Sunflower County,4,1759,914,845
Mississippi,Sunflower County,5,2404,1352,1052
Mississippi,Sunflower County,6,2257,1437,820
Mississippi,Sunflower County,7,2102,1249,853
Mississippi,Sunflower County,8,1768,1027,741
Mississippi,Sunflower County,9,1681,960,721
Mississippi,Sunflower County,10,1816,1034,782
Mississippi,Sunflower County,11,1850,942,908
Mississippi,Sunflower County,12,1721,827,894
Mississippi,Sunflower County,13,1550,765,785
Mississippi,Sunflower County,14,1068,497,571
Mississippi,Sunflower County,15,780,352,428
Mississippi,Sunflower County,16,562,243,319
Mississippi,Sunflower County,17,362,99,263
Mississippi,Sunflower County,18,405,109,296
Mississippi,Tallahatchie County,0,14761,8229,6532
Mississippi,Tallahatchie County,1,790,442,348
Mississippi,Tallahatchie County,2,894,433,461
Mississippi,Tallahatchie County,3,810,407,403
Mississippi,Tallahatchie County,4,824,418,406
Mississippi,Tallahatchie County,5,1346,894,452
Mississippi,Tallahatchie County,6,1300,910,390
Mississippi,Tallahatchie County,7,1111,739,372
Mississippi,Tallahatchie County,8,1029,646,383
Mississippi,Tallahatchie County,9,1023,585,438
Mississippi,Tallahatchie County,10,961,541,420
Mississippi,Tallahatchie County,11,965,474,491
Mississippi,Tallahatchie County,12,919,468,451
Mississippi,Tallahatchie County,13,793,437,356
Mississippi,Tallahatchie County,14,635,286,349
Mississippi,Tallahatchie County,15,473,212,261
Mississippi,Tallahatchie County,16,383,153,230
Mississippi,Tallahatchie County,17,250,99,151
Mississippi,Tallahatchie County,18,255,85,170
Mississippi,Tate County,0,28204,13628,14576
Mississippi,Tate County,1,1667,840,827
Mississippi,Tate County,2,1890,968,922
Mississippi,Tate County,3,2053,1060,993
Mississippi,Tate County,4,2411,1223,1188
Mississippi,Tate County,5,2037,1042,995
Mississippi,Tate County,6,1644,790,854
Mississippi,Tate County,7,1696,813,883
Mississippi,Tate County,8,1551,734,817
Mississippi,Tate County,9,1714,814,900
Mississippi,Tate County,10,1737,840,897
Mississippi,Tate County,11,2010,952,1058
Mississippi,Tate County,12,1816,852,964
Mississippi,Tate County,13,1757,828,929
Mississippi,Tate County,14,1554,728,826
Mississippi,Tate County,15,1072,514,558
Mississippi,Tate County,16,739,335,404
Mississippi,Tate County,17,453,168,285
Mississippi,Tate County,18,403,127,276
Mississippi,Tippah County,0,22039,10848,11191
Mississippi,Tippah County,1,1368,707,661
Mississippi,Tippah County,2,1586,795,791
Mississippi,Tippah County,3,1554,789,765
Mississippi,Tippah County,4,1451,754,697
Mississippi,Tippah County,5,1527,780,747
Mississippi,Tippah County,6,1243,609,634
Mississippi,Tippah County,7,1331,636,695
Mississippi,Tippah County,8,1323,661,662
Mississippi,Tippah County,9,1372,689,683
Mississippi,Tippah County,10,1503,766,737
Mississippi,Tippah County,11,1599,804,795
Mississippi,Tippah County,12,1402,695,707
Mississippi,Tippah County,13,1290,607,683
Mississippi,Tippah County,14,1170,577,593
Mississippi,Tippah County,15,910,416,494
Mississippi,Tippah County,16,641,276,365
Mississippi,Tippah County,17,436,182,254
Mississippi,Tippah County,18,333,105,228
Mississippi,Tishomingo County,0,19420,9364,10056
Mississippi,Tishomingo County,1,1038,500,538
Mississippi,Tishomingo County,2,1219,622,597
Mississippi,Tishomingo County,3,1229,615,614
Mississippi,Tishomingo County,4,1228,625,603
Mississippi,Tishomingo County,5,1153,590,563
Mississippi,Tishomingo County,6,1042,510,532
Mississippi,Tishomingo County,7,1017,502,515
Mississippi,Tishomingo County,8,1076,515,561
Mississippi,Tishomingo County,9,1235,588,647
Mississippi,Tishomingo County,10,1348,649,699
Mississippi,Tishomingo County,11,1406,713,693
Mississippi,Tishomingo County,12,1354,672,682
Mississippi,Tishomingo County,13,1273,618,655
Mississippi,Tishomingo County,14,1263,595,668
Mississippi,Tishomingo County,15,955,450,505
Mississippi,Tishomingo County,16,701,298,403
Mississippi,Tishomingo County,17,473,169,304
Mississippi,Tishomingo County,18,410,133,277
Mississippi,Tunica County,0,10598,4987,5611
Mississippi,Tunica County,1,917,461,456
Mississippi,Tunica County,2,901,493,408
Mississippi,Tunica County,3,898,451,447
Mississippi,Tunica County,4,745,372,373
Mississippi,Tunica County,5,727,353,374
Mississippi,Tunica County,6,796,365,431
Mississippi,Tunica County,7,740,306,434
Mississippi,Tunica County,8,681,318,363
Mississippi,Tunica County,9,637,299,338
Mississippi,Tunica County,10,607,266,341
Mississippi,Tunica County,11,655,306,349
Mississippi,Tunica County,12,656,281,375
Mississippi,Tunica County,13,555,260,295
Mississippi,Tunica County,14,390,191,199
Mississippi,Tunica County,15,262,117,145
Mississippi,Tunica County,16,181,77,104
Mississippi,Tunica County,17,133,42,91
Mississippi,Tunica County,18,117,29,88
Mississippi,Union County,0,28097,13719,14378
Mississippi,Union County,1,1870,909,961
Mississippi,Union County,2,1990,986,1004
Mississippi,Union County,3,2020,1014,1006
Mississippi,Union County,4,1841,967,874
Mississippi,Union County,5,1778,904,874
Mississippi,Union County,6,1810,905,905
Mississippi,Union County,7,1685,856,829
Mississippi,Union County,8,1832,919,913
Mississippi,Union County,9,1846,876,970
Mississippi,Union County,10,1869,946,923
Mississippi,Union County,11,1842,897,945
Mississippi,Union County,12,1758,875,883
Mississippi,Union County,13,1554,737,817
Mississippi,Union County,14,1475,712,763
Mississippi,Union County,15,1058,484,574
Mississippi,Union County,16,808,349,459
Mississippi,Union County,17,531,218,313
Mississippi,Union County,18,530,165,365
Mississippi,Walthall County,0,14859,7149,7710
Mississippi,Walthall County,1,848,400,448
Mississippi,Walthall County,2,1036,538,498
Mississippi,Walthall County,3,1067,554,513
Mississippi,Walthall County,4,1049,548,501
Mississippi,Walthall County,5,897,476,421
Mississippi,Walthall County,6,776,377,399
Mississippi,Walthall County,7,909,459,450
Mississippi,Walthall County,8,898,408,490
Mississippi,Walthall County,9,855,396,459
Mississippi,Walthall County,10,874,429,445
Mississippi,Walthall County,11,1006,494,512
Mississippi,Walthall County,12,1067,500,567
Mississippi,Walthall County,13,947,467,480
Mississippi,Walthall County,14,789,380,409
Mississippi,Walthall County,15,636,269,367
Mississippi,Walthall County,16,506,220,286
Mississippi,Walthall County,17,356,125,231
Mississippi,Walthall County,18,343,109,234
Mississippi,Warren County,0,47983,22834,25149
Mississippi,Warren County,1,3100,1521,1579
Mississippi,Warren County,2,3385,1710,1675
Mississippi,Warren County,3,3372,1723,1649
Mississippi,Warren County,4,3185,1594,1591
Mississippi,Warren County,5,3106,1507,1599
Mississippi,Warren County,6,2828,1362,1466
Mississippi,Warren County,7,3083,1414,1669
Mississippi,Warren County,8,2974,1456,1518
Mississippi,Warren County,9,2891,1360,1531
Mississippi,Warren County,10,2849,1323,1526
Mississippi,Warren County,11,3470,1677,1793
Mississippi,Warren County,12,3671,1678,1993
Mississippi,Warren County,13,3080,1524,1556
Mississippi,Warren County,14,2406,1122,1284
Mississippi,Warren County,15,1733,795,938
Mississippi,Warren County,16,1203,513,690
Mississippi,Warren County,17,854,321,533
Mississippi,Warren County,18,793,234,559
Mississippi,Washington County,0,48958,22902,26056
Mississippi,Washington County,1,3614,1834,1780
Mississippi,Washington County,2,3659,1898,1761
Mississippi,Washington County,3,3543,1773,1770
Mississippi,Washington County,4,3445,1750,1695
Mississippi,Washington County,5,3554,1811,1743
Mississippi,Washington County,6,3087,1482,1605
Mississippi,Washington County,7,3045,1392,1653
Mississippi,Washington County,8,2760,1251,1509
Mississippi,Washington County,9,2729,1212,1517
Mississippi,Washington County,10,2841,1257,1584
Mississippi,Washington County,11,3335,1530,1805
Mississippi,Washington County,12,3498,1579,1919
Mississippi,Washington County,13,3176,1452,1724
Mississippi,Washington County,14,2300,1041,1259
Mississippi,Washington County,15,1625,700,925
Mississippi,Washington County,16,1115,436,679
Mississippi,Washington County,17,818,274,544
Mississippi,Washington County,18,814,230,584
Mississippi,Wayne County,0,20490,9848,10642
Mississippi,Wayne County,1,1321,658,663
Mississippi,Wayne County,2,1446,746,700
Mississippi,Wayne County,3,1439,729,710
Mississippi,Wayne County,4,1372,683,689
Mississippi,Wayne County,5,1384,689,695
Mississippi,Wayne County,6,1264,611,653
Mississippi,Wayne County,7,1268,605,663
Mississippi,Wayne County,8,1196,565,631
Mississippi,Wayne County,9,1250,575,675
Mississippi,Wayne County,10,1188,550,638
Mississippi,Wayne County,11,1523,738,785
Mississippi,Wayne County,12,1451,719,732
Mississippi,Wayne County,13,1161,559,602
Mississippi,Wayne County,14,1083,521,562
Mississippi,Wayne County,15,814,360,454
Mississippi,Wayne County,16,635,294,341
Mississippi,Wayne County,17,371,145,226
Mississippi,Wayne County,18,324,101,223
Mississippi,Webster County,0,9972,4891,5081
Mississippi,Webster County,1,587,311,276
Mississippi,Webster County,2,702,365,337
Mississippi,Webster County,3,721,378,343
Mississippi,Webster County,4,604,300,304
Mississippi,Webster County,5,590,316,274
Mississippi,Webster County,6,584,278,306
Mississippi,Webster County,7,638,335,303
Mississippi,Webster County,8,556,271,285
Mississippi,Webster County,9,591,298,293
Mississippi,Webster County,10,674,313,361
Mississippi,Webster County,11,753,386,367
Mississippi,Webster County,12,711,343,368
Mississippi,Webster County,13,602,288,314
Mississippi,Webster County,14,525,258,267
Mississippi,Webster County,15,426,189,237
Mississippi,Webster County,16,328,134,194
Mississippi,Webster County,17,213,83,130
Mississippi,Webster County,18,167,45,122
Mississippi,Wilkinson County,0,9191,4911,4280
Mississippi,Wilkinson County,1,556,311,245
Mississippi,Wilkinson County,2,564,278,286
Mississippi,Wilkinson County,3,561,293,268
Mississippi,Wilkinson County,4,465,246,219
Mississippi,Wilkinson County,5,682,417,265
Mississippi,Wilkinson County,6,717,482,235
Mississippi,Wilkinson County,7,671,442,229
Mississippi,Wilkinson County,8,540,322,218
Mississippi,Wilkinson County,9,495,291,204
Mississippi,Wilkinson County,10,566,283,283
Mississippi,Wilkinson County,11,673,320,353
Mississippi,Wilkinson County,12,670,334,336
Mississippi,Wilkinson County,13,604,275,329
Mississippi,Wilkinson County,14,453,227,226
Mississippi,Wilkinson County,15,343,157,186
Mississippi,Wilkinson County,16,254,108,146
Mississippi,Wilkinson County,17,184,79,105
Mississippi,Wilkinson County,18,193,46,147
Mississippi,Winston County,0,18478,9051,9427
Mississippi,Winston County,1,1065,562,503
Mississippi,Winston County,2,1320,675,645
Mississippi,Winston County,3,1294,694,600
Mississippi,Winston County,4,1063,557,506
Mississippi,Winston County,5,1158,603,555
Mississippi,Winston County,6,1049,547,502
Mississippi,Winston County,7,1088,510,578
Mississippi,Winston County,8,1096,541,555
Mississippi,Winston County,9,1104,550,554
Mississippi,Winston County,10,1141,574,567
Mississippi,Winston County,11,1293,620,673
Mississippi,Winston County,12,1329,648,681
Mississippi,Winston County,13,1259,586,673
Mississippi,Winston County,14,1027,495,532
Mississippi,Winston County,15,743,322,421
Mississippi,Winston County,16,627,273,354
Mississippi,Winston County,17,419,138,281
Mississippi,Winston County,18,403,156,247
Mississippi,Yalobusha County,0,12276,5922,6354
Mississippi,Yalobusha County,1,784,423,361
Mississippi,Yalobusha County,2,780,407,373
Mississippi,Yalobusha County,3,765,385,380
Mississippi,Yalobusha County,4,712,362,350
Mississippi,Yalobusha County,5,749,344,405
Mississippi,Yalobusha County,6,670,327,343
Mississippi,Yalobusha County,7,678,291,387
Mississippi,Yalobusha County,8,705,354,351
Mississippi,Yalobusha County,9,798,394,404
Mississippi,Yalobusha County,10,727,356,371
Mississippi,Yalobusha County,11,835,399,436
Mississippi,Yalobusha County,12,956,452,504
Mississippi,Yalobusha County,13,873,418,455
Mississippi,Yalobusha County,14,741,380,361
Mississippi,Yalobusha County,15,545,247,298
Mississippi,Yalobusha County,16,434,188,246
Mississippi,Yalobusha County,17,286,120,166
Mississippi,Yalobusha County,18,238,75,163
Mississippi,Yazoo County,0,27817,15421,12396
Mississippi,Yazoo County,1,1857,990,867
Mississippi,Yazoo County,2,2007,1074,933
Mississippi,Yazoo County,3,1773,920,853
Mississippi,Yazoo County,4,1711,893,818
Mississippi,Yazoo County,5,1857,1021,836
Mississippi,Yazoo County,6,2144,1407,737
Mississippi,Yazoo County,7,2348,1588,760
Mississippi,Yazoo County,8,2226,1522,704
Mississippi,Yazoo County,9,1801,1100,701
Mississippi,Yazoo County,10,1713,980,733
Mississippi,Yazoo County,11,1785,933,852
Mississippi,Yazoo County,12,1766,889,877
Mississippi,Yazoo County,13,1380,715,665
Mississippi,Yazoo County,14,1078,491,587
Mississippi,Yazoo County,15,792,346,446
Mississippi,Yazoo County,16,624,245,379
Mississippi,Yazoo County,17,465,158,307
Mississippi,Yazoo County,18,490,149,341
Missouri,Adair County,0,25602,12316,13286
Missouri,Adair County,1,1183,645,538
Missouri,Adair County,2,1373,705,668
Missouri,Adair County,3,1369,710,659
Missouri,Adair County,4,2897,1296,1601
Missouri,Adair County,5,4759,2259,2500
Missouri,Adair County,6,1471,715,756
Missouri,Adair County,7,1231,615,616
Missouri,Adair County,8,1096,524,572
Missouri,Adair County,9,1201,602,599
Missouri,Adair County,10,1278,645,633
Missouri,Adair County,11,1507,718,789
Missouri,Adair County,12,1446,725,721
Missouri,Adair County,13,1304,648,656
Missouri,Adair County,14,1074,502,572
Missouri,Adair County,15,856,411,445
Missouri,Adair County,16,630,268,362
Missouri,Adair County,17,428,169,259
Missouri,Adair County,18,499,159,340
Missouri,Andrew County,0,17379,8607,8772
Missouri,Andrew County,1,902,495,407
Missouri,Andrew County,2,1046,514,532
Missouri,Andrew County,3,1289,673,616
Missouri,Andrew County,4,1120,575,545
Missouri,Andrew County,5,992,504,488
Missouri,Andrew County,6,886,431,455
Missouri,Andrew County,7,944,469,475
Missouri,Andrew County,8,1078,533,545
Missouri,Andrew County,9,1100,556,544
Missouri,Andrew County,10,1141,594,547
Missouri,Andrew County,11,1321,659,662
Missouri,Andrew County,12,1370,663,707
Missouri,Andrew County,13,1155,608,547
Missouri,Andrew County,14,948,453,495
Missouri,Andrew County,15,780,375,405
Missouri,Andrew County,16,535,231,304
Missouri,Andrew County,17,381,163,218
Missouri,Andrew County,18,391,111,280
Missouri,Atchison County,0,5382,2669,2713
Missouri,Atchison County,1,295,161,134
Missouri,Atchison County,2,285,141,144
Missouri,Atchison County,3,321,162,159
Missouri,Atchison County,4,288,141,147
Missouri,Atchison County,5,273,142,131
Missouri,Atchison County,6,250,118,132
Missouri,Atchison County,7,279,148,131
Missouri,Atchison County,8,260,140,120
Missouri,Atchison County,9,319,153,166
Missouri,Atchison County,10,345,169,176
Missouri,Atchison County,11,398,217,181
Missouri,Atchison County,12,405,204,201
Missouri,Atchison County,13,383,195,188
Missouri,Atchison County,14,394,199,195
Missouri,Atchison County,15,326,164,162
Missouri,Atchison County,16,197,96,101
Missouri,Atchison County,17,162,62,100
Missouri,Atchison County,18,202,57,145
Missouri,Audrain County,0,25887,11769,14118
Missouri,Audrain County,1,1582,820,762
Missouri,Audrain County,2,1629,836,793
Missouri,Audrain County,3,1763,921,842
Missouri,Audrain County,4,1708,964,744
Missouri,Audrain County,5,1597,654,943
Missouri,Audrain County,6,1661,620,1041
Missouri,Audrain County,7,1705,673,1032
Missouri,Audrain County,8,1608,641,967
Missouri,Audrain County,9,1591,691,900
Missouri,Audrain County,10,1580,680,900
Missouri,Audrain County,11,1763,817,946
Missouri,Audrain County,12,1796,860,936
Missouri,Audrain County,13,1587,750,837
Missouri,Audrain County,14,1299,654,645
Missouri,Audrain County,15,1045,470,575
Missouri,Audrain County,16,747,316,431
Missouri,Audrain County,17,603,235,368
Missouri,Audrain County,18,623,167,456
Missouri,Barry County,0,35662,17773,17889
Missouri,Barry County,1,2271,1163,1108
Missouri,Barry County,2,2199,1148,1051
Missouri,Barry County,3,2273,1184,1089
Missouri,Barry County,4,2217,1147,1070
Missouri,Barry County,5,1999,1013,986
Missouri,Barry County,6,1767,902,865
Missouri,Barry County,7,1895,936,959
Missouri,Barry County,8,1779,914,865
Missouri,Barry County,9,1999,948,1051
Missouri,Barry County,10,2262,1140,1122
Missouri,Barry County,11,2679,1383,1296
Missouri,Barry County,12,2637,1279,1358
Missouri,Barry County,13,2473,1210,1263
Missouri,Barry County,14,2220,1116,1104
Missouri,Barry County,15,1965,949,1016
Missouri,Barry County,16,1374,652,722
Missouri,Barry County,17,883,416,467
Missouri,Barry County,18,770,273,497
Missouri,Barton County,0,12057,5948,6109
Missouri,Barton County,1,686,347,339
Missouri,Barton County,2,830,428,402
Missouri,Barton County,3,938,510,428
Missouri,Barton County,4,845,428,417
Missouri,Barton County,5,698,371,327
Missouri,Barton County,6,547,277,270
Missouri,Barton County,7,692,328,364
Missouri,Barton County,8,650,328,322
Missouri,Barton County,9,654,324,330
Missouri,Barton County,10,700,349,351
Missouri,Barton County,11,901,437,464
Missouri,Barton County,12,904,451,453
Missouri,Barton County,13,768,379,389
Missouri,Barton County,14,656,306,350
Missouri,Barton County,15,526,249,277
Missouri,Barton County,16,378,180,198
Missouri,Barton County,17,323,136,187
Missouri,Barton County,18,361,120,241
Missouri,Bates County,0,16584,8198,8386
Missouri,Bates County,1,982,509,473
Missouri,Bates County,2,1125,528,597
Missouri,Bates County,3,1187,650,537
Missouri,Bates County,4,1064,583,481
Missouri,Bates County,5,872,463,409
Missouri,Bates County,6,877,426,451
Missouri,Bates County,7,976,488,488
Missouri,Bates County,8,889,425,464
Missouri,Bates County,9,922,476,446
Missouri,Bates County,10,1029,516,513
Missouri,Bates County,11,1276,624,652
Missouri,Bates County,12,1219,626,593
Missouri,Bates County,13,1068,512,556
Missouri,Bates County,14,849,413,436
Missouri,Bates County,15,771,352,419
Missouri,Bates County,16,613,272,341
Missouri,Bates County,17,443,176,267
Missouri,Bates County,18,422,159,263
Missouri,Benton County,0,18806,9461,9345
Missouri,Benton County,1,732,395,337
Missouri,Benton County,2,916,487,429
Missouri,Benton County,3,995,511,484
Missouri,Benton County,4,978,531,447
Missouri,Benton County,5,758,384,374
Missouri,Benton County,6,685,354,331
Missouri,Benton County,7,770,382,388
Missouri,Benton County,8,755,362,393
Missouri,Benton County,9,921,452,469
Missouri,Benton County,10,1113,566,547
Missouri,Benton County,11,1392,720,672
Missouri,Benton County,12,1617,797,820
Missouri,Benton County,13,1767,844,923
Missouri,Benton County,14,1780,878,902
Missouri,Benton County,15,1472,754,718
Missouri,Benton County,16,1039,542,497
Missouri,Benton County,17,633,319,314
Missouri,Benton County,18,483,183,300
Missouri,Bollinger County,0,12394,6198,6196
Missouri,Bollinger County,1,745,401,344
Missouri,Bollinger County,2,771,384,387
Missouri,Bollinger County,3,803,424,379
Missouri,Bollinger County,4,731,378,353
Missouri,Bollinger County,5,715,355,360
Missouri,Bollinger County,6,641,313,328
Missouri,Bollinger County,7,634,331,303
Missouri,Bollinger County,8,673,354,319
Missouri,Bollinger County,9,789,378,411
Missouri,Bollinger County,10,838,412,426
Missouri,Bollinger County,11,1024,543,481
Missouri,Bollinger County,12,949,463,486
Missouri,Bollinger County,13,851,400,451
Missouri,Bollinger County,14,742,375,367
Missouri,Bollinger County,15,595,300,295
Missouri,Bollinger County,16,434,204,230
Missouri,Bollinger County,17,245,111,134
Missouri,Bollinger County,18,214,72,142
Missouri,Boone County,0,172717,83597,89120
Missouri,Boone County,1,10342,5178,5164
Missouri,Boone County,2,10011,5113,4898
Missouri,Boone County,3,9474,4949,4525
Missouri,Boone County,4,14159,6575,7584
Missouri,Boone County,5,26984,12961,14023
Missouri,Boone County,6,14378,7296,7082
Missouri,Boone County,7,12216,6127,6089
Missouri,Boone County,8,10087,5042,5045
Missouri,Boone County,9,9623,4690,4933
Missouri,Boone County,10,9007,4318,4689
Missouri,Boone County,11,10020,4819,5201
Missouri,Boone County,12,9715,4545,5170
Missouri,Boone County,13,8587,4033,4554
Missouri,Boone County,14,6349,3067,3282
Missouri,Boone County,15,4107,1871,2236
Missouri,Boone County,16,2935,1294,1641
Missouri,Boone County,17,2144,878,1266
Missouri,Boone County,18,2579,841,1738
Missouri,Buchanan County,0,89486,45055,44431
Missouri,Buchanan County,1,6000,3029,2971
Missouri,Buchanan County,2,5850,2980,2870
Missouri,Buchanan County,3,5408,2810,2598
Missouri,Buchanan County,4,5530,2816,2714
Missouri,Buchanan County,5,6757,3561,3196
Missouri,Buchanan County,6,6580,3511,3069
Missouri,Buchanan County,7,6206,3338,2868
Missouri,Buchanan County,8,5444,2965,2479
Missouri,Buchanan County,9,5264,2776,2488
Missouri,Buchanan County,10,5524,2844,2680
Missouri,Buchanan County,11,6534,3297,3237
Missouri,Buchanan County,12,6124,3090,3034
Missouri,Buchanan County,13,5167,2520,2647
Missouri,Buchanan County,14,4113,1930,2183
Missouri,Buchanan County,15,3076,1360,1716
Missouri,Buchanan County,16,2266,1006,1260
Missouri,Buchanan County,17,1719,647,1072
Missouri,Buchanan County,18,1924,575,1349
Missouri,Butler County,0,42972,21000,21972
Missouri,Butler County,1,2821,1530,1291
Missouri,Butler County,2,2843,1451,1392
Missouri,Butler County,3,2834,1468,1366
Missouri,Butler County,4,2560,1337,1223
Missouri,Butler County,5,2552,1312,1240
Missouri,Butler County,6,2578,1266,1312
Missouri,Butler County,7,2604,1249,1355
Missouri,Butler County,8,2457,1200,1257
Missouri,Butler County,9,2578,1268,1310
Missouri,Butler County,10,2610,1269,1341
Missouri,Butler County,11,3065,1499,1566
Missouri,Butler County,12,3042,1459,1583
Missouri,Butler County,13,2818,1317,1501
Missouri,Butler County,14,2325,1091,1234
Missouri,Butler County,15,1873,871,1002
Missouri,Butler County,16,1472,637,835
Missouri,Butler County,17,1076,462,614
Missouri,Butler County,18,864,314,550
Missouri,Caldwell County,0,9034,4555,4479
Missouri,Caldwell County,1,482,250,232
Missouri,Caldwell County,2,626,311,315
Missouri,Caldwell County,3,679,381,298
Missouri,Caldwell County,4,568,288,280
Missouri,Caldwell County,5,477,259,218
Missouri,Caldwell County,6,416,215,201
Missouri,Caldwell County,7,513,251,262
Missouri,Caldwell County,8,507,265,242
Missouri,Caldwell County,9,515,266,249
Missouri,Caldwell County,10,578,289,289
Missouri,Caldwell County,11,703,353,350
Missouri,Caldwell County,12,654,333,321
Missouri,Caldwell County,13,609,295,314
Missouri,Caldwell County,14,534,276,258
Missouri,Caldwell County,15,418,202,216
Missouri,Caldwell County,16,287,137,150
Missouri,Caldwell County,17,245,106,139
Missouri,Caldwell County,18,223,78,145
Missouri,Callaway County,0,44750,22741,22009
Missouri,Callaway County,1,2544,1208,1336
Missouri,Callaway County,2,2644,1355,1289
Missouri,Callaway County,3,2699,1362,1337
Missouri,Callaway County,4,3216,1560,1656
Missouri,Callaway County,5,3648,1908,1740
Missouri,Callaway County,6,2975,1628,1347
Missouri,Callaway County,7,2895,1577,1318
Missouri,Callaway County,8,2684,1446,1238
Missouri,Callaway County,9,2757,1444,1313
Missouri,Callaway County,10,2960,1565,1395
Missouri,Callaway County,11,3451,1784,1667
Missouri,Callaway County,12,3145,1563,1582
Missouri,Callaway County,13,2765,1416,1349
Missouri,Callaway County,14,2179,1100,1079
Missouri,Callaway County,15,1640,785,855
Missouri,Callaway County,16,1066,488,578
Missouri,Callaway County,17,728,309,419
Missouri,Callaway County,18,754,243,511
Missouri,Camden County,0,44021,21760,22261
Missouri,Camden County,1,2002,970,1032
Missouri,Camden County,2,2171,1048,1123
Missouri,Camden County,3,2441,1246,1195
Missouri,Camden County,4,2237,1162,1075
Missouri,Camden County,5,2005,996,1009
Missouri,Camden County,6,2165,1106,1059
Missouri,Camden County,7,2060,1000,1060
Missouri,Camden County,8,1957,992,965
Missouri,Camden County,9,2183,1067,1116
Missouri,Camden County,10,2623,1258,1365
Missouri,Camden County,11,3381,1665,1716
Missouri,Camden County,12,3866,1887,1979
Missouri,Camden County,13,3990,1877,2113
Missouri,Camden County,14,4049,2026,2023
Missouri,Camden County,15,3041,1610,1431
Missouri,Camden County,16,1999,1013,986
Missouri,Camden County,17,1049,514,535
Missouri,Camden County,18,802,323,479
Missouri,Cape Girardeau County,0,78043,37752,40291
Missouri,Cape Girardeau County,1,4529,2311,2218
Missouri,Cape Girardeau County,2,4812,2456,2356
Missouri,Cape Girardeau County,3,4725,2398,2327
Missouri,Cape Girardeau County,4,5783,2808,2975
Missouri,Cape Girardeau County,5,8426,3973,4453
Missouri,Cape Girardeau County,6,4869,2463,2406
Missouri,Cape Girardeau County,7,4822,2399,2423
Missouri,Cape Girardeau County,8,4254,2152,2102
Missouri,Cape Girardeau County,9,4387,2155,2232
Missouri,Cape Girardeau County,10,4470,2191,2279
Missouri,Cape Girardeau County,11,5153,2550,2603
Missouri,Cape Girardeau County,12,5110,2495,2615
Missouri,Cape Girardeau County,13,4650,2235,2415
Missouri,Cape Girardeau County,14,3636,1718,1918
Missouri,Cape Girardeau County,15,2797,1226,1571
Missouri,Cape Girardeau County,16,2113,904,1209
Missouri,Cape Girardeau County,17,1629,674,955
Missouri,Cape Girardeau County,18,1878,644,1234
Missouri,Carroll County,0,9043,4450,4593
Missouri,Carroll County,1,560,295,265
Missouri,Carroll County,2,513,266,247
Missouri,Carroll County,3,587,289,298
Missouri,Carroll County,4,600,296,304
Missouri,Carroll County,5,526,272,254
Missouri,Carroll County,6,435,222,213
Missouri,Carroll County,7,446,216,230
Missouri,Carroll County,8,518,246,272
Missouri,Carroll County,9,550,281,269
Missouri,Carroll County,10,556,272,284
Missouri,Carroll County,11,646,346,300
Missouri,Carroll County,12,638,303,335
Missouri,Carroll County,13,604,308,296
Missouri,Carroll County,14,573,277,296
Missouri,Carroll County,15,449,215,234
Missouri,Carroll County,16,318,146,172
Missouri,Carroll County,17,275,114,161
Missouri,Carroll County,18,249,86,163
Missouri,Carter County,0,6258,3037,3221
Missouri,Carter County,1,396,183,213
Missouri,Carter County,2,400,185,215
Missouri,Carter County,3,442,216,226
Missouri,Carter County,4,386,195,191
Missouri,Carter County,5,352,172,180
Missouri,Carter County,6,340,160,180
Missouri,Carter County,7,354,190,164
Missouri,Carter County,8,341,155,186
Missouri,Carter County,9,367,184,183
Missouri,Carter County,10,393,193,200
Missouri,Carter County,11,466,250,216
Missouri,Carter County,12,480,237,243
Missouri,Carter County,13,427,202,225
Missouri,Carter County,14,373,181,192
Missouri,Carter County,15,295,149,146
Missouri,Carter County,16,193,94,99
Missouri,Carter County,17,128,49,79
Missouri,Carter County,18,125,42,83
Missouri,Cass County,0,100889,49368,51521
Missouri,Cass County,1,6065,3214,2851
Missouri,Cass County,2,7040,3601,3439
Missouri,Cass County,3,7551,3825,3726
Missouri,Cass County,4,6916,3552,3364
Missouri,Cass County,5,5661,2806,2855
Missouri,Cass County,6,5541,2803,2738
Missouri,Cass County,7,6167,2971,3196
Missouri,Cass County,8,6460,3155,3305
Missouri,Cass County,9,6598,3237,3361
Missouri,Cass County,10,6573,3272,3301
Missouri,Cass County,11,7690,3761,3929
Missouri,Cass County,12,7155,3498,3657
Missouri,Cass County,13,5877,2792,3085
Missouri,Cass County,14,4909,2275,2634
Missouri,Cass County,15,3926,1789,2137
Missouri,Cass County,16,2762,1266,1496
Missouri,Cass County,17,2079,865,1214
Missouri,Cass County,18,1919,686,1233
Missouri,Cedar County,0,13952,6926,7026
Missouri,Cedar County,1,788,408,380
Missouri,Cedar County,2,827,417,410
Missouri,Cedar County,3,981,536,445
Missouri,Cedar County,4,900,478,422
Missouri,Cedar County,5,688,354,334
Missouri,Cedar County,6,618,300,318
Missouri,Cedar County,7,686,341,345
Missouri,Cedar County,8,684,337,347
Missouri,Cedar County,9,750,380,370
Missouri,Cedar County,10,819,404,415
Missouri,Cedar County,11,944,457,487
Missouri,Cedar County,12,940,478,462
Missouri,Cedar County,13,973,465,508
Missouri,Cedar County,14,1010,492,518
Missouri,Cedar County,15,848,410,438
Missouri,Cedar County,16,628,301,327
Missouri,Cedar County,17,445,218,227
Missouri,Cedar County,18,423,150,273
Missouri,Chariton County,0,7694,3824,3870
Missouri,Chariton County,1,486,262,224
Missouri,Chariton County,2,489,263,226
Missouri,Chariton County,3,480,258,222
Missouri,Chariton County,4,409,202,207
Missouri,Chariton County,5,396,204,192
Missouri,Chariton County,6,345,176,169
Missouri,Chariton County,7,413,202,211
Missouri,Chariton County,8,393,186,207
Missouri,Chariton County,9,378,188,190
Missouri,Chariton County,10,422,213,209
Missouri,Chariton County,11,582,307,275
Missouri,Chariton County,12,628,311,317
Missouri,Chariton County,13,540,285,255
Missouri,Chariton County,14,463,232,231
Missouri,Chariton County,15,385,177,208
Missouri,Chariton County,16,280,133,147
Missouri,Chariton County,17,260,103,157
Missouri,Chariton County,18,345,122,223
Missouri,Christian County,0,82101,40097,42004
Missouri,Christian County,1,5282,2760,2522
Missouri,Christian County,2,6194,3072,3122
Missouri,Christian County,3,6272,3190,3082
Missouri,Christian County,4,5439,2743,2696
Missouri,Christian County,5,4452,2216,2236
Missouri,Christian County,6,5053,2368,2685
Missouri,Christian County,7,5652,2748,2904
Missouri,Christian County,8,5436,2664,2772
Missouri,Christian County,9,5712,2823,2889
Missouri,Christian County,10,5193,2580,2613
Missouri,Christian County,11,5789,2803,2986
Missouri,Christian County,12,5342,2548,2794
Missouri,Christian County,13,4572,2169,2403
Missouri,Christian County,14,4089,1977,2112
Missouri,Christian County,15,3033,1431,1602
Missouri,Christian County,16,2040,944,1096
Missouri,Christian County,17,1378,640,738
Missouri,Christian County,18,1173,421,752
Missouri,Clark County,0,6917,3500,3417
Missouri,Clark County,1,405,207,198
Missouri,Clark County,2,479,256,223
Missouri,Clark County,3,451,223,228
Missouri,Clark County,4,423,231,192
Missouri,Clark County,5,351,172,179
Missouri,Clark County,6,348,196,152
Missouri,Clark County,7,361,169,192
Missouri,Clark County,8,404,215,189
Missouri,Clark County,9,363,190,173
Missouri,Clark County,10,455,240,215
Missouri,Clark County,11,543,276,267
Missouri,Clark County,12,527,272,255
Missouri,Clark County,13,483,246,237
Missouri,Clark County,14,414,205,209
Missouri,Clark County,15,322,152,170
Missouri,Clark County,16,231,116,115
Missouri,Clark County,17,181,72,109
Missouri,Clark County,18,176,62,114
Missouri,Clay County,0,233682,114392,119290
Missouri,Clay County,1,15269,7687,7582
Missouri,Clay County,2,16885,8617,8268
Missouri,Clay County,3,16629,8494,8135
Missouri,Clay County,4,14844,7638,7206
Missouri,Clay County,5,14033,7012,7021
Missouri,Clay County,6,15947,7847,8100
Missouri,Clay County,7,17154,8563,8591
Missouri,Clay County,8,16171,8025,8146
Missouri,Clay County,9,16591,8138,8453
Missouri,Clay County,10,15579,7681,7898
Missouri,Clay County,11,16736,8173,8563
Missouri,Clay County,12,15364,7494,7870
Missouri,Clay County,13,12646,5939,6707
Missouri,Clay County,14,10473,4944,5529
Missouri,Clay County,15,7192,3329,3863
Missouri,Clay County,16,5033,2218,2815
Missouri,Clay County,17,3480,1351,2129
Missouri,Clay County,18,3656,1242,2414
Missouri,Clinton County,0,20299,10233,10066
Missouri,Clinton County,1,1188,666,522
Missouri,Clinton County,2,1317,690,627
Missouri,Clinton County,3,1425,733,692
Missouri,Clinton County,4,1325,697,628
Missouri,Clinton County,5,1131,603,528
Missouri,Clinton County,6,1034,533,501
Missouri,Clinton County,7,1138,525,613
Missouri,Clinton County,8,1153,588,565
Missouri,Clinton County,9,1291,630,661
Missouri,Clinton County,10,1355,681,674
Missouri,Clinton County,11,1588,788,800
Missouri,Clinton County,12,1547,780,767
Missouri,Clinton County,13,1303,620,683
Missouri,Clinton County,14,1116,568,548
Missouri,Clinton County,15,829,395,434
Missouri,Clinton County,16,628,312,316
Missouri,Clinton County,17,442,213,229
Missouri,Clinton County,18,489,211,278
Missouri,Cole County,0,76557,38718,37839
Missouri,Cole County,1,4720,2437,2283
Missouri,Cole County,2,4959,2491,2468
Missouri,Cole County,3,4963,2523,2440
Missouri,Cole County,4,4944,2533,2411
Missouri,Cole County,5,4963,2531,2432
Missouri,Cole County,6,5114,2730,2384
Missouri,Cole County,7,5370,2905,2465
Missouri,Cole County,8,4842,2661,2181
Missouri,Cole County,9,4914,2615,2299
Missouri,Cole County,10,5205,2789,2416
Missouri,Cole County,11,5606,2884,2722
Missouri,Cole County,12,5359,2569,2790
Missouri,Cole County,13,4885,2396,2489
Missouri,Cole County,14,3651,1779,1872
Missouri,Cole County,15,2446,1123,1323
Missouri,Cole County,16,1770,782,988
Missouri,Cole County,17,1385,541,844
Missouri,Cole County,18,1461,429,1032
Missouri,Cooper County,0,17585,9269,8316
Missouri,Cooper County,1,973,565,408
Missouri,Cooper County,2,1089,546,543
Missouri,Cooper County,3,1078,558,520
Missouri,Cooper County,4,1123,611,512
Missouri,Cooper County,5,1317,874,443
Missouri,Cooper County,6,1247,804,443
Missouri,Cooper County,7,1146,613,533
Missouri,Cooper County,8,987,540,447
Missouri,Cooper County,9,1015,538,477
Missouri,Cooper County,10,1064,547,517
Missouri,Cooper County,11,1292,616,676
Missouri,Cooper County,12,1208,618,590
Missouri,Cooper County,13,1137,559,578
Missouri,Cooper County,14,880,434,446
Missouri,Cooper County,15,687,299,388
Missouri,Cooper County,16,525,231,294
Missouri,Cooper County,17,366,162,204
Missouri,Cooper County,18,451,154,297
Missouri,Crawford County,0,24650,12175,12475
Missouri,Crawford County,1,1503,722,781
Missouri,Crawford County,2,1650,784,866
Missouri,Crawford County,3,1651,858,793
Missouri,Crawford County,4,1536,808,728
Missouri,Crawford County,5,1338,652,686
Missouri,Crawford County,6,1373,690,683
Missouri,Crawford County,7,1462,732,730
Missouri,Crawford County,8,1384,679,705
Missouri,Crawford County,9,1431,721,710
Missouri,Crawford County,10,1549,778,771
Missouri,Crawford County,11,1955,1002,953
Missouri,Crawford County,12,1871,937,934
Missouri,Crawford County,13,1562,787,775
Missouri,Crawford County,14,1454,704,750
Missouri,Crawford County,15,1097,537,560
Missouri,Crawford County,16,848,397,451
Missouri,Crawford County,17,536,240,296
Missouri,Crawford County,18,450,147,303
Missouri,Dade County,0,7628,3878,3750
Missouri,Dade County,1,352,196,156
Missouri,Dade County,2,447,250,197
Missouri,Dade County,3,492,272,220
Missouri,Dade County,4,490,266,224
Missouri,Dade County,5,354,190,164
Missouri,Dade County,6,325,162,163
Missouri,Dade County,7,359,166,193
Missouri,Dade County,8,394,214,180
Missouri,Dade County,9,440,237,203
Missouri,Dade County,10,444,221,223
Missouri,Dade County,11,591,299,292
Missouri,Dade County,12,637,298,339
Missouri,Dade County,13,613,313,300
Missouri,Dade County,14,482,244,238
Missouri,Dade County,15,427,220,207
Missouri,Dade County,16,316,144,172
Missouri,Dade County,17,246,106,140
Missouri,Dade County,18,219,80,139
Missouri,Dallas County,0,16389,8173,8216
Missouri,Dallas County,1,944,496,448
Missouri,Dallas County,2,1109,594,515
Missouri,Dallas County,3,1131,569,562
Missouri,Dallas County,4,1005,531,474
Missouri,Dallas County,5,821,413,408
Missouri,Dallas County,6,816,409,407
Missouri,Dallas County,7,833,423,410
Missouri,Dallas County,8,848,414,434
Missouri,Dallas County,9,933,466,467
Missouri,Dallas County,10,1000,479,521
Missouri,Dallas County,11,1276,636,640
Missouri,Dallas County,12,1296,637,659
Missouri,Dallas County,13,1167,602,565
Missouri,Dallas County,14,1003,499,504
Missouri,Dallas County,15,825,410,415
Missouri,Dallas County,16,581,279,302
Missouri,Dallas County,17,416,174,242
Missouri,Dallas County,18,385,142,243
Missouri,Daviess County,0,8297,4180,4117
Missouri,Daviess County,1,526,278,248
Missouri,Daviess County,2,612,317,295
Missouri,Daviess County,3,648,317,331
Missouri,Daviess County,4,558,294,264
Missouri,Daviess County,5,469,229,240
Missouri,Daviess County,6,371,186,185
Missouri,Daviess County,7,428,221,207
Missouri,Daviess County,8,472,247,225
Missouri,Daviess County,9,469,229,240
Missouri,Daviess County,10,456,234,222
Missouri,Daviess County,11,574,283,291
Missouri,Daviess County,12,589,300,289
Missouri,Daviess County,13,559,287,272
Missouri,Daviess County,14,545,268,277
Missouri,Daviess County,15,384,196,188
Missouri,Daviess County,16,280,140,140
Missouri,Daviess County,17,191,87,104
Missouri,Daviess County,18,166,67,99
Missouri,DeKalb County,0,12692,8019,4673
Missouri,DeKalb County,1,539,291,248
Missouri,DeKalb County,2,577,300,277
Missouri,DeKalb County,3,621,339,282
Missouri,DeKalb County,4,607,335,272
Missouri,DeKalb County,5,840,601,239
Missouri,DeKalb County,6,1014,773,241
Missouri,DeKalb County,7,1034,768,266
Missouri,DeKalb County,8,947,704,243
Missouri,DeKalb County,9,986,713,273
Missouri,DeKalb County,10,922,641,281
Missouri,DeKalb County,11,1055,687,368
Missouri,DeKalb County,12,865,526,339
Missouri,DeKalb County,13,696,395,301
Missouri,DeKalb County,14,527,279,248
Missouri,DeKalb County,15,521,273,248
Missouri,DeKalb County,16,359,173,186
Missouri,DeKalb County,17,265,107,158
Missouri,DeKalb County,18,317,114,203
Missouri,Dent County,0,15655,7822,7833
Missouri,Dent County,1,921,439,482
Missouri,Dent County,2,973,525,448
Missouri,Dent County,3,1024,528,496
Missouri,Dent County,4,966,521,445
Missouri,Dent County,5,888,481,407
Missouri,Dent County,6,830,418,412
Missouri,Dent County,7,845,433,412
Missouri,Dent County,8,800,381,419
Missouri,Dent County,9,864,445,419
Missouri,Dent County,10,946,484,462
Missouri,Dent County,11,1194,610,584
Missouri,Dent County,12,1203,606,597
Missouri,Dent County,13,1026,484,542
Missouri,Dent County,14,927,464,463
Missouri,Dent County,15,829,387,442
Missouri,Dent County,16,605,287,318
Missouri,Dent County,17,411,198,213
Missouri,Dent County,18,403,131,272
Missouri,Douglas County,0,13546,6690,6856
Missouri,Douglas County,1,758,390,368
Missouri,Douglas County,2,812,389,423
Missouri,Douglas County,3,826,440,386
Missouri,Douglas County,4,760,390,370
Missouri,Douglas County,5,660,357,303
Missouri,Douglas County,6,665,320,345
Missouri,Douglas County,7,685,348,337
Missouri,Douglas County,8,618,303,315
Missouri,Douglas County,9,708,344,364
Missouri,Douglas County,10,765,352,413
Missouri,Douglas County,11,1028,538,490
Missouri,Douglas County,12,1137,547,590
Missouri,Douglas County,13,1115,564,551
Missouri,Douglas County,14,926,467,459
Missouri,Douglas County,15,791,387,404
Missouri,Douglas County,16,553,263,290
Missouri,Douglas County,17,409,178,231
Missouri,Douglas County,18,330,113,217
Missouri,Dunklin County,0,31344,15014,16330
Missouri,Dunklin County,1,2276,1173,1103
Missouri,Dunklin County,2,2222,1106,1116
Missouri,Dunklin County,3,2259,1147,1112
Missouri,Dunklin County,4,2083,1079,1004
Missouri,Dunklin County,5,1857,919,938
Missouri,Dunklin County,6,1671,797,874
Missouri,Dunklin County,7,1744,842,902
Missouri,Dunklin County,8,1820,883,937
Missouri,Dunklin County,9,1784,824,960
Missouri,Dunklin County,10,1973,956,1017
Missouri,Dunklin County,11,2185,1071,1114
Missouri,Dunklin County,12,2088,1010,1078
Missouri,Dunklin County,13,1921,925,996
Missouri,Dunklin County,14,1676,728,948
Missouri,Dunklin County,15,1354,633,721
Missouri,Dunklin County,16,1049,442,607
Missouri,Dunklin County,17,689,259,430
Missouri,Dunklin County,18,693,220,473
Missouri,Franklin County,0,102084,50686,51398
Missouri,Franklin County,1,6319,3305,3014
Missouri,Franklin County,2,6647,3430,3217
Missouri,Franklin County,3,6944,3567,3377
Missouri,Franklin County,4,6372,3311,3061
Missouri,Franklin County,5,6257,3128,3129
Missouri,Franklin County,6,6102,3122,2980
Missouri,Franklin County,7,6195,3151,3044
Missouri,Franklin County,8,5460,2768,2692
Missouri,Franklin County,9,6277,3091,3186
Missouri,Franklin County,10,7137,3540,3597
Missouri,Franklin County,11,8352,4176,4176
Missouri,Franklin County,12,7838,3889,3949
Missouri,Franklin County,13,6242,3086,3156
Missouri,Franklin County,14,5215,2486,2729
Missouri,Franklin County,15,3970,1878,2092
Missouri,Franklin County,16,2847,1270,1577
Missouri,Franklin County,17,2011,853,1158
Missouri,Franklin County,18,1899,635,1264
Missouri,Gasconade County,0,14866,7340,7526
Missouri,Gasconade County,1,743,374,369
Missouri,Gasconade County,2,866,438,428
Missouri,Gasconade County,3,932,501,431
Missouri,Gasconade County,4,888,444,444
Missouri,Gasconade County,5,789,381,408
Missouri,Gasconade County,6,718,366,352
Missouri,Gasconade County,7,744,380,364
Missouri,Gasconade County,8,736,369,367
Missouri,Gasconade County,9,838,432,406
Missouri,Gasconade County,10,940,474,466
Missouri,Gasconade County,11,1166,612,554
Missouri,Gasconade County,12,1252,645,607
Missouri,Gasconade County,13,1040,528,512
Missouri,Gasconade County,14,959,430,529
Missouri,Gasconade County,15,750,344,406
Missouri,Gasconade County,16,594,276,318
Missouri,Gasconade County,17,406,167,239
Missouri,Gasconade County,18,505,179,326
Missouri,Gentry County,0,6826,3298,3528
Missouri,Gentry County,1,511,289,222
Missouri,Gentry County,2,451,216,235
Missouri,Gentry County,3,457,223,234
Missouri,Gentry County,4,411,201,210
Missouri,Gentry County,5,397,194,203
Missouri,Gentry County,6,381,173,208
Missouri,Gentry County,7,377,181,196
Missouri,Gentry County,8,333,177,156
Missouri,Gentry County,9,356,161,195
Missouri,Gentry County,10,418,216,202
Missouri,Gentry County,11,485,247,238
Missouri,Gentry County,12,496,251,245
Missouri,Gentry County,13,405,200,205
Missouri,Gentry County,14,312,144,168
Missouri,Gentry County,15,320,149,171
Missouri,Gentry County,16,265,112,153
Missouri,Gentry County,17,206,85,121
Missouri,Gentry County,18,245,79,166
Missouri,Greene County,0,285865,139466,146399
Missouri,Greene County,1,17421,8961,8460
Missouri,Greene County,2,17013,8780,8233
Missouri,Greene County,3,16058,8282,7776
Missouri,Greene County,4,18757,9182,9575
Missouri,Greene County,5,31183,15343,15840
Missouri,Greene County,6,20598,10297,10301
Missouri,Greene County,7,19627,10112,9515
Missouri,Greene County,8,16657,8618,8039
Missouri,Greene County,9,16382,8357,8025
Missouri,Greene County,10,16281,8129,8152
Missouri,Greene County,11,18318,8926,9392
Missouri,Greene County,12,17771,8525,9246
Missouri,Greene County,13,16051,7437,8614
Missouri,Greene County,14,13516,6315,7201
Missouri,Greene County,15,10359,4569,5790
Missouri,Greene County,16,7536,3223,4313
Missouri,Greene County,17,5836,2282,3554
Missouri,Greene County,18,6501,2128,4373
Missouri,Grundy County,0,10197,4832,5365
Missouri,Grundy County,1,694,344,350
Missouri,Grundy County,2,690,337,353
Missouri,Grundy County,3,645,296,349
Missouri,Grundy County,4,656,309,347
Missouri,Grundy County,5,649,325,324
Missouri,Grundy County,6,592,297,295
Missouri,Grundy County,7,571,294,277
Missouri,Grundy County,8,453,216,237
Missouri,Grundy County,9,499,232,267
Missouri,Grundy County,10,596,286,310
Missouri,Grundy County,11,693,337,356
Missouri,Grundy County,12,681,352,329
Missouri,Grundy County,13,618,304,314
Missouri,Grundy County,14,566,263,303
Missouri,Grundy County,15,531,237,294
Missouri,Grundy County,16,425,191,234
Missouri,Grundy County,17,283,110,173
Missouri,Grundy County,18,355,102,253
Missouri,Harrison County,0,8639,4304,4335
Missouri,Harrison County,1,585,314,271
Missouri,Harrison County,2,632,335,297
Missouri,Harrison County,3,580,310,270
Missouri,Harrison County,4,512,287,225
Missouri,Harrison County,5,441,226,215
Missouri,Harrison County,6,444,215,229
Missouri,Harrison County,7,463,226,237
Missouri,Harrison County,8,439,228,211
Missouri,Harrison County,9,466,239,227
Missouri,Harrison County,10,479,240,239
Missouri,Harrison County,11,581,288,293
Missouri,Harrison County,12,653,316,337
Missouri,Harrison County,13,546,274,272
Missouri,Harrison County,14,469,242,227
Missouri,Harrison County,15,434,212,222
Missouri,Harrison County,16,350,161,189
Missouri,Harrison County,17,268,101,167
Missouri,Harrison County,18,297,90,207
Missouri,Henry County,0,22028,10809,11219
Missouri,Henry County,1,1314,701,613
Missouri,Henry County,2,1330,643,687
Missouri,Henry County,3,1458,721,737
Missouri,Henry County,4,1229,649,580
Missouri,Henry County,5,1137,562,575
Missouri,Henry County,6,1209,597,612
Missouri,Henry County,7,1241,606,635
Missouri,Henry County,8,1185,608,577
Missouri,Henry County,9,1286,666,620
Missouri,Henry County,10,1329,660,669
Missouri,Henry County,11,1652,817,835
Missouri,Henry County,12,1653,815,838
Missouri,Henry County,13,1482,701,781
Missouri,Henry County,14,1415,674,741
Missouri,Henry County,15,1135,563,572
Missouri,Henry County,16,828,373,455
Missouri,Henry County,17,576,252,324
Missouri,Henry County,18,569,201,368
Missouri,Hickory County,0,9219,4511,4708
Missouri,Hickory County,1,360,194,166
Missouri,Hickory County,2,440,211,229
Missouri,Hickory County,3,458,222,236
Missouri,Hickory County,4,459,227,232
Missouri,Hickory County,5,348,180,168
Missouri,Hickory County,6,325,162,163
Missouri,Hickory County,7,318,164,154
Missouri,Hickory County,8,351,164,187
Missouri,Hickory County,9,446,210,236
Missouri,Hickory County,10,535,276,259
Missouri,Hickory County,11,671,305,366
Missouri,Hickory County,12,745,367,378
Missouri,Hickory County,13,824,383,441
Missouri,Hickory County,14,953,470,483
Missouri,Hickory County,15,802,412,390
Missouri,Hickory County,16,541,261,280
Missouri,Hickory County,17,378,187,191
Missouri,Hickory County,18,265,116,149
Missouri,Holt County,0,4516,2226,2290
Missouri,Holt County,1,231,122,109
Missouri,Holt County,2,259,130,129
Missouri,Holt County,3,263,140,123
Missouri,Holt County,4,221,114,107
Missouri,Holt County,5,223,107,116
Missouri,Holt County,6,227,121,106
Missouri,Holt County,7,220,111,109
Missouri,Holt County,8,221,118,103
Missouri,Holt County,9,265,128,137
Missouri,Holt County,10,283,137,146
Missouri,Holt County,11,366,186,180
Missouri,Holt County,12,360,170,190
Missouri,Holt County,13,346,187,159
Missouri,Holt County,14,301,147,154
Missouri,Holt County,15,205,111,94
Missouri,Holt County,16,168,80,88
Missouri,Holt County,17,153,61,92
Missouri,Holt County,18,204,56,148
Missouri,Howard County,0,10159,5062,5097
Missouri,Howard County,1,597,328,269
Missouri,Howard County,2,626,325,301
Missouri,Howard County,3,611,304,307
Missouri,Howard County,4,825,419,406
Missouri,Howard County,5,849,423,426
Missouri,Howard County,6,568,285,283
Missouri,Howard County,7,592,281,311
Missouri,Howard County,8,477,243,234
Missouri,Howard County,9,520,261,259
Missouri,Howard County,10,568,304,264
Missouri,Howard County,11,744,384,360
Missouri,Howard County,12,774,392,382
Missouri,Howard County,13,680,319,361
Missouri,Howard County,14,527,268,259
Missouri,Howard County,15,425,200,225
Missouri,Howard County,16,308,144,164
Missouri,Howard County,17,236,88,148
Missouri,Howard County,18,232,94,138
Missouri,Howell County,0,40173,19549,20624
Missouri,Howell County,1,2639,1364,1275
Missouri,Howell County,2,2681,1362,1319
Missouri,Howell County,3,2750,1406,1344
Missouri,Howell County,4,2538,1316,1222
Missouri,Howell County,5,2344,1175,1169
Missouri,Howell County,6,2351,1183,1168
Missouri,Howell County,7,2306,1152,1154
Missouri,Howell County,8,2213,1092,1121
Missouri,Howell County,9,2434,1157,1277
Missouri,Howell County,10,2376,1182,1194
Missouri,Howell County,11,2829,1356,1473
Missouri,Howell County,12,2660,1268,1392
Missouri,Howell County,13,2602,1233,1369
Missouri,Howell County,14,2342,1115,1227
Missouri,Howell County,15,1790,829,961
Missouri,Howell County,16,1388,633,755
Missouri,Howell County,17,959,412,547
Missouri,Howell County,18,971,314,657
Missouri,Iron County,0,10267,5065,5202
Missouri,Iron County,1,612,307,305
Missouri,Iron County,2,616,290,326
Missouri,Iron County,3,631,343,288
Missouri,Iron County,4,581,286,295
Missouri,Iron County,5,542,288,254
Missouri,Iron County,6,523,273,250
Missouri,Iron County,7,570,271,299
Missouri,Iron County,8,598,295,303
Missouri,Iron County,9,641,331,310
Missouri,Iron County,10,668,336,332
Missouri,Iron County,11,782,399,383
Missouri,Iron County,12,817,404,413
Missouri,Iron County,13,764,373,391
Missouri,Iron County,14,611,296,315
Missouri,Iron County,15,515,240,275
Missouri,Iron County,16,351,163,188
Missouri,Iron County,17,250,107,143
Missouri,Iron County,18,195,63,132
Missouri,Jackson County,0,683191,330369,352822
Missouri,Jackson County,1,46696,23750,22946
Missouri,Jackson County,2,46413,23591,22822
Missouri,Jackson County,3,44798,22882,21916
Missouri,Jackson County,4,40872,20715,20157
Missouri,Jackson County,5,45307,22079,23228
Missouri,Jackson County,6,53057,26019,27038
Missouri,Jackson County,7,50270,24660,25610
Missouri,Jackson County,8,42593,20894,21699
Missouri,Jackson County,9,42696,20924,21772
Missouri,Jackson County,10,42333,20910,21423
Missouri,Jackson County,11,49381,23930,25451
Missouri,Jackson County,12,46903,22590,24313
Missouri,Jackson County,13,39343,18412,20931
Missouri,Jackson County,14,30340,13882,16458
Missouri,Jackson County,15,21520,9489,12031
Missouri,Jackson County,16,15432,6549,8883
Missouri,Jackson County,17,12087,4768,7319
Missouri,Jackson County,18,13150,4325,8825
Missouri,Jasper County,0,117543,57424,60119
Missouri,Jasper County,1,8399,4356,4043
Missouri,Jasper County,2,8533,4302,4231
Missouri,Jasper County,3,8305,4245,4060
Missouri,Jasper County,4,7697,3900,3797
Missouri,Jasper County,5,8301,4092,4209
Missouri,Jasper County,6,8475,4187,4288
Missouri,Jasper County,7,8063,4053,4010
Missouri,Jasper County,8,7375,3711,3664
Missouri,Jasper County,9,7305,3616,3689
Missouri,Jasper County,10,6883,3356,3527
Missouri,Jasper County,11,7707,3815,3892
Missouri,Jasper County,12,7582,3661,3921
Missouri,Jasper County,13,6523,3060,3463
Missouri,Jasper County,14,5264,2484,2780
Missouri,Jasper County,15,3908,1792,2116
Missouri,Jasper County,16,2936,1276,1660
Missouri,Jasper County,17,2150,870,1280
Missouri,Jasper County,18,2137,648,1489
Missouri,Jefferson County,0,222716,110481,112235
Missouri,Jefferson County,1,13926,7141,6785
Missouri,Jefferson County,2,15184,7791,7393
Missouri,Jefferson County,3,15170,7733,7437
Missouri,Jefferson County,4,13846,7142,6704
Missouri,Jefferson County,5,13161,6662,6499
Missouri,Jefferson County,6,13662,6868,6794
Missouri,Jefferson County,7,15019,7475,7544
Missouri,Jefferson County,8,14444,7308,7136
Missouri,Jefferson County,9,14790,7318,7472
Missouri,Jefferson County,10,15373,7568,7805
Missouri,Jefferson County,11,18226,9122,9104
Missouri,Jefferson County,12,16714,8349,8365
Missouri,Jefferson County,13,13527,6575,6952
Missouri,Jefferson County,14,10844,5196,5648
Missouri,Jefferson County,15,7811,3633,4178
Missouri,Jefferson County,16,4993,2250,2743
Missouri,Jefferson County,17,3226,1367,1859
Missouri,Jefferson County,18,2800,983,1817
Missouri,Johnson County,0,54362,27858,26504
Missouri,Johnson County,1,3530,1794,1736
Missouri,Johnson County,2,3293,1671,1622
Missouri,Johnson County,3,3152,1606,1546
Missouri,Johnson County,4,4500,2241,2259
Missouri,Johnson County,5,8795,4869,3926
Missouri,Johnson County,6,4199,2337,1862
Missouri,Johnson County,7,3514,1799,1715
Missouri,Johnson County,8,2879,1494,1385
Missouri,Johnson County,9,2758,1400,1358
Missouri,Johnson County,10,2587,1263,1324
Missouri,Johnson County,11,3305,1651,1654
Missouri,Johnson County,12,2974,1474,1500
Missouri,Johnson County,13,2479,1229,1250
Missouri,Johnson County,14,2113,1044,1069
Missouri,Johnson County,15,1559,745,814
Missouri,Johnson County,16,1101,533,568
Missouri,Johnson County,17,814,376,438
Missouri,Johnson County,18,810,332,478
Missouri,Knox County,0,4000,1980,2020
Missouri,Knox County,1,272,139,133
Missouri,Knox County,2,251,126,125
Missouri,Knox County,3,257,142,115
Missouri,Knox County,4,277,145,132
Missouri,Knox County,5,214,120,94
Missouri,Knox County,6,188,86,102
Missouri,Knox County,7,209,110,99
Missouri,Knox County,8,166,77,89
Missouri,Knox County,9,229,114,115
Missouri,Knox County,10,228,112,116
Missouri,Knox County,11,307,151,156
Missouri,Knox County,12,311,165,146
Missouri,Knox County,13,250,126,124
Missouri,Knox County,14,251,118,133
Missouri,Knox County,15,209,96,113
Missouri,Knox County,16,154,68,86
Missouri,Knox County,17,105,35,70
Missouri,Knox County,18,122,50,72
Missouri,Laclede County,0,35439,17457,17982
Missouri,Laclede County,1,2322,1130,1192
Missouri,Laclede County,2,2541,1323,1218
Missouri,Laclede County,3,2442,1232,1210
Missouri,Laclede County,4,2188,1142,1046
Missouri,Laclede County,5,2037,1059,978
Missouri,Laclede County,6,2010,997,1013
Missouri,Laclede County,7,2172,1067,1105
Missouri,Laclede County,8,2027,991,1036
Missouri,Laclede County,9,2223,1088,1135
Missouri,Laclede County,10,2269,1139,1130
Missouri,Laclede County,11,2678,1383,1295
Missouri,Laclede County,12,2433,1195,1238
Missouri,Laclede County,13,2113,1009,1104
Missouri,Laclede County,14,1939,888,1051
Missouri,Laclede County,15,1565,739,826
Missouri,Laclede County,16,1125,532,593
Missouri,Laclede County,17,702,311,391
Missouri,Laclede County,18,653,232,421
Missouri,Lafayette County,0,32688,16221,16467
Missouri,Lafayette County,1,1889,996,893
Missouri,Lafayette County,2,2103,1041,1062
Missouri,Lafayette County,3,2137,1103,1034
Missouri,Lafayette County,4,2251,1230,1021
Missouri,Lafayette County,5,1939,1020,919
Missouri,Lafayette County,6,1734,877,857
Missouri,Lafayette County,7,1808,874,934
Missouri,Lafayette County,8,1730,867,863
Missouri,Lafayette County,9,2062,1015,1047
Missouri,Lafayette County,10,2137,1041,1096
Missouri,Lafayette County,11,2559,1269,1290
Missouri,Lafayette County,12,2446,1246,1200
Missouri,Lafayette County,13,2042,1001,1041
Missouri,Lafayette County,14,1693,800,893
Missouri,Lafayette County,15,1464,715,749
Missouri,Lafayette County,16,1019,482,537
Missouri,Lafayette County,17,797,341,456
Missouri,Lafayette County,18,878,303,575
Missouri,Lawrence County,0,38023,18819,19204
Missouri,Lawrence County,1,2431,1257,1174
Missouri,Lawrence County,2,2650,1361,1289
Missouri,Lawrence County,3,2845,1452,1393
Missouri,Lawrence County,4,2602,1382,1220
Missouri,Lawrence County,5,2058,1033,1025
Missouri,Lawrence County,6,1965,984,981
Missouri,Lawrence County,7,2169,1065,1104
Missouri,Lawrence County,8,2245,1104,1141
Missouri,Lawrence County,9,2343,1192,1151
Missouri,Lawrence County,10,2324,1165,1159
Missouri,Lawrence County,11,2790,1360,1430
Missouri,Lawrence County,12,2596,1278,1318
Missouri,Lawrence County,13,2255,1115,1140
Missouri,Lawrence County,14,2061,969,1092
Missouri,Lawrence County,15,1622,745,877
Missouri,Lawrence County,16,1267,586,681
Missouri,Lawrence County,17,902,392,510
Missouri,Lawrence County,18,898,379,519
Missouri,Lewis County,0,10138,5068,5070
Missouri,Lewis County,1,589,305,284
Missouri,Lewis County,2,641,351,290
Missouri,Lewis County,3,646,330,316
Missouri,Lewis County,4,829,424,405
Missouri,Lewis County,5,833,445,388
Missouri,Lewis County,6,521,252,269
Missouri,Lewis County,7,583,289,294
Missouri,Lewis County,8,496,249,247
Missouri,Lewis County,9,538,278,260
Missouri,Lewis County,10,589,295,294
Missouri,Lewis County,11,760,394,366
Missouri,Lewis County,12,703,353,350
Missouri,Lewis County,13,581,269,312
Missouri,Lewis County,14,536,263,273
Missouri,Lewis County,15,447,236,211
Missouri,Lewis County,16,326,127,199
Missouri,Lewis County,17,258,110,148
Missouri,Lewis County,18,262,98,164
Missouri,Lincoln County,0,54249,27221,27028
Missouri,Lincoln County,1,3662,1958,1704
Missouri,Lincoln County,2,4029,2119,1910
Missouri,Lincoln County,3,4132,2134,1998
Missouri,Lincoln County,4,3761,1902,1859
Missouri,Lincoln County,5,3262,1686,1576
Missouri,Lincoln County,6,3344,1577,1767
Missouri,Lincoln County,7,3590,1768,1822
Missouri,Lincoln County,8,3457,1693,1764
Missouri,Lincoln County,9,3400,1723,1677
Missouri,Lincoln County,10,3756,1916,1840
Missouri,Lincoln County,11,4250,2125,2125
Missouri,Lincoln County,12,3849,1949,1900
Missouri,Lincoln County,13,3023,1504,1519
Missouri,Lincoln County,14,2279,1095,1184
Missouri,Lincoln County,15,1770,898,872
Missouri,Lincoln County,16,1150,554,596
Missouri,Lincoln County,17,853,365,488
Missouri,Lincoln County,18,682,255,427
Missouri,Linn County,0,12311,5978,6333
Missouri,Linn County,1,688,374,314
Missouri,Linn County,2,854,439,415
Missouri,Linn County,3,864,420,444
Missouri,Linn County,4,802,414,388
Missouri,Linn County,5,676,354,322
Missouri,Linn County,6,561,274,287
Missouri,Linn County,7,665,325,340
Missouri,Linn County,8,678,334,344
Missouri,Linn County,9,671,332,339
Missouri,Linn County,10,681,350,331
Missouri,Linn County,11,925,440,485
Missouri,Linn County,12,940,445,495
Missouri,Linn County,13,825,416,409
Missouri,Linn County,14,735,358,377
Missouri,Linn County,15,591,282,309
Missouri,Linn County,16,437,178,259
Missouri,Linn County,17,347,135,212
Missouri,Linn County,18,371,108,263
Missouri,Livingston County,0,15053,6639,8414
Missouri,Livingston County,1,872,449,423
Missouri,Livingston County,2,925,453,472
Missouri,Livingston County,3,843,417,426
Missouri,Livingston County,4,825,406,419
Missouri,Livingston County,5,922,410,512
Missouri,Livingston County,6,940,383,557
Missouri,Livingston County,7,1019,389,630
Missouri,Livingston County,8,928,366,562
Missouri,Livingston County,9,1011,388,623
Missouri,Livingston County,10,920,385,535
Missouri,Livingston County,11,1027,436,591
Missouri,Livingston County,12,998,492,506
Missouri,Livingston County,13,915,438,477
Missouri,Livingston County,14,804,353,451
Missouri,Livingston County,15,663,323,340
Missouri,Livingston County,16,502,224,278
Missouri,Livingston County,17,402,159,243
Missouri,Livingston County,18,537,168,369
Missouri,McDonald County,0,22800,11583,11217
Missouri,McDonald County,1,1501,748,753
Missouri,McDonald County,2,1651,878,773
Missouri,McDonald County,3,1725,884,841
Missouri,McDonald County,4,1674,893,781
Missouri,McDonald County,5,1375,739,636
Missouri,McDonald County,6,1327,673,654
Missouri,McDonald County,7,1301,672,629
Missouri,McDonald County,8,1356,667,689
Missouri,McDonald County,9,1471,762,709
Missouri,McDonald County,10,1597,796,801
Missouri,McDonald County,11,1723,884,839
Missouri,McDonald County,12,1590,792,798
Missouri,McDonald County,13,1318,663,655
Missouri,McDonald County,14,1122,578,544
Missouri,McDonald County,15,870,398,472
Missouri,McDonald County,16,567,278,289
Missouri,McDonald County,17,364,176,188
Missouri,McDonald County,18,268,102,166
Missouri,Macon County,0,15479,7599,7880
Missouri,Macon County,1,920,436,484
Missouri,Macon County,2,1083,544,539
Missouri,Macon County,3,1020,517,503
Missouri,Macon County,4,967,541,426
Missouri,Macon County,5,791,415,376
Missouri,Macon County,6,785,390,395
Missouri,Macon County,7,854,415,439
Missouri,Macon County,8,815,418,397
Missouri,Macon County,9,866,439,427
Missouri,Macon County,10,933,470,463
Missouri,Macon County,11,1076,549,527
Missouri,Macon County,12,1075,524,551
Missouri,Macon County,13,1044,505,539
Missouri,Macon County,14,977,476,501
Missouri,Macon County,15,768,351,417
Missouri,Macon County,16,591,270,321
Missouri,Macon County,17,440,182,258
Missouri,Macon County,18,474,157,317
Missouri,Madison County,0,12368,6087,6281
Missouri,Madison County,1,724,384,340
Missouri,Madison County,2,813,411,402
Missouri,Madison County,3,823,427,396
Missouri,Madison County,4,784,420,364
Missouri,Madison County,5,686,325,361
Missouri,Madison County,6,673,343,330
Missouri,Madison County,7,704,356,348
Missouri,Madison County,8,727,366,361
Missouri,Madison County,9,727,352,375
Missouri,Madison County,10,782,375,407
Missouri,Madison County,11,899,448,451
Missouri,Madison County,12,890,437,453
Missouri,Madison County,13,764,375,389
Missouri,Madison County,14,687,331,356
Missouri,Madison County,15,658,309,349
Missouri,Madison County,16,458,187,271
Missouri,Madison County,17,310,143,167
Missouri,Madison County,18,259,98,161
Missouri,Maries County,0,9013,4537,4476
Missouri,Maries County,1,419,236,183
Missouri,Maries County,2,568,297,271
Missouri,Maries County,3,597,297,300
Missouri,Maries County,4,581,302,279
Missouri,Maries County,5,455,241,214
Missouri,Maries County,6,446,199,247
Missouri,Maries County,7,502,244,258
Missouri,Maries County,8,484,265,219
Missouri,Maries County,9,515,265,250
Missouri,Maries County,10,598,278,320
Missouri,Maries County,11,777,400,377
Missouri,Maries County,12,703,363,340
Missouri,Maries County,13,625,323,302
Missouri,Maries County,14,526,256,270
Missouri,Maries County,15,463,223,240
Missouri,Maries County,16,326,151,175
Missouri,Maries County,17,238,116,122
Missouri,Maries County,18,190,81,109
Missouri,Marion County,0,28920,14010,14910
Missouri,Marion County,1,1817,896,921
Missouri,Marion County,2,1932,955,977
Missouri,Marion County,3,1928,988,940
Missouri,Marion County,4,1856,901,955
Missouri,Marion County,5,1923,949,974
Missouri,Marion County,6,1701,838,863
Missouri,Marion County,7,1825,866,959
Missouri,Marion County,8,1657,823,834
Missouri,Marion County,9,1711,858,853
Missouri,Marion County,10,1743,869,874
Missouri,Marion County,11,2109,1062,1047
Missouri,Marion County,12,1994,981,1013
Missouri,Marion County,13,1843,915,928
Missouri,Marion County,14,1477,715,762
Missouri,Marion County,15,1086,508,578
Missouri,Marion County,16,851,360,491
Missouri,Marion County,17,700,272,428
Missouri,Marion County,18,767,254,513
Missouri,Mercer County,0,3719,1868,1851
Missouri,Mercer County,1,205,93,112
Missouri,Mercer County,2,252,136,116
Missouri,Mercer County,3,250,143,107
Missouri,Mercer County,4,281,140,141
Missouri,Mercer County,5,180,93,87
Missouri,Mercer County,6,143,67,76
Missouri,Mercer County,7,203,100,103
Missouri,Mercer County,8,166,74,92
Missouri,Mercer County,9,216,115,101
Missouri,Mercer County,10,206,100,106
Missouri,Mercer County,11,287,138,149
Missouri,Mercer County,12,286,152,134
Missouri,Mercer County,13,270,143,127
Missouri,Mercer County,14,200,114,86
Missouri,Mercer County,15,195,94,101
Missouri,Mercer County,16,138,67,71
Missouri,Mercer County,17,115,43,72
Missouri,Mercer County,18,126,56,70
Missouri,Miller County,0,25141,12549,12592
Missouri,Miller County,1,1500,730,770
Missouri,Miller County,2,1660,848,812
Missouri,Miller County,3,1645,830,815
Missouri,Miller County,4,1646,899,747
Missouri,Miller County,5,1403,741,662
Missouri,Miller County,6,1419,722,697
Missouri,Miller County,7,1478,720,758
Missouri,Miller County,8,1354,685,669
Missouri,Miller County,9,1532,790,742
Missouri,Miller County,10,1572,801,771
Missouri,Miller County,11,1873,932,941
Missouri,Miller County,12,1864,903,961
Missouri,Miller County,13,1670,830,840
Missouri,Miller County,14,1456,729,727
Missouri,Miller County,15,1142,543,599
Missouri,Miller County,16,768,359,409
Missouri,Miller County,17,564,255,309
Missouri,Miller County,18,595,232,363
Missouri,Mississippi County,0,14232,7605,6627
Missouri,Mississippi County,1,943,435,508
Missouri,Mississippi County,2,881,458,423
Missouri,Mississippi County,3,869,446,423
Missouri,Mississippi County,4,759,419,340
Missouri,Mississippi County,5,945,553,392
Missouri,Mississippi County,6,1012,595,417
Missouri,Mississippi County,7,977,576,401
Missouri,Mississippi County,8,915,546,369
Missouri,Mississippi County,9,963,594,369
Missouri,Mississippi County,10,970,574,396
Missouri,Mississippi County,11,1002,541,461
Missouri,Mississippi County,12,892,462,430
Missouri,Mississippi County,13,795,392,403
Missouri,Mississippi County,14,737,352,385
Missouri,Mississippi County,15,591,288,303
Missouri,Mississippi County,16,429,192,237
Missouri,Mississippi County,17,267,105,162
Missouri,Mississippi County,18,285,77,208
Missouri,Moniteau County,0,15856,8419,7437
Missouri,Moniteau County,1,1030,548,482
Missouri,Moniteau County,2,1099,554,545
Missouri,Moniteau County,3,1154,579,575
Missouri,Moniteau County,4,1004,517,487
Missouri,Moniteau County,5,957,531,426
Missouri,Moniteau County,6,1027,592,435
Missouri,Moniteau County,7,1069,639,430
Missouri,Moniteau County,8,1069,625,444
Missouri,Moniteau County,9,1065,613,452
Missouri,Moniteau County,10,1076,620,456
Missouri,Moniteau County,11,1153,610,543
Missouri,Moniteau County,12,942,494,448
Missouri,Moniteau County,13,861,419,442
Missouri,Moniteau County,14,775,384,391
Missouri,Moniteau County,15,527,262,265
Missouri,Moniteau County,16,433,213,220
Missouri,Moniteau County,17,279,115,164
Missouri,Moniteau County,18,336,104,232
Missouri,Monroe County,0,8707,4407,4300
Missouri,Monroe County,1,453,246,207
Missouri,Monroe County,2,563,306,257
Missouri,Monroe County,3,604,310,294
Missouri,Monroe County,4,534,278,256
Missouri,Monroe County,5,465,235,230
Missouri,Monroe County,6,407,211,196
Missouri,Monroe County,7,470,250,220
Missouri,Monroe County,8,430,225,205
Missouri,Monroe County,9,468,247,221
Missouri,Monroe County,10,501,248,253
Missouri,Monroe County,11,683,346,337
Missouri,Monroe County,12,693,346,347
Missouri,Monroe County,13,627,318,309
Missouri,Monroe County,14,574,281,293
Missouri,Monroe County,15,462,240,222
Missouri,Monroe County,16,325,151,174
Missouri,Monroe County,17,202,94,108
Missouri,Monroe County,18,246,75,171
Missouri,Montgomery County,0,11841,5905,5936
Missouri,Montgomery County,1,706,340,366
Missouri,Montgomery County,2,785,420,365
Missouri,Montgomery County,3,746,390,356
Missouri,Montgomery County,4,686,370,316
Missouri,Montgomery County,5,618,313,305
Missouri,Montgomery County,6,634,330,304
Missouri,Montgomery County,7,638,324,314
Missouri,Montgomery County,8,627,301,326
Missouri,Montgomery County,9,645,334,311
Missouri,Montgomery County,10,738,382,356
Missouri,Montgomery County,11,926,459,467
Missouri,Montgomery County,12,910,455,455
Missouri,Montgomery County,13,837,446,391
Missouri,Montgomery County,14,643,304,339
Missouri,Montgomery County,15,617,301,316
Missouri,Montgomery County,16,395,181,214
Missouri,Montgomery County,17,315,136,179
Missouri,Montgomery County,18,375,119,256
Missouri,Morgan County,0,20240,10184,10056
Missouri,Morgan County,1,1213,628,585
Missouri,Morgan County,2,1250,645,605
Missouri,Morgan County,3,1253,633,620
Missouri,Morgan County,4,1117,588,529
Missouri,Morgan County,5,1016,496,520
Missouri,Morgan County,6,990,509,481
Missouri,Morgan County,7,954,488,466
Missouri,Morgan County,8,915,478,437
Missouri,Morgan County,9,1011,501,510
Missouri,Morgan County,10,1177,598,579
Missouri,Morgan County,11,1495,759,736
Missouri,Morgan County,12,1464,716,748
Missouri,Morgan County,13,1588,787,801
Missouri,Morgan County,14,1529,767,762
Missouri,Morgan County,15,1282,659,623
Missouri,Morgan County,16,932,477,455
Missouri,Morgan County,17,528,244,284
Missouri,Morgan County,18,526,211,315
Missouri,New Madrid County,0,18272,8744,9528
Missouri,New Madrid County,1,1109,592,517
Missouri,New Madrid County,2,1267,668,599
Missouri,New Madrid County,3,1178,571,607
Missouri,New Madrid County,4,1166,588,578
Missouri,New Madrid County,5,1055,553,502
Missouri,New Madrid County,6,1001,461,540
Missouri,New Madrid County,7,1041,478,563
Missouri,New Madrid County,8,1090,523,567
Missouri,New Madrid County,9,1095,564,531
Missouri,New Madrid County,10,1172,550,622
Missouri,New Madrid County,11,1356,647,709
Missouri,New Madrid County,12,1369,650,719
Missouri,New Madrid County,13,1151,542,609
Missouri,New Madrid County,14,1052,486,566
Missouri,New Madrid County,15,809,365,444
Missouri,New Madrid County,16,550,246,304
Missouri,New Madrid County,17,375,130,245
Missouri,New Madrid County,18,436,130,306
Missouri,Newton County,0,58598,29095,29503
Missouri,Newton County,1,3687,1907,1780
Missouri,Newton County,2,3980,2072,1908
Missouri,Newton County,3,4078,2126,1952
Missouri,Newton County,4,4039,2134,1905
Missouri,Newton County,5,3595,1803,1792
Missouri,Newton County,6,3388,1722,1666
Missouri,Newton County,7,3338,1645,1693
Missouri,Newton County,8,3212,1632,1580
Missouri,Newton County,9,3520,1754,1766
Missouri,Newton County,10,3678,1870,1808
Missouri,Newton County,11,4252,2098,2154
Missouri,Newton County,12,4023,1949,2074
Missouri,Newton County,13,3623,1784,1839
Missouri,Newton County,14,3267,1599,1668
Missouri,Newton County,15,2599,1205,1394
Missouri,Newton County,16,1921,854,1067
Missouri,Newton County,17,1300,549,751
Missouri,Newton County,18,1098,392,706
Missouri,Nodaway County,0,23081,11621,11460
Missouri,Nodaway County,1,1054,539,515
Missouri,Nodaway County,2,1087,568,519
Missouri,Nodaway County,3,1016,511,505
Missouri,Nodaway County,4,2686,1230,1456
Missouri,Nodaway County,5,4607,2318,2289
Missouri,Nodaway County,6,1273,779,494
Missouri,Nodaway County,7,1289,730,559
Missouri,Nodaway County,8,1019,539,480
Missouri,Nodaway County,9,1001,536,465
Missouri,Nodaway County,10,1125,580,545
Missouri,Nodaway County,11,1305,645,660
Missouri,Nodaway County,12,1255,645,610
Missouri,Nodaway County,13,1145,569,576
Missouri,Nodaway County,14,860,447,413
Missouri,Nodaway County,15,764,351,413
Missouri,Nodaway County,16,601,269,332
Missouri,Nodaway County,17,456,172,284
Missouri,Nodaway County,18,538,193,345
Missouri,Oregon County,0,10911,5365,5546
Missouri,Oregon County,1,670,358,312
Missouri,Oregon County,2,688,357,331
Missouri,Oregon County,3,657,285,372
Missouri,Oregon County,4,633,326,307
Missouri,Oregon County,5,595,312,283
Missouri,Oregon County,6,503,251,252
Missouri,Oregon County,7,474,230,244
Missouri,Oregon County,8,517,253,264
Missouri,Oregon County,9,578,282,296
Missouri,Oregon County,10,633,316,317
Missouri,Oregon County,11,913,436,477
Missouri,Oregon County,12,823,421,402
Missouri,Oregon County,13,818,404,414
Missouri,Oregon County,14,787,390,397
Missouri,Oregon County,15,650,316,334
Missouri,Oregon County,16,459,233,226
Missouri,Oregon County,17,258,106,152
Missouri,Oregon County,18,255,89,166
Missouri,Osage County,0,13703,7116,6587
Missouri,Osage County,1,782,399,383
Missouri,Osage County,2,924,483,441
Missouri,Osage County,3,946,483,463
Missouri,Osage County,4,969,544,425
Missouri,Osage County,5,842,501,341
Missouri,Osage County,6,737,390,347
Missouri,Osage County,7,742,383,359
Missouri,Osage County,8,813,439,374
Missouri,Osage County,9,866,451,415
Missouri,Osage County,10,932,471,461
Missouri,Osage County,11,1105,589,516
Missouri,Osage County,12,952,492,460
Missouri,Osage County,13,804,410,394
Missouri,Osage County,14,694,362,332
Missouri,Osage County,15,534,267,267
Missouri,Osage County,16,417,189,228
Missouri,Osage County,17,340,153,187
Missouri,Osage County,18,304,110,194
Missouri,Ozark County,0,9492,4795,4697
Missouri,Ozark County,1,444,259,185
Missouri,Ozark County,2,526,279,247
Missouri,Ozark County,3,545,261,284
Missouri,Ozark County,4,515,281,234
Missouri,Ozark County,5,420,225,195
Missouri,Ozark County,6,376,171,205
Missouri,Ozark County,7,440,219,221
Missouri,Ozark County,8,425,215,210
Missouri,Ozark County,9,463,234,229
Missouri,Ozark County,10,506,242,264
Missouri,Ozark County,11,717,371,346
Missouri,Ozark County,12,813,398,415
Missouri,Ozark County,13,808,422,386
Missouri,Ozark County,14,771,379,392
Missouri,Ozark County,15,668,348,320
Missouri,Ozark County,16,515,255,260
Missouri,Ozark County,17,291,145,146
Missouri,Ozark County,18,249,91,158
Missouri,Pemiscot County,0,17650,8347,9303
Missouri,Pemiscot County,1,1352,640,712
Missouri,Pemiscot County,2,1264,664,600
Missouri,Pemiscot County,3,1268,634,634
Missouri,Pemiscot County,4,1287,642,645
Missouri,Pemiscot County,5,1135,576,559
Missouri,Pemiscot County,6,1047,480,567
Missouri,Pemiscot County,7,972,445,527
Missouri,Pemiscot County,8,1041,471,570
Missouri,Pemiscot County,9,1021,493,528
Missouri,Pemiscot County,10,1092,518,574
Missouri,Pemiscot County,11,1182,564,618
Missouri,Pemiscot County,12,1223,589,634
Missouri,Pemiscot County,13,1058,493,565
Missouri,Pemiscot County,14,818,381,437
Missouri,Pemiscot County,15,680,324,356
Missouri,Pemiscot County,16,477,214,263
Missouri,Pemiscot County,17,364,104,260
Missouri,Pemiscot County,18,369,115,254
Missouri,Perry County,0,19202,9614,9588
Missouri,Perry County,1,1160,622,538
Missouri,Perry County,2,1326,700,626
Missouri,Perry County,3,1342,706,636
Missouri,Perry County,4,1223,616,607
Missouri,Perry County,5,1129,562,567
Missouri,Perry County,6,1083,574,509
Missouri,Perry County,7,1116,572,544
Missouri,Perry County,8,1159,585,574
Missouri,Perry County,9,1188,605,583
Missouri,Perry County,10,1248,633,615
Missouri,Perry County,11,1426,727,699
Missouri,Perry County,12,1327,656,671
Missouri,Perry County,13,1280,644,636
Missouri,Perry County,14,946,451,495
Missouri,Perry County,15,759,358,401
Missouri,Perry County,16,580,271,309
Missouri,Perry County,17,421,178,243
Missouri,Perry County,18,489,154,335
Missouri,Pettis County,0,42225,20858,21367
Missouri,Pettis County,1,2921,1521,1400
Missouri,Pettis County,2,3038,1572,1466
Missouri,Pettis County,3,2864,1479,1385
Missouri,Pettis County,4,2779,1401,1378
Missouri,Pettis County,5,2788,1359,1429
Missouri,Pettis County,6,2797,1445,1352
Missouri,Pettis County,7,2847,1394,1453
Missouri,Pettis County,8,2403,1209,1194
Missouri,Pettis County,9,2379,1219,1160
Missouri,Pettis County,10,2473,1228,1245
Missouri,Pettis County,11,3105,1568,1537
Missouri,Pettis County,12,2931,1439,1492
Missouri,Pettis County,13,2435,1208,1227
Missouri,Pettis County,14,1925,953,972
Missouri,Pettis County,15,1461,638,823
Missouri,Pettis County,16,1162,533,629
Missouri,Pettis County,17,927,370,557
Missouri,Pettis County,18,990,322,668
Missouri,Phelps County,0,44847,23505,21342
Missouri,Phelps County,1,2600,1345,1255
Missouri,Phelps County,2,2697,1417,1280
Missouri,Phelps County,3,2580,1338,1242
Missouri,Phelps County,4,3758,2296,1462
Missouri,Phelps County,5,5805,3717,2088
Missouri,Phelps County,6,2738,1457,1281
Missouri,Phelps County,7,2614,1367,1247
Missouri,Phelps County,8,2279,1135,1144
Missouri,Phelps County,9,2329,1181,1148
Missouri,Phelps County,10,2488,1212,1276
Missouri,Phelps County,11,2989,1445,1544
Missouri,Phelps County,12,2872,1394,1478
Missouri,Phelps County,13,2409,1181,1228
Missouri,Phelps County,14,2078,1027,1051
Missouri,Phelps County,15,1629,745,884
Missouri,Phelps County,16,1205,545,660
Missouri,Phelps County,17,856,380,476
Missouri,Phelps County,18,921,323,598
Missouri,Pike County,0,18541,10237,8304
Missouri,Pike County,1,1087,569,518
Missouri,Pike County,2,1153,594,559
Missouri,Pike County,3,1149,591,558
Missouri,Pike County,4,1024,551,473
Missouri,Pike County,5,1275,779,496
Missouri,Pike County,6,1260,806,454
Missouri,Pike County,7,1243,732,511
Missouri,Pike County,8,1126,688,438
Missouri,Pike County,9,1157,716,441
Missouri,Pike County,10,1243,771,472
Missouri,Pike County,11,1364,753,611
Missouri,Pike County,12,1299,695,604
Missouri,Pike County,13,1098,579,519
Missouri,Pike County,14,939,454,485
Missouri,Pike County,15,783,385,398
Missouri,Pike County,16,550,254,296
Missouri,Pike County,17,409,182,227
Missouri,Pike County,18,382,138,244
Missouri,Platte County,0,94788,46847,47941
Missouri,Platte County,1,5811,2937,2874
Missouri,Platte County,2,6240,3138,3102
Missouri,Platte County,3,6632,3385,3247
Missouri,Platte County,4,6250,3232,3018
Missouri,Platte County,5,5729,2969,2760
Missouri,Platte County,6,5969,2985,2984
Missouri,Platte County,7,6590,3312,3278
Missouri,Platte County,8,6328,3166,3162
Missouri,Platte County,9,6687,3298,3389
Missouri,Platte County,10,6457,3195,3262
Missouri,Platte County,11,7400,3664,3736
Missouri,Platte County,12,6738,3265,3473
Missouri,Platte County,13,5672,2744,2928
Missouri,Platte County,14,4437,2157,2280
Missouri,Platte County,15,3095,1504,1591
Missouri,Platte County,16,1904,889,1015
Missouri,Platte County,17,1308,533,775
Missouri,Platte County,18,1541,474,1067
Missouri,Polk County,0,31054,15164,15890
Missouri,Polk County,1,1880,909,971
Missouri,Polk County,2,1953,996,957
Missouri,Polk County,3,2082,1070,1012
Missouri,Polk County,4,2672,1366,1306
Missouri,Polk County,5,2667,1300,1367
Missouri,Polk County,6,1565,810,755
Missouri,Polk County,7,1740,858,882
Missouri,Polk County,8,1615,804,811
Missouri,Polk County,9,1820,867,953
Missouri,Polk County,10,1760,861,899
Missouri,Polk County,11,2234,1142,1092
Missouri,Polk County,12,1966,943,1023
Missouri,Polk County,13,1794,841,953
Missouri,Polk County,14,1625,795,830
Missouri,Polk County,15,1304,638,666
Missouri,Polk County,16,964,413,551
Missouri,Polk County,17,744,301,443
Missouri,Polk County,18,669,250,419
Missouri,Pulaski County,0,53436,30354,23082
Missouri,Pulaski County,1,3876,1966,1910
Missouri,Pulaski County,2,3416,1761,1655
Missouri,Pulaski County,3,3057,1606,1451
Missouri,Pulaski County,4,6003,4127,1876
Missouri,Pulaski County,5,8073,5718,2355
Missouri,Pulaski County,6,5258,3108,2150
Missouri,Pulaski County,7,4525,2555,1970
Missouri,Pulaski County,8,3390,1870,1520
Missouri,Pulaski County,9,2806,1500,1306
Missouri,Pulaski County,10,2482,1231,1251
Missouri,Pulaski County,11,2581,1215,1366
Missouri,Pulaski County,12,2176,1113,1063
Missouri,Pulaski County,13,1718,796,922
Missouri,Pulaski County,14,1391,675,716
Missouri,Pulaski County,15,1007,444,563
Missouri,Pulaski County,16,748,318,430
Missouri,Pulaski County,17,489,212,277
Missouri,Pulaski County,18,440,139,301
Missouri,Putnam County,0,4829,2459,2370
Missouri,Putnam County,1,239,128,111
Missouri,Putnam County,2,292,169,123
Missouri,Putnam County,3,314,159,155
Missouri,Putnam County,4,281,152,129
Missouri,Putnam County,5,266,147,119
Missouri,Putnam County,6,210,110,100
Missouri,Putnam County,7,235,120,115
Missouri,Putnam County,8,230,124,106
Missouri,Putnam County,9,258,127,131
Missouri,Putnam County,10,290,149,141
Missouri,Putnam County,11,351,184,167
Missouri,Putnam County,12,371,186,185
Missouri,Putnam County,13,352,177,175
Missouri,Putnam County,14,347,169,178
Missouri,Putnam County,15,280,134,146
Missouri,Putnam County,16,206,109,97
Missouri,Putnam County,17,153,62,91
Missouri,Putnam County,18,154,53,101
Missouri,Ralls County,0,10255,5167,5088
Missouri,Ralls County,1,533,264,269
Missouri,Ralls County,2,689,338,351
Missouri,Ralls County,3,624,324,300
Missouri,Ralls County,4,594,335,259
Missouri,Ralls County,5,491,235,256
Missouri,Ralls County,6,512,261,251
Missouri,Ralls County,7,527,259,268
Missouri,Ralls County,8,615,314,301
Missouri,Ralls County,9,609,304,305
Missouri,Ralls County,10,645,329,316
Missouri,Ralls County,11,863,428,435
Missouri,Ralls County,12,799,407,392
Missouri,Ralls County,13,776,394,382
Missouri,Ralls County,14,695,354,341
Missouri,Ralls County,15,581,290,291
Missouri,Ralls County,16,329,181,148
Missouri,Ralls County,17,189,83,106
Missouri,Ralls County,18,184,67,117
Missouri,Randolph County,0,25072,13156,11916
Missouri,Randolph County,1,1456,748,708
Missouri,Randolph County,2,1535,796,739
Missouri,Randolph County,3,1571,797,774
Missouri,Randolph County,4,1597,807,790
Missouri,Randolph County,5,1721,976,745
Missouri,Randolph County,6,1764,1029,735
Missouri,Randolph County,7,1685,987,698
Missouri,Randolph County,8,1612,949,663
Missouri,Randolph County,9,1617,906,711
Missouri,Randolph County,10,1707,924,783
Missouri,Randolph County,11,1839,997,842
Missouri,Randolph County,12,1609,824,785
Missouri,Randolph County,13,1497,739,758
Missouri,Randolph County,14,1227,585,642
Missouri,Randolph County,15,912,443,469
Missouri,Randolph County,16,679,291,388
Missouri,Randolph County,17,534,219,315
Missouri,Randolph County,18,510,139,371
Missouri,Ray County,0,22949,11499,11450
Missouri,Ray County,1,1268,658,610
Missouri,Ray County,2,1462,741,721
Missouri,Ray County,3,1600,864,736
Missouri,Ray County,4,1563,843,720
Missouri,Ray County,5,1312,698,614
Missouri,Ray County,6,1188,595,593
Missouri,Ray County,7,1228,614,614
Missouri,Ray County,8,1296,631,665
Missouri,Ray County,9,1463,743,720
Missouri,Ray County,10,1547,737,810
Missouri,Ray County,11,1850,970,880
Missouri,Ray County,12,1781,877,904
Missouri,Ray County,13,1461,729,732
Missouri,Ray County,14,1276,610,666
Missouri,Ray County,15,1060,499,561
Missouri,Ray County,16,707,334,373
Missouri,Ray County,17,438,195,243
Missouri,Ray County,18,449,161,288
Missouri,Reynolds County,0,6565,3362,3203
Missouri,Reynolds County,1,329,167,162
Missouri,Reynolds County,2,369,199,170
Missouri,Reynolds County,3,410,231,179
Missouri,Reynolds County,4,390,236,154
Missouri,Reynolds County,5,310,154,156
Missouri,Reynolds County,6,293,147,146
Missouri,Reynolds County,7,358,179,179
Missouri,Reynolds County,8,321,147,174
Missouri,Reynolds County,9,413,202,211
Missouri,Reynolds County,10,392,209,183
Missouri,Reynolds County,11,511,266,245
Missouri,Reynolds County,12,515,260,255
Missouri,Reynolds County,13,462,235,227
Missouri,Reynolds County,14,441,228,213
Missouri,Reynolds County,15,388,192,196
Missouri,Reynolds County,16,297,150,147
Missouri,Reynolds County,17,199,111,88
Missouri,Reynolds County,18,167,49,118
Missouri,Ripley County,0,13969,6887,7082
Missouri,Ripley County,1,959,473,486
Missouri,Ripley County,2,802,423,379
Missouri,Ripley County,3,888,472,416
Missouri,Ripley County,4,816,418,398
Missouri,Ripley County,5,768,366,402
Missouri,Ripley County,6,799,386,413
Missouri,Ripley County,7,760,396,364
Missouri,Ripley County,8,809,404,405
Missouri,Ripley County,9,844,425,419
Missouri,Ripley County,10,825,399,426
Missouri,Ripley County,11,1061,528,533
Missouri,Ripley County,12,1000,488,512
Missouri,Ripley County,13,904,440,464
Missouri,Ripley County,14,828,397,431
Missouri,Ripley County,15,725,349,376
Missouri,Ripley County,16,552,255,297
Missouri,Ripley County,17,346,152,194
Missouri,Ripley County,18,283,116,167
Missouri,Saline County,0,23347,11593,11754
Missouri,Saline County,1,1468,710,758
Missouri,Saline County,2,1521,774,747
Missouri,Saline County,3,1544,817,727
Missouri,Saline County,4,1709,928,781
Missouri,Saline County,5,1864,1004,860
Missouri,Saline County,6,1440,739,701
Missouri,Saline County,7,1400,673,727
Missouri,Saline County,8,1350,667,683
Missouri,Saline County,9,1258,620,638
Missouri,Saline County,10,1332,682,650
Missouri,Saline County,11,1587,789,798
Missouri,Saline County,12,1594,800,794
Missouri,Saline County,13,1394,703,691
Missouri,Saline County,14,1206,606,600
Missouri,Saline County,15,873,406,467
Missouri,Saline County,16,626,282,344
Missouri,Saline County,17,524,208,316
Missouri,Saline County,18,657,185,472
Missouri,Schuyler County,0,4370,2145,2225
Missouri,Schuyler County,1,266,123,143
Missouri,Schuyler County,2,288,144,144
Missouri,Schuyler County,3,337,185,152
Missouri,Schuyler County,4,310,151,159
Missouri,Schuyler County,5,250,133,117
Missouri,Schuyler County,6,228,125,103
Missouri,Schuyler County,7,208,108,100
Missouri,Schuyler County,8,236,100,136
Missouri,Schuyler County,9,247,125,122
Missouri,Schuyler County,10,266,126,140
Missouri,Schuyler County,11,303,153,150
Missouri,Schuyler County,12,315,161,154
Missouri,Schuyler County,13,253,128,125
Missouri,Schuyler County,14,218,106,112
Missouri,Schuyler County,15,225,102,123
Missouri,Schuyler County,16,173,89,84
Missouri,Schuyler County,17,119,41,78
Missouri,Schuyler County,18,128,45,83
Missouri,Scotland County,0,4863,2397,2466
Missouri,Scotland County,1,402,220,182
Missouri,Scotland County,2,371,186,185
Missouri,Scotland County,3,361,183,178
Missouri,Scotland County,4,354,179,175
Missouri,Scotland County,5,283,138,145
Missouri,Scotland County,6,250,128,122
Missouri,Scotland County,7,256,138,118
Missouri,Scotland County,8,247,118,129
Missouri,Scotland County,9,238,122,116
Missouri,Scotland County,10,280,131,149
Missouri,Scotland County,11,321,166,155
Missouri,Scotland County,12,291,124,167
Missouri,Scotland County,13,288,159,129
Missouri,Scotland County,14,254,119,135
Missouri,Scotland County,15,224,120,104
Missouri,Scotland County,16,158,62,96
Missouri,Scotland County,17,126,51,75
Missouri,Scotland County,18,159,53,106
Missouri,Scott County,0,38903,18900,20003
Missouri,Scott County,1,2689,1419,1270
Missouri,Scott County,2,2643,1352,1291
Missouri,Scott County,3,2490,1292,1198
Missouri,Scott County,4,2339,1250,1089
Missouri,Scott County,5,2483,1234,1249
Missouri,Scott County,6,2313,1120,1193
Missouri,Scott County,7,2430,1178,1252
Missouri,Scott County,8,2266,1087,1179
Missouri,Scott County,9,2404,1177,1227
Missouri,Scott County,10,2446,1210,1236
Missouri,Scott County,11,2799,1380,1419
Missouri,Scott County,12,2723,1287,1436
Missouri,Scott County,13,2449,1128,1321
Missouri,Scott County,14,2070,982,1088
Missouri,Scott County,15,1611,724,887
Missouri,Scott County,16,1183,521,662
Missouri,Scott County,17,774,288,486
Missouri,Scott County,18,791,271,520
Missouri,Shannon County,0,8329,4153,4176
Missouri,Shannon County,1,457,238,219
Missouri,Shannon County,2,550,288,262
Missouri,Shannon County,3,509,253,256
Missouri,Shannon County,4,514,264,250
Missouri,Shannon County,5,469,228,241
Missouri,Shannon County,6,459,239,220
Missouri,Shannon County,7,423,225,198
Missouri,Shannon County,8,399,209,190
Missouri,Shannon County,9,445,222,223
Missouri,Shannon County,10,510,259,251
Missouri,Shannon County,11,681,352,329
Missouri,Shannon County,12,690,337,353
Missouri,Shannon County,13,589,300,289
Missouri,Shannon County,14,576,273,303
Missouri,Shannon County,15,457,223,234
Missouri,Shannon County,16,306,144,162
Missouri,Shannon County,17,175,69,106
Missouri,Shannon County,18,120,30,90
Missouri,Shelby County,0,6108,3034,3074
Missouri,Shelby County,1,352,206,146
Missouri,Shelby County,2,426,225,201
Missouri,Shelby County,3,403,208,195
Missouri,Shelby County,4,365,185,180
Missouri,Shelby County,5,293,133,160
Missouri,Shelby County,6,294,139,155
Missouri,Shelby County,7,362,181,181
Missouri,Shelby County,8,350,192,158
Missouri,Shelby County,9,311,154,157
Missouri,Shelby County,10,320,150,170
Missouri,Shelby County,11,481,265,216
Missouri,Shelby County,12,462,232,230
Missouri,Shelby County,13,433,223,210
Missouri,Shelby County,14,344,169,175
Missouri,Shelby County,15,307,149,158
Missouri,Shelby County,16,220,92,128
Missouri,Shelby County,17,158,63,95
Missouri,Shelby County,18,227,68,159
Missouri,Stoddard County,0,29867,14557,15310
Missouri,Stoddard County,1,1687,821,866
Missouri,Stoddard County,2,1903,967,936
Missouri,Stoddard County,3,1902,947,955
Missouri,Stoddard County,4,1832,1006,826
Missouri,Stoddard County,5,1771,910,861
Missouri,Stoddard County,6,1734,837,897
Missouri,Stoddard County,7,1726,842,884
Missouri,Stoddard County,8,1722,876,846
Missouri,Stoddard County,9,1864,927,937
Missouri,Stoddard County,10,1848,945,903
Missouri,Stoddard County,11,2224,1133,1091
Missouri,Stoddard County,12,2094,989,1105
Missouri,Stoddard County,13,1890,882,1008
Missouri,Stoddard County,14,1689,801,888
Missouri,Stoddard County,15,1371,642,729
Missouri,Stoddard County,16,1073,470,603
Missouri,Stoddard County,17,762,306,456
Missouri,Stoddard County,18,775,256,519
Missouri,Stone County,0,31104,15211,15893
Missouri,Stone County,1,1291,678,613
Missouri,Stone County,2,1415,686,729
Missouri,Stone County,3,1659,820,839
Missouri,Stone County,4,1685,869,816
Missouri,Stone County,5,1345,700,645
Missouri,Stone County,6,1175,584,591
Missouri,Stone County,7,1324,650,674
Missouri,Stone County,8,1339,640,699
Missouri,Stone County,9,1599,752,847
Missouri,Stone County,10,1851,918,933
Missouri,Stone County,11,2387,1130,1257
Missouri,Stone County,12,2620,1257,1363
Missouri,Stone County,13,2886,1322,1564
Missouri,Stone County,14,2972,1460,1512
Missouri,Stone County,15,2377,1208,1169
Missouri,Stone County,16,1621,817,804
Missouri,Stone County,17,884,466,418
Missouri,Stone County,18,674,254,420
Missouri,Sullivan County,0,6411,3256,3155
Missouri,Sullivan County,1,384,206,178
Missouri,Sullivan County,2,394,217,177
Missouri,Sullivan County,3,426,215,211
Missouri,Sullivan County,4,427,211,216
Missouri,Sullivan County,5,359,201,158
Missouri,Sullivan County,6,315,151,164
Missouri,Sullivan County,7,343,172,171
Missouri,Sullivan County,8,376,201,175
Missouri,Sullivan County,9,398,214,184
Missouri,Sullivan County,10,425,194,231
Missouri,Sullivan County,11,494,271,223
Missouri,Sullivan County,12,460,264,196
Missouri,Sullivan County,13,429,205,224
Missouri,Sullivan County,14,370,192,178
Missouri,Sullivan County,15,291,131,160
Missouri,Sullivan County,16,219,104,115
Missouri,Sullivan County,17,160,70,90
Missouri,Sullivan County,18,141,37,104
Missouri,Taney County,0,54230,26293,27937
Missouri,Taney County,1,3126,1633,1493
Missouri,Taney County,2,3195,1642,1553
Missouri,Taney County,3,3170,1600,1570
Missouri,Taney County,4,3518,1791,1727
Missouri,Taney County,5,4026,1921,2105
Missouri,Taney County,6,3125,1575,1550
Missouri,Taney County,7,3170,1568,1602
Missouri,Taney County,8,2954,1418,1536
Missouri,Taney County,9,3019,1489,1530
Missouri,Taney County,10,3302,1579,1723
Missouri,Taney County,11,3688,1762,1926
Missouri,Taney County,12,3631,1711,1920
Missouri,Taney County,13,3613,1645,1968
Missouri,Taney County,14,3507,1649,1858
Missouri,Taney County,15,2862,1368,1494
Missouri,Taney County,16,2023,970,1053
Missouri,Taney County,17,1279,575,704
Missouri,Taney County,18,1022,397,625
Missouri,Texas County,0,25642,13367,12275
Missouri,Texas County,1,1437,741,696
Missouri,Texas County,2,1563,809,754
Missouri,Texas County,3,1490,743,747
Missouri,Texas County,4,1550,813,737
Missouri,Texas County,5,1565,933,632
Missouri,Texas County,6,1513,872,641
Missouri,Texas County,7,1512,844,668
Missouri,Texas County,8,1480,851,629
Missouri,Texas County,9,1409,749,660
Missouri,Texas County,10,1536,833,703
Missouri,Texas County,11,1999,1071,928
Missouri,Texas County,12,1850,938,912
Missouri,Texas County,13,1730,818,912
Missouri,Texas County,14,1499,751,748
Missouri,Texas County,15,1283,639,644
Missouri,Texas County,16,941,433,508
Missouri,Texas County,17,662,301,361
Missouri,Texas County,18,623,228,395
Missouri,Vernon County,0,21001,10245,10756
Missouri,Vernon County,1,1317,676,641
Missouri,Vernon County,2,1474,758,716
Missouri,Vernon County,3,1450,770,680
Missouri,Vernon County,4,1523,704,819
Missouri,Vernon County,5,1217,580,637
Missouri,Vernon County,6,1151,559,592
Missouri,Vernon County,7,1137,556,581
Missouri,Vernon County,8,1203,593,610
Missouri,Vernon County,9,1183,614,569
Missouri,Vernon County,10,1303,624,679
Missouri,Vernon County,11,1510,753,757
Missouri,Vernon County,12,1481,717,764
Missouri,Vernon County,13,1335,654,681
Missouri,Vernon County,14,1206,565,641
Missouri,Vernon County,15,893,416,477
Missouri,Vernon County,16,623,286,337
Missouri,Vernon County,17,507,217,290
Missouri,Vernon County,18,488,203,285
Missouri,Warren County,0,33253,16593,16660
Missouri,Warren County,1,2051,1045,1006
Missouri,Warren County,2,2396,1220,1176
Missouri,Warren County,3,2346,1198,1148
Missouri,Warren County,4,1996,1065,931
Missouri,Warren County,5,1795,902,893
Missouri,Warren County,6,1935,969,966
Missouri,Warren County,7,2035,998,1037
Missouri,Warren County,8,1886,930,956
Missouri,Warren County,9,1895,978,917
Missouri,Warren County,10,2168,1047,1121
Missouri,Warren County,11,2720,1370,1350
Missouri,Warren County,12,2499,1281,1218
Missouri,Warren County,13,2016,989,1027
Missouri,Warren County,14,1741,839,902
Missouri,Warren County,15,1521,741,780
Missouri,Warren County,16,1025,502,523
Missouri,Warren County,17,697,323,374
Missouri,Warren County,18,531,196,335
Missouri,Washington County,0,25077,12951,12126
Missouri,Washington County,1,1466,791,675
Missouri,Washington County,2,1644,818,826
Missouri,Washington County,3,1693,868,825
Missouri,Washington County,4,1482,765,717
Missouri,Washington County,5,1463,772,691
Missouri,Washington County,6,1521,827,694
Missouri,Washington County,7,1527,817,710
Missouri,Washington County,8,1536,817,719
Missouri,Washington County,9,1703,903,800
Missouri,Washington County,10,1742,958,784
Missouri,Washington County,11,1973,1037,936
Missouri,Washington County,12,1907,987,920
Missouri,Washington County,13,1562,751,811
Missouri,Washington County,14,1341,660,681
Missouri,Washington County,15,1033,497,536
Missouri,Washington County,16,695,349,346
Missouri,Washington County,17,460,196,264
Missouri,Washington County,18,329,138,191
Missouri,Wayne County,0,13452,6695,6757
Missouri,Wayne County,1,801,413,388
Missouri,Wayne County,2,761,388,373
Missouri,Wayne County,3,756,368,388
Missouri,Wayne County,4,746,410,336
Missouri,Wayne County,5,652,350,302
Missouri,Wayne County,6,687,332,355
Missouri,Wayne County,7,662,337,325
Missouri,Wayne County,8,660,340,320
Missouri,Wayne County,9,748,367,381
Missouri,Wayne County,10,931,446,485
Missouri,Wayne County,11,1070,537,533
Missouri,Wayne County,12,1045,516,529
Missouri,Wayne County,13,981,467,514
Missouri,Wayne County,14,929,461,468
Missouri,Wayne County,15,847,423,424
Missouri,Wayne County,16,548,261,287
Missouri,Wayne County,17,347,186,161
Missouri,Wayne County,18,281,93,188
Missouri,Webster County,0,36888,18769,18119
Missouri,Webster County,1,2497,1353,1144
Missouri,Webster County,2,2837,1441,1396
Missouri,Webster County,3,2969,1535,1434
Missouri,Webster County,4,2579,1377,1202
Missouri,Webster County,5,2050,1093,957
Missouri,Webster County,6,2010,1081,929
Missouri,Webster County,7,2296,1150,1146
Missouri,Webster County,8,2227,1154,1073
Missouri,Webster County,9,2325,1190,1135
Missouri,Webster County,10,2523,1306,1217
Missouri,Webster County,11,2639,1347,1292
Missouri,Webster County,12,2522,1245,1277
Missouri,Webster County,13,2023,988,1035
Missouri,Webster County,14,1809,895,914
Missouri,Webster County,15,1385,660,725
Missouri,Webster County,16,992,475,517
Missouri,Webster County,17,632,266,366
Missouri,Webster County,18,573,213,360
Missouri,Worth County,0,2073,1034,1039
Missouri,Worth County,1,123,60,63
Missouri,Worth County,2,94,49,45
Missouri,Worth County,3,127,62,65
Missouri,Worth County,4,114,65,49
Missouri,Worth County,5,116,50,66
Missouri,Worth County,6,94,49,45
Missouri,Worth County,7,103,55,48
Missouri,Worth County,8,102,62,40
Missouri,Worth County,9,86,46,40
Missouri,Worth County,10,125,67,58
Missouri,Worth County,11,161,84,77
Missouri,Worth County,12,178,85,93
Missouri,Worth County,13,146,86,60
Missouri,Worth County,14,126,59,67
Missouri,Worth County,15,112,52,60
Missouri,Worth County,16,101,44,57
Missouri,Worth County,17,79,33,46
Missouri,Worth County,18,86,26,60
Missouri,Wright County,0,18291,8947,9344
Missouri,Wright County,1,1146,592,554
Missouri,Wright County,2,1280,619,661
Missouri,Wright County,3,1360,690,670
Missouri,Wright County,4,1217,649,568
Missouri,Wright County,5,960,485,475
Missouri,Wright County,6,936,471,465
Missouri,Wright County,7,974,473,501
Missouri,Wright County,8,924,447,477
Missouri,Wright County,9,1021,514,507
Missouri,Wright County,10,1128,554,574
Missouri,Wright County,11,1330,643,687
Missouri,Wright County,12,1369,681,688
Missouri,Wright County,13,1158,566,592
Missouri,Wright County,14,1060,523,537
Missouri,Wright County,15,884,389,495
Missouri,Wright County,16,678,317,361
Missouri,Wright County,17,430,180,250
Missouri,Wright County,18,436,154,282
Montana,Beaverhead County,0,9345,4773,4572
Montana,Beaverhead County,1,424,196,228
Montana,Beaverhead County,2,442,212,230
Montana,Beaverhead County,3,451,242,209
Montana,Beaverhead County,4,778,417,361
Montana,Beaverhead County,5,941,481,460
Montana,Beaverhead County,6,457,248,209
Montana,Beaverhead County,7,485,257,228
Montana,Beaverhead County,8,446,244,202
Montana,Beaverhead County,9,462,230,232
Montana,Beaverhead County,10,463,237,226
Montana,Beaverhead County,11,649,323,326
Montana,Beaverhead County,12,782,398,384
Montana,Beaverhead County,13,712,351,361
Montana,Beaverhead County,14,605,320,285
Montana,Beaverhead County,15,473,255,218
Montana,Beaverhead County,16,326,169,157
Montana,Beaverhead County,17,238,110,128
Montana,Beaverhead County,18,211,83,128
Montana,Big Horn County,0,13282,6534,6748
Montana,Big Horn County,1,1365,693,672
Montana,Big Horn County,2,1341,691,650
Montana,Big Horn County,3,1158,608,550
Montana,Big Horn County,4,929,453,476
Montana,Big Horn County,5,896,437,459
Montana,Big Horn County,6,862,430,432
Montana,Big Horn County,7,755,361,394
Montana,Big Horn County,8,683,346,337
Montana,Big Horn County,9,647,303,344
Montana,Big Horn County,10,788,358,430
Montana,Big Horn County,11,821,395,426
Montana,Big Horn County,12,798,384,414
Montana,Big Horn County,13,731,374,357
Montana,Big Horn County,14,562,268,294
Montana,Big Horn County,15,355,175,180
Montana,Big Horn County,16,275,131,144
Montana,Big Horn County,17,174,64,110
Montana,Big Horn County,18,142,63,79
Montana,Blaine County,0,6619,3268,3351
Montana,Blaine County,1,573,275,298
Montana,Blaine County,2,596,322,274
Montana,Blaine County,3,512,278,234
Montana,Blaine County,4,507,261,246
Montana,Blaine County,5,410,212,198
Montana,Blaine County,6,385,184,201
Montana,Blaine County,7,414,207,207
Montana,Blaine County,8,349,173,176
Montana,Blaine County,9,315,149,166
Montana,Blaine County,10,350,175,175
Montana,Blaine County,11,453,222,231
Montana,Blaine County,12,419,215,204
Montana,Blaine County,13,395,193,202
Montana,Blaine County,14,307,136,171
Montana,Blaine County,15,209,97,112
Montana,Blaine County,16,151,63,88
Montana,Blaine County,17,131,54,77
Montana,Blaine County,18,143,52,91
Montana,Broadwater County,0,5667,2875,2792
Montana,Broadwater County,1,281,121,160
Montana,Broadwater County,2,312,161,151
Montana,Broadwater County,3,364,193,171
Montana,Broadwater County,4,338,178,160
Montana,Broadwater County,5,238,118,120
Montana,Broadwater County,6,229,122,107
Montana,Broadwater County,7,262,125,137
Montana,Broadwater County,8,294,157,137
Montana,Broadwater County,9,335,170,165
Montana,Broadwater County,10,389,192,197
Montana,Broadwater County,11,453,209,244
Montana,Broadwater County,12,505,266,239
Montana,Broadwater County,13,480,259,221
Montana,Broadwater County,14,459,238,221
Montana,Broadwater County,15,293,157,136
Montana,Broadwater County,16,192,92,100
Montana,Broadwater County,17,134,71,63
Montana,Broadwater County,18,109,46,63
Montana,Carbon County,0,10399,5225,5174
Montana,Carbon County,1,435,225,210
Montana,Carbon County,2,495,242,253
Montana,Carbon County,3,587,308,279
Montana,Carbon County,4,596,321,275
Montana,Carbon County,5,442,224,218
Montana,Carbon County,6,423,210,213
Montana,Carbon County,7,488,237,251
Montana,Carbon County,8,563,273,290
Montana,Carbon County,9,560,281,279
Montana,Carbon County,10,644,321,323
Montana,Carbon County,11,857,422,435
Montana,Carbon County,12,1026,499,527
Montana,Carbon County,13,962,480,482
Montana,Carbon County,14,871,462,409
Montana,Carbon County,15,558,290,268
Montana,Carbon County,16,394,200,194
Montana,Carbon County,17,228,114,114
Montana,Carbon County,18,270,116,154
Montana,Carter County,0,1169,584,585
Montana,Carter County,1,63,36,27
Montana,Carter County,2,52,26,26
Montana,Carter County,3,53,32,21
Montana,Carter County,4,50,24,26
Montana,Carter County,5,55,25,30
Montana,Carter County,6,63,32,31
Montana,Carter County,7,64,39,25
Montana,Carter County,8,38,25,13
Montana,Carter County,9,39,18,21
Montana,Carter County,10,71,27,44
Montana,Carter County,11,93,46,47
Montana,Carter County,12,117,62,55
Montana,Carter County,13,116,61,55
Montana,Carter County,14,77,39,38
Montana,Carter County,15,66,33,33
Montana,Carter County,16,55,27,28
Montana,Carter County,17,48,18,30
Montana,Carter County,18,49,14,35
Montana,Cascade County,0,82344,41491,40853
Montana,Cascade County,1,5556,2847,2709
Montana,Cascade County,2,5307,2766,2541
Montana,Cascade County,3,4818,2497,2321
Montana,Cascade County,4,4738,2445,2293
Montana,Cascade County,5,6782,3837,2945
Montana,Cascade County,6,5970,3097,2873
Montana,Cascade County,7,5434,2801,2633
Montana,Cascade County,8,4418,2294,2124
Montana,Cascade County,9,4244,2165,2079
Montana,Cascade County,10,4516,2200,2316
Montana,Cascade County,11,5734,2870,2864
Montana,Cascade County,12,5777,2764,3013
Montana,Cascade County,13,5152,2506,2646
Montana,Cascade County,14,4226,2105,2121
Montana,Cascade County,15,3262,1530,1732
Montana,Cascade County,16,2631,1215,1416
Montana,Cascade County,17,1886,838,1048
Montana,Cascade County,18,1893,714,1179
Montana,Chouteau County,0,5894,2914,2980
Montana,Chouteau County,1,225,88,137
Montana,Chouteau County,2,470,225,245
Montana,Chouteau County,3,476,240,236
Montana,Chouteau County,4,436,218,218
Montana,Chouteau County,5,357,187,170
Montana,Chouteau County,6,342,183,159
Montana,Chouteau County,7,304,150,154
Montana,Chouteau County,8,305,162,143
Montana,Chouteau County,9,295,146,149
Montana,Chouteau County,10,306,156,150
Montana,Chouteau County,11,417,193,224
Montana,Chouteau County,12,456,235,221
Montana,Chouteau County,13,438,222,216
Montana,Chouteau County,14,340,167,173
Montana,Chouteau County,15,246,124,122
Montana,Chouteau County,16,189,93,96
Montana,Chouteau County,17,144,63,81
Montana,Chouteau County,18,148,62,86
Montana,Custer County,0,12092,6049,6043
Montana,Custer County,1,762,372,390
Montana,Custer County,2,726,394,332
Montana,Custer County,3,687,330,357
Montana,Custer County,4,796,460,336
Montana,Custer County,5,725,370,355
Montana,Custer County,6,769,386,383
Montana,Custer County,7,771,394,377
Montana,Custer County,8,609,325,284
Montana,Custer County,9,662,297,365
Montana,Custer County,10,688,342,346
Montana,Custer County,11,903,460,443
Montana,Custer County,12,899,464,435
Montana,Custer County,13,836,422,414
Montana,Custer County,14,696,342,354
Montana,Custer County,15,465,233,232
Montana,Custer County,16,389,167,222
Montana,Custer County,17,325,149,176
Montana,Custer County,18,384,142,242
Montana,Daniels County,0,1793,901,892
Montana,Daniels County,1,100,47,53
Montana,Daniels County,2,113,58,55
Montana,Daniels County,3,95,54,41
Montana,Daniels County,4,97,52,45
Montana,Daniels County,5,71,38,33
Montana,Daniels County,6,88,43,45
Montana,Daniels County,7,96,52,44
Montana,Daniels County,8,87,44,43
Montana,Daniels County,9,83,41,42
Montana,Daniels County,10,84,47,37
Montana,Daniels County,11,128,69,59
Montana,Daniels County,12,152,74,78
Montana,Daniels County,13,147,79,68
Montana,Daniels County,14,120,64,56
Montana,Daniels County,15,91,45,46
Montana,Daniels County,16,75,36,39
Montana,Daniels County,17,67,28,39
Montana,Daniels County,18,99,30,69
Montana,Dawson County,0,9518,4897,4621
Montana,Dawson County,1,616,316,300
Montana,Dawson County,2,596,311,285
Montana,Dawson County,3,599,316,283
Montana,Dawson County,4,557,291,266
Montana,Dawson County,5,646,346,300
Montana,Dawson County,6,642,370,272
Montana,Dawson County,7,604,328,276
Montana,Dawson County,8,512,270,242
Montana,Dawson County,9,536,305,231
Montana,Dawson County,10,522,272,250
Montana,Dawson County,11,681,330,351
Montana,Dawson County,12,734,368,366
Montana,Dawson County,13,675,346,329
Montana,Dawson County,14,477,250,227
Montana,Dawson County,15,337,168,169
Montana,Dawson County,16,269,112,157
Montana,Dawson County,17,248,100,148
Montana,Dawson County,18,267,98,169
Montana,Deer Lodge County,0,9150,4888,4262
Montana,Deer Lodge County,1,362,194,168
Montana,Deer Lodge County,2,373,188,185
Montana,Deer Lodge County,3,423,218,205
Montana,Deer Lodge County,4,584,361,223
Montana,Deer Lodge County,5,570,353,217
Montana,Deer Lodge County,6,490,291,199
Montana,Deer Lodge County,7,476,257,219
Montana,Deer Lodge County,8,488,274,214
Montana,Deer Lodge County,9,572,318,254
Montana,Deer Lodge County,10,603,337,266
Montana,Deer Lodge County,11,710,360,350
Montana,Deer Lodge County,12,781,396,385
Montana,Deer Lodge County,13,824,427,397
Montana,Deer Lodge County,14,616,312,304
Montana,Deer Lodge County,15,467,244,223
Montana,Deer Lodge County,16,355,176,179
Montana,Deer Lodge County,17,222,93,129
Montana,Deer Lodge County,18,234,89,145
Montana,Fallon County,0,3108,1595,1513
Montana,Fallon County,1,241,133,108
Montana,Fallon County,2,237,111,126
Montana,Fallon County,3,214,97,117
Montana,Fallon County,4,166,97,69
Montana,Fallon County,5,172,91,81
Montana,Fallon County,6,206,119,87
Montana,Fallon County,7,184,98,86
Montana,Fallon County,8,188,98,90
Montana,Fallon County,9,169,91,78
Montana,Fallon County,10,158,81,77
Montana,Fallon County,11,205,101,104
Montana,Fallon County,12,283,150,133
Montana,Fallon County,13,197,98,99
Montana,Fallon County,14,141,76,65
Montana,Fallon County,15,93,49,44
Montana,Fallon County,16,92,45,47
Montana,Fallon County,17,87,37,50
Montana,Fallon County,18,75,23,52
Montana,Fergus County,0,11442,5755,5687
Montana,Fergus County,1,588,290,298
Montana,Fergus County,2,671,333,338
Montana,Fergus County,3,674,369,305
Montana,Fergus County,4,609,307,302
Montana,Fergus County,5,528,274,254
Montana,Fergus County,6,539,275,264
Montana,Fergus County,7,648,344,304
Montana,Fergus County,8,589,289,300
Montana,Fergus County,9,648,332,316
Montana,Fergus County,10,623,313,310
Montana,Fergus County,11,816,406,410
Montana,Fergus County,12,943,467,476
Montana,Fergus County,13,940,475,465
Montana,Fergus County,14,811,437,374
Montana,Fergus County,15,605,306,299
Montana,Fergus County,16,468,227,241
Montana,Fergus County,17,339,140,199
Montana,Fergus County,18,403,171,232
Montana,Flathead County,0,94924,47242,47682
Montana,Flathead County,1,5534,2870,2664
Montana,Flathead County,2,5907,3103,2804
Montana,Flathead County,3,6054,3165,2889
Montana,Flathead County,4,5691,2978,2713
Montana,Flathead County,5,5061,2504,2557
Montana,Flathead County,6,5232,2547,2685
Montana,Flathead County,7,5904,2887,3017
Montana,Flathead County,8,5579,2825,2754
Montana,Flathead County,9,5570,2802,2768
Montana,Flathead County,10,5723,2845,2878
Montana,Flathead County,11,7031,3406,3625
Montana,Flathead County,12,7929,3791,4138
Montana,Flathead County,13,7418,3679,3739
Montana,Flathead County,14,5874,2976,2898
Montana,Flathead County,15,4025,1980,2045
Montana,Flathead County,16,2769,1383,1386
Montana,Flathead County,17,1797,813,984
Montana,Flathead County,18,1826,688,1138
Montana,Gallatin County,0,97308,49996,47312
Montana,Gallatin County,1,5680,2781,2899
Montana,Gallatin County,2,5805,2925,2880
Montana,Gallatin County,3,5393,2674,2719
Montana,Gallatin County,4,6872,3560,3312
Montana,Gallatin County,5,11842,6484,5358
Montana,Gallatin County,6,7996,4290,3706
Montana,Gallatin County,7,7783,4089,3694
Montana,Gallatin County,8,6676,3583,3093
Montana,Gallatin County,9,5903,3094,2809
Montana,Gallatin County,10,5204,2701,2503
Montana,Gallatin County,11,5806,2890,2916
Montana,Gallatin County,12,5947,2975,2972
Montana,Gallatin County,13,5523,2712,2811
Montana,Gallatin County,14,3975,2073,1902
Montana,Gallatin County,15,2621,1314,1307
Montana,Gallatin County,16,1703,834,869
Montana,Gallatin County,17,1141,498,643
Montana,Gallatin County,18,1438,519,919
Montana,Garfield County,0,1309,653,656
Montana,Garfield County,1,75,28,47
Montana,Garfield County,2,91,51,40
Montana,Garfield County,3,74,31,43
Montana,Garfield County,4,90,48,42
Montana,Garfield County,5,45,21,24
Montana,Garfield County,6,49,20,29
Montana,Garfield County,7,93,50,43
Montana,Garfield County,8,68,39,29
Montana,Garfield County,9,67,31,36
Montana,Garfield County,10,62,30,32
Montana,Garfield County,11,81,30,51
Montana,Garfield County,12,92,48,44
Montana,Garfield County,13,126,73,53
Montana,Garfield County,14,88,54,34
Montana,Garfield County,15,83,41,42
Montana,Garfield County,16,60,33,27
Montana,Garfield County,17,33,11,22
Montana,Garfield County,18,32,14,18
Montana,Glacier County,0,13696,6696,7000
Montana,Glacier County,1,1269,644,625
Montana,Glacier County,2,1212,609,603
Montana,Glacier County,3,1155,576,579
Montana,Glacier County,4,1034,551,483
Montana,Glacier County,5,957,444,513
Montana,Glacier County,6,943,476,467
Montana,Glacier County,7,863,411,452
Montana,Glacier County,8,762,408,354
Montana,Glacier County,9,690,316,374
Montana,Glacier County,10,789,380,409
Montana,Glacier County,11,972,458,514
Montana,Glacier County,12,885,417,468
Montana,Glacier County,13,677,328,349
Montana,Glacier County,14,493,238,255
Montana,Glacier County,15,368,164,204
Montana,Glacier County,16,253,118,135
Montana,Glacier County,17,180,78,102
Montana,Glacier County,18,194,80,114
Montana,Golden Valley County,0,852,437,415
Montana,Golden Valley County,1,40,21,19
Montana,Golden Valley County,2,48,23,25
Montana,Golden Valley County,3,50,27,23
Montana,Golden Valley County,4,53,27,26
Montana,Golden Valley County,5,33,18,15
Montana,Golden Valley County,6,36,17,19
Montana,Golden Valley County,7,28,12,16
Montana,Golden Valley County,8,38,20,18
Montana,Golden Valley County,9,34,13,21
Montana,Golden Valley County,10,54,27,27
Montana,Golden Valley County,11,71,34,37
Montana,Golden Valley County,12,72,41,31
Montana,Golden Valley County,13,86,42,44
Montana,Golden Valley County,14,60,32,28
Montana,Golden Valley County,15,53,30,23
Montana,Golden Valley County,16,38,19,19
Montana,Golden Valley County,17,34,17,17
Montana,Golden Valley County,18,24,17,7
Montana,Granite County,0,3209,1620,1589
Montana,Granite County,1,115,52,63
Montana,Granite County,2,131,75,56
Montana,Granite County,3,163,66,97
Montana,Granite County,4,159,75,84
Montana,Granite County,5,106,54,52
Montana,Granite County,6,101,48,53
Montana,Granite County,7,149,79,70
Montana,Granite County,8,144,70,74
Montana,Granite County,9,157,84,73
Montana,Granite County,10,146,67,79
Montana,Granite County,11,266,138,128
Montana,Granite County,12,320,156,164
Montana,Granite County,13,326,172,154
Montana,Granite County,14,284,155,129
Montana,Granite County,15,262,139,123
Montana,Granite County,16,178,94,84
Montana,Granite County,17,95,51,44
Montana,Granite County,18,107,45,62
Montana,Hill County,0,16596,8361,8235
Montana,Hill County,1,1411,704,707
Montana,Hill County,2,1213,615,598
Montana,Hill County,3,1210,603,607
Montana,Hill County,4,1131,600,531
Montana,Hill County,5,1218,642,576
Montana,Hill County,6,1172,626,546
Montana,Hill County,7,1075,560,515
Montana,Hill County,8,892,433,459
Montana,Hill County,9,876,444,432
Montana,Hill County,10,845,429,416
Montana,Hill County,11,1051,549,502
Montana,Hill County,12,1187,585,602
Montana,Hill County,13,983,522,461
Montana,Hill County,14,775,391,384
Montana,Hill County,15,528,242,286
Montana,Hill County,16,402,188,214
Montana,Hill County,17,325,130,195
Montana,Hill County,18,302,98,204
Montana,Jefferson County,0,11558,5891,5667
Montana,Jefferson County,1,490,266,224
Montana,Jefferson County,2,647,346,301
Montana,Jefferson County,3,760,383,377
Montana,Jefferson County,4,798,426,372
Montana,Jefferson County,5,477,258,219
Montana,Jefferson County,6,445,236,209
Montana,Jefferson County,7,521,267,254
Montana,Jefferson County,8,496,241,255
Montana,Jefferson County,9,733,357,376
Montana,Jefferson County,10,778,368,410
Montana,Jefferson County,11,1004,495,509
Montana,Jefferson County,12,1118,549,569
Montana,Jefferson County,13,1126,578,548
Montana,Jefferson County,14,918,499,419
Montana,Jefferson County,15,571,303,268
Montana,Jefferson County,16,342,170,172
Montana,Jefferson County,17,169,77,92
Montana,Jefferson County,18,165,72,93
Montana,Judith Basin County,0,1991,1037,954
Montana,Judith Basin County,1,74,37,37
Montana,Judith Basin County,2,120,67,53
Montana,Judith Basin County,3,117,58,59
Montana,Judith Basin County,4,99,60,39
Montana,Judith Basin County,5,102,61,41
Montana,Judith Basin County,6,62,30,32
Montana,Judith Basin County,7,110,52,58
Montana,Judith Basin County,8,89,49,40
Montana,Judith Basin County,9,93,46,47
Montana,Judith Basin County,10,113,61,52
Montana,Judith Basin County,11,201,87,114
Montana,Judith Basin County,12,174,99,75
Montana,Judith Basin County,13,190,100,90
Montana,Judith Basin County,14,137,78,59
Montana,Judith Basin County,15,124,66,58
Montana,Judith Basin County,16,78,37,41
Montana,Judith Basin County,17,61,34,27
Montana,Judith Basin County,18,47,15,32
Montana,Lake County,0,29099,14306,14793
Montana,Lake County,1,1864,947,917
Montana,Lake County,2,2008,1021,987
Montana,Lake County,3,1952,1009,943
Montana,Lake County,4,1958,1022,936
Montana,Lake County,5,1590,821,769
Montana,Lake County,6,1493,724,769
Montana,Lake County,7,1460,718,742
Montana,Lake County,8,1502,720,782
Montana,Lake County,9,1438,679,759
Montana,Lake County,10,1591,739,852
Montana,Lake County,11,1999,973,1026
Montana,Lake County,12,2274,1037,1237
Montana,Lake County,13,2247,1100,1147
Montana,Lake County,14,1907,952,955
Montana,Lake County,15,1543,823,720
Montana,Lake County,16,970,452,518
Montana,Lake County,17,685,340,345
Montana,Lake County,18,618,229,389
Montana,Lewis and Clark County,0,65856,32387,33469
Montana,Lewis and Clark County,1,3874,1945,1929
Montana,Lewis and Clark County,2,3984,2026,1958
Montana,Lewis and Clark County,3,4030,2070,1960
Montana,Lewis and Clark County,4,4122,2126,1996
Montana,Lewis and Clark County,5,3844,1930,1914
Montana,Lewis and Clark County,6,3919,1920,1999
Montana,Lewis and Clark County,7,4380,2226,2154
Montana,Lewis and Clark County,8,3772,1900,1872
Montana,Lewis and Clark County,9,3766,1833,1933
Montana,Lewis and Clark County,10,4074,1985,2089
Montana,Lewis and Clark County,11,5033,2423,2610
Montana,Lewis and Clark County,12,5246,2494,2752
Montana,Lewis and Clark County,13,5114,2525,2589
Montana,Lewis and Clark County,14,3814,1955,1859
Montana,Lewis and Clark County,15,2597,1281,1316
Montana,Lewis and Clark County,16,1659,763,896
Montana,Lewis and Clark County,17,1187,502,685
Montana,Lewis and Clark County,18,1441,483,958
Montana,Liberty County,0,2359,1124,1235
Montana,Liberty County,1,135,57,78
Montana,Liberty County,2,129,63,66
Montana,Liberty County,3,143,71,72
Montana,Liberty County,4,148,80,68
Montana,Liberty County,5,134,55,79
Montana,Liberty County,6,141,64,77
Montana,Liberty County,7,144,76,68
Montana,Liberty County,8,111,49,62
Montana,Liberty County,9,111,57,54
Montana,Liberty County,10,151,68,83
Montana,Liberty County,11,193,93,100
Montana,Liberty County,12,201,93,108
Montana,Liberty County,13,152,85,67
Montana,Liberty County,14,103,57,46
Montana,Liberty County,15,106,53,53
Montana,Liberty County,16,87,38,49
Montana,Liberty County,17,76,30,46
Montana,Liberty County,18,94,35,59
Montana,Lincoln County,0,19125,9658,9467
Montana,Lincoln County,1,907,446,461
Montana,Lincoln County,2,971,531,440
Montana,Lincoln County,3,988,477,511
Montana,Lincoln County,4,958,508,450
Montana,Lincoln County,5,707,384,323
Montana,Lincoln County,6,744,375,369
Montana,Lincoln County,7,842,403,439
Montana,Lincoln County,8,906,464,442
Montana,Lincoln County,9,947,437,510
Montana,Lincoln County,10,1097,554,543
Montana,Lincoln County,11,1528,750,778
Montana,Lincoln County,12,1849,912,937
Montana,Lincoln County,13,1937,983,954
Montana,Lincoln County,14,1639,844,795
Montana,Lincoln County,15,1384,728,656
Montana,Lincoln County,16,822,447,375
Montana,Lincoln County,17,501,250,251
Montana,Lincoln County,18,398,165,233
Montana,McCone County,0,1694,864,830
Montana,McCone County,1,58,34,24
Montana,McCone County,2,120,50,70
Montana,McCone County,3,94,60,34
Montana,McCone County,4,104,53,51
Montana,McCone County,5,92,42,50
Montana,McCone County,6,78,41,37
Montana,McCone County,7,78,42,36
Montana,McCone County,8,87,42,45
Montana,McCone County,9,74,35,39
Montana,McCone County,10,91,44,47
Montana,McCone County,11,133,75,58
Montana,McCone County,12,157,82,75
Montana,McCone County,13,147,73,74
Montana,McCone County,14,108,58,50
Montana,McCone County,15,87,44,43
Montana,McCone County,16,75,36,39
Montana,McCone County,17,50,23,27
Montana,McCone County,18,61,30,31
Montana,Madison County,0,7820,4102,3718
Montana,Madison County,1,298,180,118
Montana,Madison County,2,322,177,145
Montana,Madison County,3,375,178,197
Montana,Madison County,4,366,187,179
Montana,Madison County,5,356,199,157
Montana,Madison County,6,316,176,140
Montana,Madison County,7,388,196,192
Montana,Madison County,8,369,197,172
Montana,Madison County,9,393,217,176
Montana,Madison County,10,418,204,214
Montana,Madison County,11,591,306,285
Montana,Madison County,12,702,336,366
Montana,Madison County,13,867,435,432
Montana,Madison County,14,758,432,326
Montana,Madison County,15,537,306,231
Montana,Madison County,16,338,181,157
Montana,Madison County,17,220,104,116
Montana,Madison County,18,206,91,115
Montana,Meagher County,0,1853,944,909
Montana,Meagher County,1,108,62,46
Montana,Meagher County,2,94,48,46
Montana,Meagher County,3,86,55,31
Montana,Meagher County,4,98,50,48
Montana,Meagher County,5,90,41,49
Montana,Meagher County,6,66,33,33
Montana,Meagher County,7,96,51,45
Montana,Meagher County,8,71,37,34
Montana,Meagher County,9,91,43,48
Montana,Meagher County,10,89,44,45
Montana,Meagher County,11,135,68,67
Montana,Meagher County,12,175,80,95
Montana,Meagher County,13,169,87,82
Montana,Meagher County,14,157,84,73
Montana,Meagher County,15,120,65,55
Montana,Meagher County,16,74,39,35
Montana,Meagher County,17,70,41,29
Montana,Meagher County,18,64,16,48
Montana,Mineral County,0,4257,2244,2013
Montana,Mineral County,1,200,118,82
Montana,Mineral County,2,224,114,110
Montana,Mineral County,3,219,120,99
Montana,Mineral County,4,196,111,85
Montana,Mineral County,5,166,94,72
Montana,Mineral County,6,189,110,79
Montana,Mineral County,7,205,107,98
Montana,Mineral County,8,167,76,91
Montana,Mineral County,9,194,104,90
Montana,Mineral County,10,240,119,121
Montana,Mineral County,11,326,155,171
Montana,Mineral County,12,365,196,169
Montana,Mineral County,13,435,231,204
Montana,Mineral County,14,349,173,176
Montana,Mineral County,15,338,180,158
Montana,Mineral County,16,229,130,99
Montana,Mineral County,17,108,60,48
Montana,Mineral County,18,107,46,61
Montana,Missoula County,0,112684,56681,56003
Montana,Missoula County,1,6094,3080,3014
Montana,Missoula County,2,6371,3343,3028
Montana,Missoula County,3,5851,3012,2839
Montana,Missoula County,4,7498,3794,3704
Montana,Missoula County,5,13588,6942,6646
Montana,Missoula County,6,8617,4411,4206
Montana,Missoula County,7,8484,4437,4047
Montana,Missoula County,8,7088,3679,3409
Montana,Missoula County,9,6211,3253,2958
Montana,Missoula County,10,6037,2999,3038
Montana,Missoula County,11,7025,3433,3592
Montana,Missoula County,12,7329,3507,3822
Montana,Missoula County,13,7128,3533,3595
Montana,Missoula County,14,5645,2877,2768
Montana,Missoula County,15,3735,1824,1911
Montana,Missoula County,16,2330,1125,1205
Montana,Missoula County,17,1759,761,998
Montana,Missoula County,18,1894,671,1223
Montana,Musselshell County,0,4589,2302,2287
Montana,Musselshell County,1,222,113,109
Montana,Musselshell County,2,244,129,115
Montana,Musselshell County,3,274,141,133
Montana,Musselshell County,4,254,123,131
Montana,Musselshell County,5,190,90,100
Montana,Musselshell County,6,159,83,76
Montana,Musselshell County,7,216,117,99
Montana,Musselshell County,8,207,89,118
Montana,Musselshell County,9,257,146,111
Montana,Musselshell County,10,282,147,135
Montana,Musselshell County,11,385,186,199
Montana,Musselshell County,12,427,206,221
Montana,Musselshell County,13,493,242,251
Montana,Musselshell County,14,370,188,182
Montana,Musselshell County,15,253,138,115
Montana,Musselshell County,16,152,77,75
Montana,Musselshell County,17,99,46,53
Montana,Musselshell County,18,105,41,64
Montana,Park County,0,15880,7972,7908
Montana,Park County,1,742,395,347
Montana,Park County,2,837,469,368
Montana,Park County,3,890,456,434
Montana,Park County,4,829,401,428
Montana,Park County,5,671,330,341
Montana,Park County,6,720,372,348
Montana,Park County,7,923,456,467
Montana,Park County,8,994,492,502
Montana,Park County,9,1037,529,508
Montana,Park County,10,1028,541,487
Montana,Park County,11,1321,639,682
Montana,Park County,12,1430,729,701
Montana,Park County,13,1366,703,663
Montana,Park County,14,1151,573,578
Montana,Park County,15,735,369,366
Montana,Park County,16,501,209,292
Montana,Park County,17,335,154,181
Montana,Park County,18,370,155,215
Montana,Petroleum County,0,485,265,220
Montana,Petroleum County,1,11,9,2
Montana,Petroleum County,2,29,17,12
Montana,Petroleum County,3,37,19,18
Montana,Petroleum County,4,45,25,20
Montana,Petroleum County,5,18,10,8
Montana,Petroleum County,6,18,11,7
Montana,Petroleum County,7,15,8,7
Montana,Petroleum County,8,22,12,10
Montana,Petroleum County,9,16,5,11
Montana,Petroleum County,10,39,22,17
Montana,Petroleum County,11,46,28,18
Montana,Petroleum County,12,49,25,24
Montana,Petroleum County,13,38,20,18
Montana,Petroleum County,14,27,15,12
Montana,Petroleum County,15,29,13,16
Montana,Petroleum County,16,22,12,10
Montana,Petroleum County,17,13,6,7
Montana,Petroleum County,18,11,8,3
Montana,Phillips County,0,4192,2082,2110
Montana,Phillips County,1,256,126,130
Montana,Phillips County,2,263,125,138
Montana,Phillips County,3,257,131,126
Montana,Phillips County,4,257,143,114
Montana,Phillips County,5,244,135,109
Montana,Phillips County,6,158,75,83
Montana,Phillips County,7,228,114,114
Montana,Phillips County,8,208,107,101
Montana,Phillips County,9,159,86,73
Montana,Phillips County,10,234,119,115
Montana,Phillips County,11,394,184,210
Montana,Phillips County,12,355,175,180
Montana,Phillips County,13,321,167,154
Montana,Phillips County,14,257,126,131
Montana,Phillips County,15,182,79,103
Montana,Phillips County,16,171,92,79
Montana,Phillips County,17,111,48,63
Montana,Phillips County,18,137,50,87
Montana,Pondera County,0,6219,3026,3193
Montana,Pondera County,1,411,214,197
Montana,Pondera County,2,430,216,214
Montana,Pondera County,3,429,209,220
Montana,Pondera County,4,395,188,207
Montana,Pondera County,5,322,157,165
Montana,Pondera County,6,349,182,167
Montana,Pondera County,7,359,165,194
Montana,Pondera County,8,304,153,151
Montana,Pondera County,9,318,163,155
Montana,Pondera County,10,338,159,179
Montana,Pondera County,11,466,229,237
Montana,Pondera County,12,477,229,248
Montana,Pondera County,13,401,205,196
Montana,Pondera County,14,368,180,188
Montana,Pondera County,15,277,148,129
Montana,Pondera County,16,168,70,98
Montana,Pondera County,17,156,64,92
Montana,Pondera County,18,251,95,156
Montana,Powder River County,0,1783,902,881
Montana,Powder River County,1,49,22,27
Montana,Powder River County,2,96,52,44
Montana,Powder River County,3,88,48,40
Montana,Powder River County,4,125,62,63
Montana,Powder River County,5,105,62,43
Montana,Powder River County,6,69,46,23
Montana,Powder River County,7,71,33,38
Montana,Powder River County,8,76,33,43
Montana,Powder River County,9,81,38,43
Montana,Powder River County,10,108,57,51
Montana,Powder River County,11,172,85,87
Montana,Powder River County,12,160,75,85
Montana,Powder River County,13,163,91,72
Montana,Powder River County,14,130,71,59
Montana,Powder River County,15,89,38,51
Montana,Powder River County,16,80,42,38
Montana,Powder River County,17,57,18,39
Montana,Powder River County,18,64,29,35
Montana,Powell County,0,6909,4275,2634
Montana,Powell County,1,288,160,128
Montana,Powell County,2,293,158,135
Montana,Powell County,3,278,132,146
Montana,Powell County,4,359,213,146
Montana,Powell County,5,426,316,110
Montana,Powell County,6,434,333,101
Montana,Powell County,7,455,313,142
Montana,Powell County,8,418,307,111
Montana,Powell County,9,447,304,143
Montana,Powell County,10,535,381,154
Montana,Powell County,11,601,381,220
Montana,Powell County,12,535,306,229
Montana,Powell County,13,559,316,243
Montana,Powell County,14,425,240,185
Montana,Powell County,15,334,192,142
Montana,Powell County,16,243,110,133
Montana,Powell County,17,131,59,72
Montana,Powell County,18,148,54,94
Montana,Prairie County,0,1148,583,565
Montana,Prairie County,1,75,40,35
Montana,Prairie County,2,44,21,23
Montana,Prairie County,3,53,28,25
Montana,Prairie County,4,58,28,30
Montana,Prairie County,5,43,18,25
Montana,Prairie County,6,44,22,22
Montana,Prairie County,7,38,20,18
Montana,Prairie County,8,54,33,21
Montana,Prairie County,9,55,27,28
Montana,Prairie County,10,53,26,27
Montana,Prairie County,11,74,30,44
Montana,Prairie County,12,97,53,44
Montana,Prairie County,13,116,57,59
Montana,Prairie County,14,126,68,58
Montana,Prairie County,15,80,46,34
Montana,Prairie County,16,46,24,22
Montana,Prairie County,17,41,15,26
Montana,Prairie County,18,51,27,24
Montana,Ravalli County,0,41030,20381,20649
Montana,Ravalli County,1,1961,1024,937
Montana,Ravalli County,2,2256,1185,1071
Montana,Ravalli County,3,2512,1279,1233
Montana,Ravalli County,4,2441,1305,1136
Montana,Ravalli County,5,1808,996,812
Montana,Ravalli County,6,1604,770,834
Montana,Ravalli County,7,2064,1037,1027
Montana,Ravalli County,8,2093,1033,1060
Montana,Ravalli County,9,2191,1051,1140
Montana,Ravalli County,10,2516,1264,1252
Montana,Ravalli County,11,3054,1483,1571
Montana,Ravalli County,12,3455,1604,1851
Montana,Ravalli County,13,3587,1699,1888
Montana,Ravalli County,14,3377,1673,1704
Montana,Ravalli County,15,2394,1224,1170
Montana,Ravalli County,16,1693,868,825
Montana,Ravalli County,17,1020,498,522
Montana,Ravalli County,18,1004,388,616
Montana,Richland County,0,11576,6053,5523
Montana,Richland County,1,838,381,457
Montana,Richland County,2,828,405,423
Montana,Richland County,3,756,395,361
Montana,Richland County,4,684,388,296
Montana,Richland County,5,815,458,357
Montana,Richland County,6,789,422,367
Montana,Richland County,7,764,426,338
Montana,Richland County,8,730,390,340
Montana,Richland County,9,725,379,346
Montana,Richland County,10,675,344,331
Montana,Richland County,11,841,459,382
Montana,Richland County,12,920,478,442
Montana,Richland County,13,706,392,314
Montana,Richland County,14,513,270,243
Montana,Richland County,15,370,180,190
Montana,Richland County,16,249,125,124
Montana,Richland County,17,195,66,129
Montana,Richland County,18,178,95,83
Montana,Roosevelt County,0,11332,5698,5634
Montana,Roosevelt County,1,1098,602,496
Montana,Roosevelt County,2,1096,554,542
Montana,Roosevelt County,3,919,442,477
Montana,Roosevelt County,4,787,424,363
Montana,Roosevelt County,5,852,443,409
Montana,Roosevelt County,6,820,430,390
Montana,Roosevelt County,7,697,337,360
Montana,Roosevelt County,8,633,338,295
Montana,Roosevelt County,9,581,286,295
Montana,Roosevelt County,10,564,292,272
Montana,Roosevelt County,11,742,381,361
Montana,Roosevelt County,12,752,346,406
Montana,Roosevelt County,13,603,311,292
Montana,Roosevelt County,14,386,181,205
Montana,Roosevelt County,15,296,140,156
Montana,Roosevelt County,16,186,80,106
Montana,Roosevelt County,17,156,67,89
Montana,Roosevelt County,18,164,44,120
Montana,Rosebud County,0,9326,4698,4628
Montana,Rosebud County,1,807,397,410
Montana,Rosebud County,2,746,397,349
Montana,Rosebud County,3,732,359,373
Montana,Rosebud County,4,685,375,310
Montana,Rosebud County,5,529,255,274
Montana,Rosebud County,6,506,255,251
Montana,Rosebud County,7,529,270,259
Montana,Rosebud County,8,477,240,237
Montana,Rosebud County,9,523,259,264
Montana,Rosebud County,10,500,262,238
Montana,Rosebud County,11,657,320,337
Montana,Rosebud County,12,729,359,370
Montana,Rosebud County,13,634,315,319
Montana,Rosebud County,14,489,265,224
Montana,Rosebud County,15,316,158,158
Montana,Rosebud County,16,201,93,108
Montana,Rosebud County,17,139,69,70
Montana,Rosebud County,18,127,50,77
Montana,Sanders County,0,11364,5805,5559
Montana,Sanders County,1,515,258,257
Montana,Sanders County,2,551,300,251
Montana,Sanders County,3,576,287,289
Montana,Sanders County,4,654,368,286
Montana,Sanders County,5,478,261,217
Montana,Sanders County,6,413,185,228
Montana,Sanders County,7,475,244,231
Montana,Sanders County,8,496,234,262
Montana,Sanders County,9,547,297,250
Montana,Sanders County,10,557,276,281
Montana,Sanders County,11,850,403,447
Montana,Sanders County,12,1094,502,592
Montana,Sanders County,13,1198,607,591
Montana,Sanders County,14,1033,561,472
Montana,Sanders County,15,826,452,374
Montana,Sanders County,16,535,308,227
Montana,Sanders County,17,295,149,146
Montana,Sanders County,18,271,113,158
Montana,Sheridan County,0,3696,1880,1816
Montana,Sheridan County,1,201,106,95
Montana,Sheridan County,2,229,102,127
Montana,Sheridan County,3,204,110,94
Montana,Sheridan County,4,215,118,97
Montana,Sheridan County,5,177,104,73
Montana,Sheridan County,6,184,99,85
Montana,Sheridan County,7,235,142,93
Montana,Sheridan County,8,202,93,109
Montana,Sheridan County,9,178,78,100
Montana,Sheridan County,10,196,90,106
Montana,Sheridan County,11,261,144,117
Montana,Sheridan County,12,337,183,154
Montana,Sheridan County,13,307,166,141
Montana,Sheridan County,14,212,106,106
Montana,Sheridan County,15,160,74,86
Montana,Sheridan County,16,143,65,78
Montana,Sheridan County,17,121,43,78
Montana,Sheridan County,18,134,57,77
Montana,Silver Bow County,0,34680,17591,17089
Montana,Silver Bow County,1,2006,1004,1002
Montana,Silver Bow County,2,1928,1006,922
Montana,Silver Bow County,3,1937,1009,928
Montana,Silver Bow County,4,2171,1166,1005
Montana,Silver Bow County,5,3135,1698,1437
Montana,Silver Bow County,6,1980,1108,872
Montana,Silver Bow County,7,2055,1083,972
Montana,Silver Bow County,8,1887,997,890
Montana,Silver Bow County,9,1854,934,920
Montana,Silver Bow County,10,2081,1064,1017
Montana,Silver Bow County,11,2483,1231,1252
Montana,Silver Bow County,12,2756,1371,1385
Montana,Silver Bow County,13,2416,1191,1225
Montana,Silver Bow County,14,1835,943,892
Montana,Silver Bow County,15,1484,728,756
Montana,Silver Bow County,16,1081,481,600
Montana,Silver Bow County,17,730,331,399
Montana,Silver Bow County,18,861,246,615
Montana,Stillwater County,0,9290,4736,4554
Montana,Stillwater County,1,430,217,213
Montana,Stillwater County,2,566,306,260
Montana,Stillwater County,3,633,323,310
Montana,Stillwater County,4,558,296,262
Montana,Stillwater County,5,402,216,186
Montana,Stillwater County,6,340,177,163
Montana,Stillwater County,7,453,216,237
Montana,Stillwater County,8,505,249,256
Montana,Stillwater County,9,526,274,252
Montana,Stillwater County,10,567,276,291
Montana,Stillwater County,11,722,354,368
Montana,Stillwater County,12,857,434,423
Montana,Stillwater County,13,864,441,423
Montana,Stillwater County,14,664,353,311
Montana,Stillwater County,15,497,252,245
Montana,Stillwater County,16,307,170,137
Montana,Stillwater County,17,210,110,100
Montana,Stillwater County,18,189,72,117
Montana,Sweet Grass County,0,3665,1815,1850
Montana,Sweet Grass County,1,157,63,94
Montana,Sweet Grass County,2,246,120,126
Montana,Sweet Grass County,3,241,134,107
Montana,Sweet Grass County,4,247,131,116
Montana,Sweet Grass County,5,165,85,80
Montana,Sweet Grass County,6,150,75,75
Montana,Sweet Grass County,7,164,81,83
Montana,Sweet Grass County,8,191,100,91
Montana,Sweet Grass County,9,190,85,105
Montana,Sweet Grass County,10,214,114,100
Montana,Sweet Grass County,11,261,128,133
Montana,Sweet Grass County,12,278,136,142
Montana,Sweet Grass County,13,300,159,141
Montana,Sweet Grass County,14,256,114,142
Montana,Sweet Grass County,15,215,113,102
Montana,Sweet Grass County,16,141,78,63
Montana,Sweet Grass County,17,110,49,61
Montana,Sweet Grass County,18,139,50,89
Montana,Teton County,0,6064,2976,3088
Montana,Teton County,1,368,181,187
Montana,Teton County,2,367,176,191
Montana,Teton County,3,395,196,199
Montana,Teton County,4,400,195,205
Montana,Teton County,5,310,168,142
Montana,Teton County,6,254,109,145
Montana,Teton County,7,336,164,172
Montana,Teton County,8,301,136,165
Montana,Teton County,9,313,162,151
Montana,Teton County,10,349,174,175
Montana,Teton County,11,455,235,220
Montana,Teton County,12,459,226,233
Montana,Teton County,13,423,221,202
Montana,Teton County,14,373,172,201
Montana,Teton County,15,323,170,153
Montana,Teton County,16,254,122,132
Montana,Teton County,17,163,88,75
Montana,Teton County,18,221,81,140
Montana,Toole County,0,5150,2903,2247
Montana,Toole County,1,272,138,134
Montana,Toole County,2,281,147,134
Montana,Toole County,3,275,145,130
Montana,Toole County,4,300,156,144
Montana,Toole County,5,345,215,130
Montana,Toole County,6,339,237,102
Montana,Toole County,7,366,242,124
Montana,Toole County,8,332,208,124
Montana,Toole County,9,292,177,115
Montana,Toole County,10,319,192,127
Montana,Toole County,11,440,240,200
Montana,Toole County,12,427,243,184
Montana,Toole County,13,360,195,165
Montana,Toole County,14,238,131,107
Montana,Toole County,15,199,89,110
Montana,Toole County,16,120,62,58
Montana,Toole County,17,110,41,69
Montana,Toole County,18,135,45,90
Montana,Treasure County,0,692,360,332
Montana,Treasure County,1,42,14,28
Montana,Treasure County,2,34,15,19
Montana,Treasure County,3,26,13,13
Montana,Treasure County,4,33,18,15
Montana,Treasure County,5,25,19,6
Montana,Treasure County,6,37,17,20
Montana,Treasure County,7,40,22,18
Montana,Treasure County,8,27,13,14
Montana,Treasure County,9,22,13,9
Montana,Treasure County,10,42,21,21
Montana,Treasure County,11,45,27,18
Montana,Treasure County,12,77,41,36
Montana,Treasure County,13,55,31,24
Montana,Treasure County,14,58,32,26
Montana,Treasure County,15,45,25,20
Montana,Treasure County,16,33,15,18
Montana,Treasure County,17,22,9,13
Montana,Treasure County,18,29,15,14
Montana,Valley County,0,7640,3857,3783
Montana,Valley County,1,409,218,191
Montana,Valley County,2,493,250,243
Montana,Valley County,3,515,281,234
Montana,Valley County,4,460,230,230
Montana,Valley County,5,401,195,206
Montana,Valley County,6,347,188,159
Montana,Valley County,7,422,210,212
Montana,Valley County,8,399,222,177
Montana,Valley County,9,376,184,192
Montana,Valley County,10,434,223,211
Montana,Valley County,11,584,273,311
Montana,Valley County,12,615,330,285
Montana,Valley County,13,597,312,285
Montana,Valley County,14,432,210,222
Montana,Valley County,15,357,187,170
Montana,Valley County,16,325,144,181
Montana,Valley County,17,242,111,131
Montana,Valley County,18,232,89,143
Montana,Wheatland County,0,2102,1047,1055
Montana,Wheatland County,1,142,72,70
Montana,Wheatland County,2,139,66,73
Montana,Wheatland County,3,124,66,58
Montana,Wheatland County,4,128,63,65
Montana,Wheatland County,5,88,32,56
Montana,Wheatland County,6,97,50,47
Montana,Wheatland County,7,90,39,51
Montana,Wheatland County,8,102,46,56
Montana,Wheatland County,9,124,65,59
Montana,Wheatland County,10,100,62,38
Montana,Wheatland County,11,121,66,55
Montana,Wheatland County,12,166,75,91
Montana,Wheatland County,13,178,90,88
Montana,Wheatland County,14,159,96,63
Montana,Wheatland County,15,133,66,67
Montana,Wheatland County,16,76,40,36
Montana,Wheatland County,17,56,24,32
Montana,Wheatland County,18,79,29,50
Montana,Wibaux County,0,1121,573,548
Montana,Wibaux County,1,52,27,25
Montana,Wibaux County,2,64,34,30
Montana,Wibaux County,3,76,33,43
Montana,Wibaux County,4,73,40,33
Montana,Wibaux County,5,57,36,21
Montana,Wibaux County,6,49,21,28
Montana,Wibaux County,7,62,35,27
Montana,Wibaux County,8,48,28,20
Montana,Wibaux County,9,38,18,20
Montana,Wibaux County,10,70,33,37
Montana,Wibaux County,11,87,53,34
Montana,Wibaux County,12,90,49,41
Montana,Wibaux County,13,79,39,40
Montana,Wibaux County,14,69,35,34
Montana,Wibaux County,15,61,32,29
Montana,Wibaux County,16,51,27,24
Montana,Wibaux County,17,44,21,23
Montana,Wibaux County,18,51,12,39
Montana,Yellowstone County,0,155634,76351,79283
Montana,Yellowstone County,1,10025,5065,4960
Montana,Yellowstone County,2,10772,5435,5337
Montana,Yellowstone County,3,10073,5024,5049
Montana,Yellowstone County,4,9206,4759,4447
Montana,Yellowstone County,5,9963,4961,5002
Montana,Yellowstone County,6,10721,5306,5415
Montana,Yellowstone County,7,10887,5455,5432
Montana,Yellowstone County,8,9610,4822,4788
Montana,Yellowstone County,9,9298,4727,4571
Montana,Yellowstone County,10,9158,4535,4623
Montana,Yellowstone County,11,10985,5346,5639
Montana,Yellowstone County,12,11321,5506,5815
Montana,Yellowstone County,13,9817,4826,4991
Montana,Yellowstone County,14,7648,3689,3959
Montana,Yellowstone County,15,5490,2602,2888
Montana,Yellowstone County,16,3985,1763,2222
Montana,Yellowstone County,17,3086,1291,1795
Montana,Yellowstone County,18,3589,1239,2350
Nebraska,Adams County,0,31457,15770,15687
Nebraska,Adams County,1,1994,989,1005
Nebraska,Adams County,2,2043,1098,945
Nebraska,Adams County,3,2072,1042,1030
Nebraska,Adams County,4,2376,1289,1087
Nebraska,Adams County,5,2570,1350,1220
Nebraska,Adams County,6,1808,945,863
Nebraska,Adams County,7,1797,940,857
Nebraska,Adams County,8,1695,867,828
Nebraska,Adams County,9,1682,871,811
Nebraska,Adams County,10,1773,878,895
Nebraska,Adams County,11,2214,1113,1101
Nebraska,Adams County,12,2222,1156,1066
Nebraska,Adams County,13,2006,997,1009
Nebraska,Adams County,14,1545,730,815
Nebraska,Adams County,15,1190,558,632
Nebraska,Adams County,16,839,356,483
Nebraska,Adams County,17,720,293,427
Nebraska,Adams County,18,911,298,613
Nebraska,Antelope County,0,6398,3165,3233
Nebraska,Antelope County,1,424,198,226
Nebraska,Antelope County,2,401,199,202
Nebraska,Antelope County,3,398,202,196
Nebraska,Antelope County,4,406,206,200
Nebraska,Antelope County,5,291,159,132
Nebraska,Antelope County,6,290,157,133
Nebraska,Antelope County,7,343,184,159
Nebraska,Antelope County,8,284,152,132
Nebraska,Antelope County,9,290,151,139
Nebraska,Antelope County,10,321,150,171
Nebraska,Antelope County,11,507,255,252
Nebraska,Antelope County,12,509,261,248
Nebraska,Antelope County,13,499,254,245
Nebraska,Antelope County,14,392,202,190
Nebraska,Antelope County,15,308,142,166
Nebraska,Antelope County,16,265,120,145
Nebraska,Antelope County,17,203,83,120
Nebraska,Antelope County,18,267,90,177
Nebraska,Arthur County,0,453,218,235
Nebraska,Arthur County,1,26,17,9
Nebraska,Arthur County,2,37,12,25
Nebraska,Arthur County,3,40,20,20
Nebraska,Arthur County,4,30,9,21
Nebraska,Arthur County,5,20,12,8
Nebraska,Arthur County,6,16,8,8
Nebraska,Arthur County,7,20,4,16
Nebraska,Arthur County,8,35,20,15
Nebraska,Arthur County,9,25,12,13
Nebraska,Arthur County,10,27,15,12
Nebraska,Arthur County,11,23,12,11
Nebraska,Arthur County,12,29,14,15
Nebraska,Arthur County,13,29,17,12
Nebraska,Arthur County,14,26,13,13
Nebraska,Arthur County,15,25,12,13
Nebraska,Arthur County,16,19,7,12
Nebraska,Arthur County,17,21,9,12
Nebraska,Arthur County,18,5,5,0
Nebraska,Banner County,0,764,386,378
Nebraska,Banner County,1,46,18,28
Nebraska,Banner County,2,40,24,16
Nebraska,Banner County,3,32,13,19
Nebraska,Banner County,4,42,26,16
Nebraska,Banner County,5,31,20,11
Nebraska,Banner County,6,32,14,18
Nebraska,Banner County,7,38,18,20
Nebraska,Banner County,8,29,17,12
Nebraska,Banner County,9,20,8,12
Nebraska,Banner County,10,34,14,20
Nebraska,Banner County,11,58,28,30
Nebraska,Banner County,12,67,35,32
Nebraska,Banner County,13,69,39,30
Nebraska,Banner County,14,67,30,37
Nebraska,Banner County,15,59,34,25
Nebraska,Banner County,16,37,15,22
Nebraska,Banner County,17,39,22,17
Nebraska,Banner County,18,24,11,13
Nebraska,Blaine County,0,504,262,242
Nebraska,Blaine County,1,42,27,15
Nebraska,Blaine County,2,26,13,13
Nebraska,Blaine County,3,28,12,16
Nebraska,Blaine County,4,32,22,10
Nebraska,Blaine County,5,28,13,15
Nebraska,Blaine County,6,17,11,6
Nebraska,Blaine County,7,23,13,10
Nebraska,Blaine County,8,25,13,12
Nebraska,Blaine County,9,22,9,13
Nebraska,Blaine County,10,32,15,17
Nebraska,Blaine County,11,47,19,28
Nebraska,Blaine County,12,35,21,14
Nebraska,Blaine County,13,37,15,22
Nebraska,Blaine County,14,32,16,16
Nebraska,Blaine County,15,27,16,11
Nebraska,Blaine County,16,26,14,12
Nebraska,Blaine County,17,14,8,6
Nebraska,Blaine County,18,11,5,6
Nebraska,Boone County,0,5353,2685,2668
Nebraska,Boone County,1,302,145,157
Nebraska,Boone County,2,348,161,187
Nebraska,Boone County,3,342,182,160
Nebraska,Boone County,4,358,192,166
Nebraska,Boone County,5,292,139,153
Nebraska,Boone County,6,227,132,95
Nebraska,Boone County,7,287,154,133
Nebraska,Boone County,8,233,121,112
Nebraska,Boone County,9,259,140,119
Nebraska,Boone County,10,315,154,161
Nebraska,Boone County,11,403,214,189
Nebraska,Boone County,12,471,257,214
Nebraska,Boone County,13,359,186,173
Nebraska,Boone County,14,273,132,141
Nebraska,Boone County,15,248,130,118
Nebraska,Boone County,16,195,93,102
Nebraska,Boone County,17,194,75,119
Nebraska,Boone County,18,247,78,169
Nebraska,Box Butte County,0,11340,5682,5658
Nebraska,Box Butte County,1,803,446,357
Nebraska,Box Butte County,2,816,413,403
Nebraska,Box Butte County,3,795,398,397
Nebraska,Box Butte County,4,709,382,327
Nebraska,Box Butte County,5,600,301,299
Nebraska,Box Butte County,6,616,320,296
Nebraska,Box Butte County,7,701,344,357
Nebraska,Box Butte County,8,680,358,322
Nebraska,Box Butte County,9,628,323,305
Nebraska,Box Butte County,10,565,273,292
Nebraska,Box Butte County,11,746,345,401
Nebraska,Box Butte County,12,1010,532,478
Nebraska,Box Butte County,13,848,439,409
Nebraska,Box Butte County,14,592,313,279
Nebraska,Box Butte County,15,377,175,202
Nebraska,Box Butte County,16,290,128,162
Nebraska,Box Butte County,17,257,89,168
Nebraska,Box Butte County,18,307,103,204
Nebraska,Boyd County,0,2033,994,1039
Nebraska,Boyd County,1,94,36,58
Nebraska,Boyd County,2,114,53,61
Nebraska,Boyd County,3,122,68,54
Nebraska,Boyd County,4,136,56,80
Nebraska,Boyd County,5,86,44,42
Nebraska,Boyd County,6,68,32,36
Nebraska,Boyd County,7,79,41,38
Nebraska,Boyd County,8,87,47,40
Nebraska,Boyd County,9,91,47,44
Nebraska,Boyd County,10,89,58,31
Nebraska,Boyd County,11,154,71,83
Nebraska,Boyd County,12,162,88,74
Nebraska,Boyd County,13,167,88,79
Nebraska,Boyd County,14,163,88,75
Nebraska,Boyd County,15,143,73,70
Nebraska,Boyd County,16,85,37,48
Nebraska,Boyd County,17,81,26,55
Nebraska,Boyd County,18,112,41,71
Nebraska,Brown County,0,2941,1446,1495
Nebraska,Brown County,1,139,75,64
Nebraska,Brown County,2,152,67,85
Nebraska,Brown County,3,185,92,93
Nebraska,Brown County,4,191,99,92
Nebraska,Brown County,5,130,71,59
Nebraska,Brown County,6,107,55,52
Nebraska,Brown County,7,146,74,72
Nebraska,Brown County,8,133,73,60
Nebraska,Brown County,9,156,70,86
Nebraska,Brown County,10,155,78,77
Nebraska,Brown County,11,239,113,126
Nebraska,Brown County,12,240,121,119
Nebraska,Brown County,13,253,127,126
Nebraska,Brown County,14,173,85,88
Nebraska,Brown County,15,163,77,86
Nebraska,Brown County,16,145,77,68
Nebraska,Brown County,17,121,54,67
Nebraska,Brown County,18,113,38,75
Nebraska,Buffalo County,0,48224,23958,24266
Nebraska,Buffalo County,1,3361,1704,1657
Nebraska,Buffalo County,2,3174,1617,1557
Nebraska,Buffalo County,3,2974,1571,1403
Nebraska,Buffalo County,4,3802,1952,1850
Nebraska,Buffalo County,5,5660,2852,2808
Nebraska,Buffalo County,6,3422,1814,1608
Nebraska,Buffalo County,7,3296,1713,1583
Nebraska,Buffalo County,8,2909,1457,1452
Nebraska,Buffalo County,9,2540,1279,1261
Nebraska,Buffalo County,10,2448,1226,1222
Nebraska,Buffalo County,11,2880,1423,1457
Nebraska,Buffalo County,12,2914,1411,1503
Nebraska,Buffalo County,13,2623,1278,1345
Nebraska,Buffalo County,14,1964,932,1032
Nebraska,Buffalo County,15,1368,638,730
Nebraska,Buffalo County,16,1031,444,587
Nebraska,Buffalo County,17,845,327,518
Nebraska,Buffalo County,18,1013,320,693
Nebraska,Burt County,0,6573,3256,3317
Nebraska,Burt County,1,352,169,183
Nebraska,Burt County,2,428,210,218
Nebraska,Burt County,3,435,261,174
Nebraska,Burt County,4,387,207,180
Nebraska,Burt County,5,296,155,141
Nebraska,Burt County,6,267,141,126
Nebraska,Burt County,7,325,149,176
Nebraska,Burt County,8,297,153,144
Nebraska,Burt County,9,335,171,164
Nebraska,Burt County,10,369,184,185
Nebraska,Burt County,11,485,234,251
Nebraska,Burt County,12,505,257,248
Nebraska,Burt County,13,524,266,258
Nebraska,Burt County,14,387,197,190
Nebraska,Burt County,15,337,165,172
Nebraska,Burt County,16,296,142,154
Nebraska,Burt County,17,260,99,161
Nebraska,Burt County,18,288,96,192
Nebraska,Butler County,0,8249,4191,4058
Nebraska,Butler County,1,477,254,223
Nebraska,Butler County,2,481,252,229
Nebraska,Butler County,3,619,317,302
Nebraska,Butler County,4,553,293,260
Nebraska,Butler County,5,408,222,186
Nebraska,Butler County,6,370,196,174
Nebraska,Butler County,7,419,227,192
Nebraska,Butler County,8,435,234,201
Nebraska,Butler County,9,428,220,208
Nebraska,Butler County,10,494,253,241
Nebraska,Butler County,11,671,338,333
Nebraska,Butler County,12,634,338,296
Nebraska,Butler County,13,558,275,283
Nebraska,Butler County,14,454,228,226
Nebraska,Butler County,15,370,173,197
Nebraska,Butler County,16,301,145,156
Nebraska,Butler County,17,259,111,148
Nebraska,Butler County,18,318,115,203
Nebraska,Cass County,0,25524,12855,12669
Nebraska,Cass County,1,1520,801,719
Nebraska,Cass County,2,1732,899,833
Nebraska,Cass County,3,1873,982,891
Nebraska,Cass County,4,1723,908,815
Nebraska,Cass County,5,1268,668,600
Nebraska,Cass County,6,1126,583,543
Nebraska,Cass County,7,1456,754,702
Nebraska,Cass County,8,1494,734,760
Nebraska,Cass County,9,1614,817,797
Nebraska,Cass County,10,1678,820,858
Nebraska,Cass County,11,2140,1076,1064
Nebraska,Cass County,12,1992,994,998
Nebraska,Cass County,13,1794,893,901
Nebraska,Cass County,14,1411,718,693
Nebraska,Cass County,15,967,472,495
Nebraska,Cass County,16,702,337,365
Nebraska,Cass County,17,500,235,265
Nebraska,Cass County,18,534,164,370
Nebraska,Cedar County,0,8610,4355,4255
Nebraska,Cedar County,1,456,250,206
Nebraska,Cedar County,2,621,334,287
Nebraska,Cedar County,3,628,324,304
Nebraska,Cedar County,4,621,330,291
Nebraska,Cedar County,5,447,241,206
Nebraska,Cedar County,6,348,198,150
Nebraska,Cedar County,7,416,216,200
Nebraska,Cedar County,8,396,193,203
Nebraska,Cedar County,9,405,196,209
Nebraska,Cedar County,10,492,248,244
Nebraska,Cedar County,11,653,326,327
Nebraska,Cedar County,12,737,390,347
Nebraska,Cedar County,13,554,293,261
Nebraska,Cedar County,14,457,241,216
Nebraska,Cedar County,15,368,172,196
Nebraska,Cedar County,16,333,145,188
Nebraska,Cedar County,17,311,123,188
Nebraska,Cedar County,18,367,135,232
Nebraska,Chase County,0,3978,1940,2038
Nebraska,Chase County,1,228,103,125
Nebraska,Chase County,2,295,145,150
Nebraska,Chase County,3,282,124,158
Nebraska,Chase County,4,232,108,124
Nebraska,Chase County,5,185,104,81
Nebraska,Chase County,6,193,108,85
Nebraska,Chase County,7,216,106,110
Nebraska,Chase County,8,228,111,117
Nebraska,Chase County,9,204,114,90
Nebraska,Chase County,10,213,108,105
Nebraska,Chase County,11,282,153,129
Nebraska,Chase County,12,328,147,181
Nebraska,Chase County,13,268,150,118
Nebraska,Chase County,14,204,106,98
Nebraska,Chase County,15,176,83,93
Nebraska,Chase County,16,139,71,68
Nebraska,Chase County,17,129,45,84
Nebraska,Chase County,18,176,54,122
Nebraska,Cherry County,0,5762,2882,2880
Nebraska,Cherry County,1,312,161,151
Nebraska,Cherry County,2,357,191,166
Nebraska,Cherry County,3,366,191,175
Nebraska,Cherry County,4,352,194,158
Nebraska,Cherry County,5,279,149,130
Nebraska,Cherry County,6,242,124,118
Nebraska,Cherry County,7,342,179,163
Nebraska,Cherry County,8,323,179,144
Nebraska,Cherry County,9,319,153,166
Nebraska,Cherry County,10,324,154,170
Nebraska,Cherry County,11,407,203,204
Nebraska,Cherry County,12,488,235,253
Nebraska,Cherry County,13,416,219,197
Nebraska,Cherry County,14,315,139,176
Nebraska,Cherry County,15,292,155,137
Nebraska,Cherry County,16,234,104,130
Nebraska,Cherry County,17,172,80,92
Nebraska,Cherry County,18,222,72,150
Nebraska,Cheyenne County,0,10148,5052,5096
Nebraska,Cheyenne County,1,631,297,334
Nebraska,Cheyenne County,2,702,360,342
Nebraska,Cheyenne County,3,715,371,344
Nebraska,Cheyenne County,4,596,315,281
Nebraska,Cheyenne County,5,539,291,248
Nebraska,Cheyenne County,6,610,312,298
Nebraska,Cheyenne County,7,728,363,365
Nebraska,Cheyenne County,8,615,300,315
Nebraska,Cheyenne County,9,608,317,291
Nebraska,Cheyenne County,10,614,308,306
Nebraska,Cheyenne County,11,766,381,385
Nebraska,Cheyenne County,12,729,389,340
Nebraska,Cheyenne County,13,652,325,327
Nebraska,Cheyenne County,14,478,249,229
Nebraska,Cheyenne County,15,339,151,188
Nebraska,Cheyenne County,16,273,120,153
Nebraska,Cheyenne County,17,247,107,140
Nebraska,Cheyenne County,18,306,96,210
Nebraska,Clay County,0,6315,3197,3118
Nebraska,Clay County,1,395,199,196
Nebraska,Clay County,2,432,212,220
Nebraska,Clay County,3,454,247,207
Nebraska,Clay County,4,397,212,185
Nebraska,Clay County,5,319,177,142
Nebraska,Clay County,6,321,166,155
Nebraska,Clay County,7,323,162,161
Nebraska,Clay County,8,329,169,160
Nebraska,Clay County,9,339,160,179
Nebraska,Clay County,10,362,186,176
Nebraska,Clay County,11,481,243,238
Nebraska,Clay County,12,512,258,254
Nebraska,Clay County,13,444,240,204
Nebraska,Clay County,14,396,199,197
Nebraska,Clay County,15,263,139,124
Nebraska,Clay County,16,201,95,106
Nebraska,Clay County,17,162,70,92
Nebraska,Clay County,18,185,63,122
Nebraska,Colfax County,0,10504,5405,5099
Nebraska,Colfax County,1,864,421,443
Nebraska,Colfax County,2,971,479,492
Nebraska,Colfax County,3,837,433,404
Nebraska,Colfax County,4,676,353,323
Nebraska,Colfax County,5,651,355,296
Nebraska,Colfax County,6,634,357,277
Nebraska,Colfax County,7,704,367,337
Nebraska,Colfax County,8,609,311,298
Nebraska,Colfax County,9,608,328,280
Nebraska,Colfax County,10,621,340,281
Nebraska,Colfax County,11,726,388,338
Nebraska,Colfax County,12,680,349,331
Nebraska,Colfax County,13,546,292,254
Nebraska,Colfax County,14,391,193,198
Nebraska,Colfax County,15,282,151,131
Nebraska,Colfax County,16,247,122,125
Nebraska,Colfax County,17,225,89,136
Nebraska,Colfax County,18,232,77,155
Nebraska,Cuming County,0,9027,4526,4501
Nebraska,Cuming County,1,500,272,228
Nebraska,Cuming County,2,646,332,314
Nebraska,Cuming County,3,678,341,337
Nebraska,Cuming County,4,600,315,285
Nebraska,Cuming County,5,447,236,211
Nebraska,Cuming County,6,398,188,210
Nebraska,Cuming County,7,510,251,259
Nebraska,Cuming County,8,419,213,206
Nebraska,Cuming County,9,438,213,225
Nebraska,Cuming County,10,548,280,268
Nebraska,Cuming County,11,687,361,326
Nebraska,Cuming County,12,659,364,295
Nebraska,Cuming County,13,556,295,261
Nebraska,Cuming County,14,500,246,254
Nebraska,Cuming County,15,396,193,203
Nebraska,Cuming County,16,356,161,195
Nebraska,Cuming County,17,303,129,174
Nebraska,Cuming County,18,386,136,250
Nebraska,Custer County,0,10728,5339,5389
Nebraska,Custer County,1,657,319,338
Nebraska,Custer County,2,711,356,355
Nebraska,Custer County,3,704,366,338
Nebraska,Custer County,4,653,336,317
Nebraska,Custer County,5,554,299,255
Nebraska,Custer County,6,538,285,253
Nebraska,Custer County,7,548,289,259
Nebraska,Custer County,8,567,298,269
Nebraska,Custer County,9,571,285,286
Nebraska,Custer County,10,565,280,285
Nebraska,Custer County,11,838,418,420
Nebraska,Custer County,12,821,416,405
Nebraska,Custer County,13,760,373,387
Nebraska,Custer County,14,639,323,316
Nebraska,Custer County,15,494,243,251
Nebraska,Custer County,16,394,176,218
Nebraska,Custer County,17,321,142,179
Nebraska,Custer County,18,393,135,258
Nebraska,Dakota County,0,20850,10425,10425
Nebraska,Dakota County,1,1672,856,816
Nebraska,Dakota County,2,1756,911,845
Nebraska,Dakota County,3,1600,831,769
Nebraska,Dakota County,4,1552,757,795
Nebraska,Dakota County,5,1505,791,714
Nebraska,Dakota County,6,1357,677,680
Nebraska,Dakota County,7,1335,685,650
Nebraska,Dakota County,8,1243,598,645
Nebraska,Dakota County,9,1189,603,586
Nebraska,Dakota County,10,1253,658,595
Nebraska,Dakota County,11,1383,705,678
Nebraska,Dakota County,12,1289,656,633
Nebraska,Dakota County,13,1060,502,558
Nebraska,Dakota County,14,857,427,430
Nebraska,Dakota County,15,645,302,343
Nebraska,Dakota County,16,497,225,272
Nebraska,Dakota County,17,307,132,175
Nebraska,Dakota County,18,350,109,241
Nebraska,Dawes County,0,9042,4468,4574
Nebraska,Dawes County,1,462,226,236
Nebraska,Dawes County,2,452,215,237
Nebraska,Dawes County,3,440,216,224
Nebraska,Dawes County,4,1001,495,506
Nebraska,Dawes County,5,1281,675,606
Nebraska,Dawes County,6,480,263,217
Nebraska,Dawes County,7,449,239,210
Nebraska,Dawes County,8,419,212,207
Nebraska,Dawes County,9,371,188,183
Nebraska,Dawes County,10,458,226,232
Nebraska,Dawes County,11,528,215,313
Nebraska,Dawes County,12,585,304,281
Nebraska,Dawes County,13,525,260,265
Nebraska,Dawes County,14,424,213,211
Nebraska,Dawes County,15,381,174,207
Nebraska,Dawes County,16,291,150,141
Nebraska,Dawes County,17,220,88,132
Nebraska,Dawes County,18,275,109,166
Nebraska,Dawson County,0,24096,12244,11852
Nebraska,Dawson County,1,1812,975,837
Nebraska,Dawson County,2,1853,971,882
Nebraska,Dawson County,3,1953,953,1000
Nebraska,Dawson County,4,1705,863,842
Nebraska,Dawson County,5,1534,806,728
Nebraska,Dawson County,6,1389,734,655
Nebraska,Dawson County,7,1470,774,696
Nebraska,Dawson County,8,1400,705,695
Nebraska,Dawson County,9,1450,723,727
Nebraska,Dawson County,10,1398,758,640
Nebraska,Dawson County,11,1523,797,726
Nebraska,Dawson County,12,1561,827,734
Nebraska,Dawson County,13,1434,712,722
Nebraska,Dawson County,14,1104,555,549
Nebraska,Dawson County,15,868,422,446
Nebraska,Dawson County,16,591,254,337
Nebraska,Dawson County,17,505,200,305
Nebraska,Dawson County,18,546,215,331
Nebraska,Deuel County,0,1940,967,973
Nebraska,Deuel County,1,101,60,41
Nebraska,Deuel County,2,117,53,64
Nebraska,Deuel County,3,123,69,54
Nebraska,Deuel County,4,105,48,57
Nebraska,Deuel County,5,82,49,33
Nebraska,Deuel County,6,91,39,52
Nebraska,Deuel County,7,82,38,44
Nebraska,Deuel County,8,98,51,47
Nebraska,Deuel County,9,99,50,49
Nebraska,Deuel County,10,118,60,58
Nebraska,Deuel County,11,155,79,76
Nebraska,Deuel County,12,166,82,84
Nebraska,Deuel County,13,147,78,69
Nebraska,Deuel County,14,109,48,61
Nebraska,Deuel County,15,113,56,57
Nebraska,Deuel County,16,89,42,47
Nebraska,Deuel County,17,74,38,36
Nebraska,Deuel County,18,71,27,44
Nebraska,Dixon County,0,5782,2906,2876
Nebraska,Dixon County,1,333,157,176
Nebraska,Dixon County,2,400,212,188
Nebraska,Dixon County,3,415,211,204
Nebraska,Dixon County,4,422,228,194
Nebraska,Dixon County,5,292,155,137
Nebraska,Dixon County,6,253,132,121
Nebraska,Dixon County,7,295,153,142
Nebraska,Dixon County,8,312,145,167
Nebraska,Dixon County,9,305,159,146
Nebraska,Dixon County,10,339,184,155
Nebraska,Dixon County,11,384,188,196
Nebraska,Dixon County,12,461,247,214
Nebraska,Dixon County,13,430,227,203
Nebraska,Dixon County,14,347,177,170
Nebraska,Dixon County,15,264,130,134
Nebraska,Dixon County,16,191,85,106
Nebraska,Dixon County,17,166,67,99
Nebraska,Dixon County,18,173,49,124
Nebraska,Dodge County,0,36744,18097,18647
Nebraska,Dodge County,1,2341,1191,1150
Nebraska,Dodge County,2,2521,1274,1247
Nebraska,Dodge County,3,2402,1208,1194
Nebraska,Dodge County,4,2386,1217,1169
Nebraska,Dodge County,5,2363,1174,1189
Nebraska,Dodge County,6,1993,1030,963
Nebraska,Dodge County,7,2198,1119,1079
Nebraska,Dodge County,8,2094,1061,1033
Nebraska,Dodge County,9,2071,1060,1011
Nebraska,Dodge County,10,2090,1078,1012
Nebraska,Dodge County,11,2608,1325,1283
Nebraska,Dodge County,12,2459,1210,1249
Nebraska,Dodge County,13,2248,1125,1123
Nebraska,Dodge County,14,1895,890,1005
Nebraska,Dodge County,15,1531,723,808
Nebraska,Dodge County,16,1237,555,682
Nebraska,Dodge County,17,1033,422,611
Nebraska,Dodge County,18,1274,435,839
Nebraska,Douglas County,0,543244,267625,275619
Nebraska,Douglas County,1,41307,21057,20250
Nebraska,Douglas County,2,39714,20304,19410
Nebraska,Douglas County,3,37753,19239,18514
Nebraska,Douglas County,4,35672,18018,17654
Nebraska,Douglas County,5,36841,18282,18559
Nebraska,Douglas County,6,44003,21814,22189
Nebraska,Douglas County,7,43505,21978,21527
Nebraska,Douglas County,8,35818,18104,17714
Nebraska,Douglas County,9,34203,17206,16997
Nebraska,Douglas County,10,33174,16791,16383
Nebraska,Douglas County,11,35966,17794,18172
Nebraska,Douglas County,12,33790,16360,17430
Nebraska,Douglas County,13,29035,13717,15318
Nebraska,Douglas County,14,21305,10038,11267
Nebraska,Douglas County,15,14272,6477,7795
Nebraska,Douglas County,16,10182,4361,5821
Nebraska,Douglas County,17,7910,3189,4721
Nebraska,Douglas County,18,8794,2896,5898
Nebraska,Dundy County,0,1886,950,936
Nebraska,Dundy County,1,74,47,27
Nebraska,Dundy County,2,118,69,49
Nebraska,Dundy County,3,124,72,52
Nebraska,Dundy County,4,134,61,73
Nebraska,Dundy County,5,86,37,49
Nebraska,Dundy County,6,64,36,28
Nebraska,Dundy County,7,94,49,45
Nebraska,Dundy County,8,87,44,43
Nebraska,Dundy County,9,123,61,62
Nebraska,Dundy County,10,90,44,46
Nebraska,Dundy County,11,141,78,63
Nebraska,Dundy County,12,163,84,79
Nebraska,Dundy County,13,149,77,72
Nebraska,Dundy County,14,123,63,60
Nebraska,Dundy County,15,89,49,40
Nebraska,Dundy County,16,74,32,42
Nebraska,Dundy County,17,69,21,48
Nebraska,Dundy County,18,84,26,58
Nebraska,Fillmore County,0,5661,2819,2842
Nebraska,Fillmore County,1,277,148,129
Nebraska,Fillmore County,2,299,136,163
Nebraska,Fillmore County,3,330,181,149
Nebraska,Fillmore County,4,385,172,213
Nebraska,Fillmore County,5,286,157,129
Nebraska,Fillmore County,6,248,139,109
Nebraska,Fillmore County,7,314,165,149
Nebraska,Fillmore County,8,273,144,129
Nebraska,Fillmore County,9,260,133,127
Nebraska,Fillmore County,10,354,186,168
Nebraska,Fillmore County,11,461,224,237
Nebraska,Fillmore County,12,451,238,213
Nebraska,Fillmore County,13,429,229,200
Nebraska,Fillmore County,14,345,159,186
Nebraska,Fillmore County,15,261,124,137
Nebraska,Fillmore County,16,231,98,133
Nebraska,Fillmore County,17,199,74,125
Nebraska,Fillmore County,18,258,112,146
Nebraska,Franklin County,0,3076,1539,1537
Nebraska,Franklin County,1,138,69,69
Nebraska,Franklin County,2,169,96,73
Nebraska,Franklin County,3,165,81,84
Nebraska,Franklin County,4,182,90,92
Nebraska,Franklin County,5,144,63,81
Nebraska,Franklin County,6,140,71,69
Nebraska,Franklin County,7,122,62,60
Nebraska,Franklin County,8,153,80,73
Nebraska,Franklin County,9,138,70,68
Nebraska,Franklin County,10,162,79,83
Nebraska,Franklin County,11,253,139,114
Nebraska,Franklin County,12,266,132,134
Nebraska,Franklin County,13,253,137,116
Nebraska,Franklin County,14,208,103,105
Nebraska,Franklin County,15,175,86,89
Nebraska,Franklin County,16,156,72,84
Nebraska,Franklin County,17,138,64,74
Nebraska,Franklin County,18,114,45,69
Nebraska,Frontier County,0,2705,1392,1313
Nebraska,Frontier County,1,105,71,34
Nebraska,Frontier County,2,178,90,88
Nebraska,Frontier County,3,157,92,65
Nebraska,Frontier County,4,254,138,116
Nebraska,Frontier County,5,181,90,91
Nebraska,Frontier County,6,121,61,60
Nebraska,Frontier County,7,144,73,71
Nebraska,Frontier County,8,114,64,50
Nebraska,Frontier County,9,142,61,81
Nebraska,Frontier County,10,131,69,62
Nebraska,Frontier County,11,177,89,88
Nebraska,Frontier County,12,229,126,103
Nebraska,Frontier County,13,199,98,101
Nebraska,Frontier County,14,162,88,74
Nebraska,Frontier County,15,132,61,71
Nebraska,Frontier County,16,120,57,63
Nebraska,Frontier County,17,81,34,47
Nebraska,Frontier County,18,78,30,48
Nebraska,Furnas County,0,4888,2431,2457
Nebraska,Furnas County,1,248,133,115
Nebraska,Furnas County,2,293,149,144
Nebraska,Furnas County,3,343,175,168
Nebraska,Furnas County,4,316,174,142
Nebraska,Furnas County,5,234,119,115
Nebraska,Furnas County,6,210,109,101
Nebraska,Furnas County,7,233,119,114
Nebraska,Furnas County,8,223,115,108
Nebraska,Furnas County,9,266,138,128
Nebraska,Furnas County,10,278,139,139
Nebraska,Furnas County,11,337,169,168
Nebraska,Furnas County,12,402,214,188
Nebraska,Furnas County,13,393,186,207
Nebraska,Furnas County,14,305,154,151
Nebraska,Furnas County,15,246,112,134
Nebraska,Furnas County,16,201,98,103
Nebraska,Furnas County,17,162,61,101
Nebraska,Furnas County,18,198,67,131
Nebraska,Gage County,0,21663,10718,10945
Nebraska,Gage County,1,1236,651,585
Nebraska,Gage County,2,1370,708,662
Nebraska,Gage County,3,1336,685,651
Nebraska,Gage County,4,1291,682,609
Nebraska,Gage County,5,1148,589,559
Nebraska,Gage County,6,1036,522,514
Nebraska,Gage County,7,1140,559,581
Nebraska,Gage County,8,1181,592,589
Nebraska,Gage County,9,1180,594,586
Nebraska,Gage County,10,1384,688,696
Nebraska,Gage County,11,1727,874,853
Nebraska,Gage County,12,1722,849,873
Nebraska,Gage County,13,1501,770,731
Nebraska,Gage County,14,1175,588,587
Nebraska,Gage County,15,968,444,524
Nebraska,Gage County,16,824,372,452
Nebraska,Gage County,17,674,286,388
Nebraska,Gage County,18,770,265,505
Nebraska,Garden County,0,1911,976,935
Nebraska,Garden County,1,74,29,45
Nebraska,Garden County,2,105,69,36
Nebraska,Garden County,3,112,73,39
Nebraska,Garden County,4,85,46,39
Nebraska,Garden County,5,71,39,32
Nebraska,Garden County,6,90,43,47
Nebraska,Garden County,7,88,46,42
Nebraska,Garden County,8,73,35,38
Nebraska,Garden County,9,99,51,48
Nebraska,Garden County,10,116,55,61
Nebraska,Garden County,11,158,75,83
Nebraska,Garden County,12,162,97,65
Nebraska,Garden County,13,148,72,76
Nebraska,Garden County,14,114,49,65
Nebraska,Garden County,15,121,67,54
Nebraska,Garden County,16,125,58,67
Nebraska,Garden County,17,81,35,46
Nebraska,Garden County,18,89,37,52
Nebraska,Garfield County,0,2003,999,1004
Nebraska,Garfield County,1,61,28,33
Nebraska,Garfield County,2,111,52,59
Nebraska,Garfield County,3,124,62,62
Nebraska,Garfield County,4,124,59,65
Nebraska,Garfield County,5,94,51,43
Nebraska,Garfield County,6,95,53,42
Nebraska,Garfield County,7,80,46,34
Nebraska,Garfield County,8,91,47,44
Nebraska,Garfield County,9,82,33,49
Nebraska,Garfield County,10,97,52,45
Nebraska,Garfield County,11,157,73,84
Nebraska,Garfield County,12,180,92,88
Nebraska,Garfield County,13,169,92,77
Nebraska,Garfield County,14,136,69,67
Nebraska,Garfield County,15,114,58,56
Nebraska,Garfield County,16,106,56,50
Nebraska,Garfield County,17,81,42,39
Nebraska,Garfield County,18,101,34,67
Nebraska,Gosper County,0,1970,1024,946
Nebraska,Gosper County,1,117,70,47
Nebraska,Gosper County,2,125,80,45
Nebraska,Gosper County,3,142,74,68
Nebraska,Gosper County,4,125,61,64
Nebraska,Gosper County,5,93,56,37
Nebraska,Gosper County,6,87,44,43
Nebraska,Gosper County,7,105,54,51
Nebraska,Gosper County,8,94,44,50
Nebraska,Gosper County,9,97,52,45
Nebraska,Gosper County,10,107,62,45
Nebraska,Gosper County,11,169,81,88
Nebraska,Gosper County,12,155,75,80
Nebraska,Gosper County,13,142,73,69
Nebraska,Gosper County,14,126,67,59
Nebraska,Gosper County,15,85,37,48
Nebraska,Gosper County,16,73,39,34
Nebraska,Gosper County,17,60,34,26
Nebraska,Gosper County,18,68,21,47
Nebraska,Grant County,0,619,328,291
Nebraska,Grant County,1,49,29,20
Nebraska,Grant County,2,33,22,11
Nebraska,Grant County,3,25,11,14
Nebraska,Grant County,4,31,19,12
Nebraska,Grant County,5,23,12,11
Nebraska,Grant County,6,42,23,19
Nebraska,Grant County,7,36,21,15
Nebraska,Grant County,8,30,14,16
Nebraska,Grant County,9,20,10,10
Nebraska,Grant County,10,33,13,20
Nebraska,Grant County,11,63,31,32
Nebraska,Grant County,12,53,32,21
Nebraska,Grant County,13,59,30,29
Nebraska,Grant County,14,31,15,16
Nebraska,Grant County,15,36,17,19
Nebraska,Grant County,16,34,20,14
Nebraska,Grant County,17,17,6,11
Nebraska,Grant County,18,4,3,1
Nebraska,Greeley County,0,2482,1258,1224
Nebraska,Greeley County,1,129,77,52
Nebraska,Greeley County,2,177,92,85
Nebraska,Greeley County,3,174,88,86
Nebraska,Greeley County,4,165,78,87
Nebraska,Greeley County,5,101,47,54
Nebraska,Greeley County,6,125,70,55
Nebraska,Greeley County,7,107,47,60
Nebraska,Greeley County,8,136,73,63
Nebraska,Greeley County,9,100,62,38
Nebraska,Greeley County,10,125,48,77
Nebraska,Greeley County,11,189,97,92
Nebraska,Greeley County,12,187,98,89
Nebraska,Greeley County,13,179,100,79
Nebraska,Greeley County,14,142,87,55
Nebraska,Greeley County,15,116,52,64
Nebraska,Greeley County,16,111,54,57
Nebraska,Greeley County,17,116,56,60
Nebraska,Greeley County,18,103,32,71
Nebraska,Hall County,0,61492,30900,30592
Nebraska,Hall County,1,4667,2384,2283
Nebraska,Hall County,2,4704,2390,2314
Nebraska,Hall County,3,4497,2342,2155
Nebraska,Hall County,4,4067,2055,2012
Nebraska,Hall County,5,4005,2088,1917
Nebraska,Hall County,6,3957,2077,1880
Nebraska,Hall County,7,4069,2088,1981
Nebraska,Hall County,8,3929,2056,1873
Nebraska,Hall County,9,3752,1967,1785
Nebraska,Hall County,10,3716,1863,1853
Nebraska,Hall County,11,4163,2087,2076
Nebraska,Hall County,12,3936,1947,1989
Nebraska,Hall County,13,3323,1599,1724
Nebraska,Hall County,14,2684,1339,1345
Nebraska,Hall County,15,1920,923,997
Nebraska,Hall County,16,1480,675,805
Nebraska,Hall County,17,1258,531,727
Nebraska,Hall County,18,1365,489,876
Nebraska,Hamilton County,0,9135,4592,4543
Nebraska,Hamilton County,1,526,284,242
Nebraska,Hamilton County,2,593,332,261
Nebraska,Hamilton County,3,673,339,334
Nebraska,Hamilton County,4,668,346,322
Nebraska,Hamilton County,5,497,267,230
Nebraska,Hamilton County,6,429,224,205
Nebraska,Hamilton County,7,520,257,263
Nebraska,Hamilton County,8,459,243,216
Nebraska,Hamilton County,9,534,257,277
Nebraska,Hamilton County,10,586,298,288
Nebraska,Hamilton County,11,689,348,341
Nebraska,Hamilton County,12,710,345,365
Nebraska,Hamilton County,13,628,318,310
Nebraska,Hamilton County,14,480,240,240
Nebraska,Hamilton County,15,364,159,205
Nebraska,Hamilton County,16,297,154,143
Nebraska,Hamilton County,17,217,90,127
Nebraska,Hamilton County,18,265,91,174
Nebraska,Harlan County,0,3492,1797,1695
Nebraska,Harlan County,1,236,132,104
Nebraska,Harlan County,2,212,109,103
Nebraska,Harlan County,3,190,98,92
Nebraska,Harlan County,4,192,94,98
Nebraska,Harlan County,5,165,78,87
Nebraska,Harlan County,6,123,67,56
Nebraska,Harlan County,7,153,70,83
Nebraska,Harlan County,8,149,80,69
Nebraska,Harlan County,9,177,91,86
Nebraska,Harlan County,10,193,106,87
Nebraska,Harlan County,11,284,154,130
Nebraska,Harlan County,12,279,134,145
Nebraska,Harlan County,13,292,159,133
Nebraska,Harlan County,14,247,126,121
Nebraska,Harlan County,15,224,110,114
Nebraska,Harlan County,16,161,86,75
Nebraska,Harlan County,17,100,54,46
Nebraska,Harlan County,18,115,49,66
Nebraska,Hayes County,0,933,483,450
Nebraska,Hayes County,1,44,14,30
Nebraska,Hayes County,2,52,30,22
Nebraska,Hayes County,3,58,28,30
Nebraska,Hayes County,4,56,34,22
Nebraska,Hayes County,5,45,23,22
Nebraska,Hayes County,6,50,28,22
Nebraska,Hayes County,7,43,23,20
Nebraska,Hayes County,8,42,23,19
Nebraska,Hayes County,9,27,11,16
Nebraska,Hayes County,10,36,18,18
Nebraska,Hayes County,11,76,41,35
Nebraska,Hayes County,12,96,55,41
Nebraska,Hayes County,13,77,36,41
Nebraska,Hayes County,14,59,36,23
Nebraska,Hayes County,15,51,21,30
Nebraska,Hayes County,16,50,24,26
Nebraska,Hayes County,17,40,22,18
Nebraska,Hayes County,18,31,16,15
Nebraska,Hitchcock County,0,2901,1461,1440
Nebraska,Hitchcock County,1,164,89,75
Nebraska,Hitchcock County,2,185,104,81
Nebraska,Hitchcock County,3,186,94,92
Nebraska,Hitchcock County,4,142,76,66
Nebraska,Hitchcock County,5,127,59,68
Nebraska,Hitchcock County,6,125,66,59
Nebraska,Hitchcock County,7,181,84,97
Nebraska,Hitchcock County,8,134,74,60
Nebraska,Hitchcock County,9,146,77,69
Nebraska,Hitchcock County,10,143,65,78
Nebraska,Hitchcock County,11,220,113,107
Nebraska,Hitchcock County,12,225,114,111
Nebraska,Hitchcock County,13,234,114,120
Nebraska,Hitchcock County,14,200,108,92
Nebraska,Hitchcock County,15,145,74,71
Nebraska,Hitchcock County,16,144,64,80
Nebraska,Hitchcock County,17,96,39,57
Nebraska,Hitchcock County,18,104,47,57
Nebraska,Holt County,0,10403,5144,5259
Nebraska,Holt County,1,743,372,371
Nebraska,Holt County,2,711,361,350
Nebraska,Holt County,3,640,313,327
Nebraska,Holt County,4,632,322,310
Nebraska,Holt County,5,471,254,217
Nebraska,Holt County,6,456,237,219
Nebraska,Holt County,7,540,257,283
Nebraska,Holt County,8,518,282,236
Nebraska,Holt County,9,470,244,226
Nebraska,Holt County,10,556,267,289
Nebraska,Holt County,11,859,425,434
Nebraska,Holt County,12,880,449,431
Nebraska,Holt County,13,762,393,369
Nebraska,Holt County,14,572,289,283
Nebraska,Holt County,15,479,228,251
Nebraska,Holt County,16,419,177,242
Nebraska,Holt County,17,325,139,186
Nebraska,Holt County,18,370,135,235
Nebraska,Hooker County,0,728,352,376
Nebraska,Hooker County,1,45,26,19
Nebraska,Hooker County,2,32,15,17
Nebraska,Hooker County,3,41,25,16
Nebraska,Hooker County,4,42,18,24
Nebraska,Hooker County,5,26,12,14
Nebraska,Hooker County,6,28,16,12
Nebraska,Hooker County,7,27,9,18
Nebraska,Hooker County,8,40,25,15
Nebraska,Hooker County,9,38,19,19
Nebraska,Hooker County,10,32,15,17
Nebraska,Hooker County,11,42,22,20
Nebraska,Hooker County,12,60,26,34
Nebraska,Hooker County,13,64,34,30
Nebraska,Hooker County,14,50,24,26
Nebraska,Hooker County,15,45,24,21
Nebraska,Hooker County,16,30,10,20
Nebraska,Hooker County,17,28,15,13
Nebraska,Hooker County,18,58,17,41
Nebraska,Howard County,0,6362,3234,3128
Nebraska,Howard County,1,376,197,179
Nebraska,Howard County,2,445,229,216
Nebraska,Howard County,3,438,234,204
Nebraska,Howard County,4,381,208,173
Nebraska,Howard County,5,318,171,147
Nebraska,Howard County,6,304,154,150
Nebraska,Howard County,7,343,183,160
Nebraska,Howard County,8,360,184,176
Nebraska,Howard County,9,373,195,178
Nebraska,Howard County,10,402,183,219
Nebraska,Howard County,11,476,236,240
Nebraska,Howard County,12,457,246,211
Nebraska,Howard County,13,406,203,203
Nebraska,Howard County,14,416,197,219
Nebraska,Howard County,15,272,140,132
Nebraska,Howard County,16,221,107,114
Nebraska,Howard County,17,180,82,98
Nebraska,Howard County,18,194,85,109
Nebraska,Jefferson County,0,7335,3646,3689
Nebraska,Jefferson County,1,409,213,196
Nebraska,Jefferson County,2,464,241,223
Nebraska,Jefferson County,3,476,227,249
Nebraska,Jefferson County,4,401,209,192
Nebraska,Jefferson County,5,315,158,157
Nebraska,Jefferson County,6,359,187,172
Nebraska,Jefferson County,7,386,201,185
Nebraska,Jefferson County,8,360,195,165
Nebraska,Jefferson County,9,388,199,189
Nebraska,Jefferson County,10,410,185,225
Nebraska,Jefferson County,11,513,264,249
Nebraska,Jefferson County,12,623,329,294
Nebraska,Jefferson County,13,580,301,279
Nebraska,Jefferson County,14,478,227,251
Nebraska,Jefferson County,15,337,158,179
Nebraska,Jefferson County,16,307,141,166
Nebraska,Jefferson County,17,243,107,136
Nebraska,Jefferson County,18,286,104,182
Nebraska,Johnson County,0,5185,3084,2101
Nebraska,Johnson County,1,248,126,122
Nebraska,Johnson County,2,289,141,148
Nebraska,Johnson County,3,302,169,133
Nebraska,Johnson County,4,276,140,136
Nebraska,Johnson County,5,310,220,90
Nebraska,Johnson County,6,311,232,79
Nebraska,Johnson County,7,401,301,100
Nebraska,Johnson County,8,383,265,118
Nebraska,Johnson County,9,304,206,98
Nebraska,Johnson County,10,339,226,113
Nebraska,Johnson County,11,433,259,174
Nebraska,Johnson County,12,402,227,175
Nebraska,Johnson County,13,310,175,135
Nebraska,Johnson County,14,248,135,113
Nebraska,Johnson County,15,177,81,96
Nebraska,Johnson County,16,171,87,84
Nebraska,Johnson County,17,116,41,75
Nebraska,Johnson County,18,165,53,112
Nebraska,Kearney County,0,6644,3263,3381
Nebraska,Kearney County,1,415,204,211
Nebraska,Kearney County,2,499,244,255
Nebraska,Kearney County,3,434,210,224
Nebraska,Kearney County,4,413,217,196
Nebraska,Kearney County,5,339,176,163
Nebraska,Kearney County,6,322,150,172
Nebraska,Kearney County,7,386,205,181
Nebraska,Kearney County,8,369,190,179
Nebraska,Kearney County,9,395,200,195
Nebraska,Kearney County,10,376,197,179
Nebraska,Kearney County,11,500,248,252
Nebraska,Kearney County,12,487,246,241
Nebraska,Kearney County,13,457,225,232
Nebraska,Kearney County,14,341,165,176
Nebraska,Kearney County,15,286,139,147
Nebraska,Kearney County,16,236,103,133
Nebraska,Kearney County,17,180,67,113
Nebraska,Kearney County,18,209,77,132
Nebraska,Keith County,0,8121,4060,4061
Nebraska,Keith County,1,364,183,181
Nebraska,Keith County,2,486,252,234
Nebraska,Keith County,3,506,249,257
Nebraska,Keith County,4,478,260,218
Nebraska,Keith County,5,374,195,179
Nebraska,Keith County,6,376,195,181
Nebraska,Keith County,7,408,204,204
Nebraska,Keith County,8,414,214,200
Nebraska,Keith County,9,423,206,217
Nebraska,Keith County,10,449,234,215
Nebraska,Keith County,11,655,339,316
Nebraska,Keith County,12,661,335,326
Nebraska,Keith County,13,643,305,338
Nebraska,Keith County,14,627,305,322
Nebraska,Keith County,15,467,231,236
Nebraska,Keith County,16,337,164,173
Nebraska,Keith County,17,247,114,133
Nebraska,Keith County,18,206,75,131
Nebraska,Keya Paha County,0,810,396,414
Nebraska,Keya Paha County,1,47,18,29
Nebraska,Keya Paha County,2,46,21,25
Nebraska,Keya Paha County,3,41,17,24
Nebraska,Keya Paha County,4,41,27,14
Nebraska,Keya Paha County,5,31,9,22
Nebraska,Keya Paha County,6,17,8,9
Nebraska,Keya Paha County,7,44,24,20
Nebraska,Keya Paha County,8,43,22,21
Nebraska,Keya Paha County,9,31,14,17
Nebraska,Keya Paha County,10,34,19,15
Nebraska,Keya Paha County,11,73,38,35
Nebraska,Keya Paha County,12,81,41,40
Nebraska,Keya Paha County,13,52,31,21
Nebraska,Keya Paha County,14,65,29,36
Nebraska,Keya Paha County,15,37,19,18
Nebraska,Keya Paha County,16,60,31,29
Nebraska,Keya Paha County,17,31,15,16
Nebraska,Keya Paha County,18,36,13,23
Nebraska,Kimball County,0,3713,1881,1832
Nebraska,Kimball County,1,217,115,102
Nebraska,Kimball County,2,229,110,119
Nebraska,Kimball County,3,235,134,101
Nebraska,Kimball County,4,219,123,96
Nebraska,Kimball County,5,186,106,80
Nebraska,Kimball County,6,210,110,100
Nebraska,Kimball County,7,190,95,95
Nebraska,Kimball County,8,165,90,75
Nebraska,Kimball County,9,176,89,87
Nebraska,Kimball County,10,219,120,99
Nebraska,Kimball County,11,253,109,144
Nebraska,Kimball County,12,327,187,140
Nebraska,Kimball County,13,244,116,128
Nebraska,Kimball County,14,211,100,111
Nebraska,Kimball County,15,222,100,122
Nebraska,Kimball County,16,158,79,79
Nebraska,Kimball County,17,124,50,74
Nebraska,Kimball County,18,128,48,80
Nebraska,Knox County,0,8482,4147,4335
Nebraska,Knox County,1,521,250,271
Nebraska,Knox County,2,571,288,283
Nebraska,Knox County,3,587,287,300
Nebraska,Knox County,4,573,300,273
Nebraska,Knox County,5,354,179,175
Nebraska,Knox County,6,314,161,153
Nebraska,Knox County,7,394,221,173
Nebraska,Knox County,8,378,189,189
Nebraska,Knox County,9,413,215,198
Nebraska,Knox County,10,472,236,236
Nebraska,Knox County,11,605,310,295
Nebraska,Knox County,12,674,351,323
Nebraska,Knox County,13,607,290,317
Nebraska,Knox County,14,545,275,270
Nebraska,Knox County,15,407,200,207
Nebraska,Knox County,16,397,165,232
Nebraska,Knox County,17,309,128,181
Nebraska,Knox County,18,361,102,259
Nebraska,Lancaster County,0,301795,151024,150771
Nebraska,Lancaster County,1,20219,10273,9946
Nebraska,Lancaster County,2,20244,10286,9958
Nebraska,Lancaster County,3,18841,9650,9191
Nebraska,Lancaster County,4,21788,10881,10907
Nebraska,Lancaster County,5,34750,17697,17053
Nebraska,Lancaster County,6,21246,11396,9850
Nebraska,Lancaster County,7,22057,11357,10700
Nebraska,Lancaster County,8,19073,10089,8984
Nebraska,Lancaster County,9,17392,8946,8446
Nebraska,Lancaster County,10,16453,8462,7991
Nebraska,Lancaster County,11,18340,9018,9322
Nebraska,Lancaster County,12,18208,8906,9302
Nebraska,Lancaster County,13,16623,7956,8667
Nebraska,Lancaster County,14,12544,5998,6546
Nebraska,Lancaster County,15,8160,3795,4365
Nebraska,Lancaster County,16,5943,2630,3313
Nebraska,Lancaster County,17,4682,1903,2779
Nebraska,Lancaster County,18,5232,1781,3451
Nebraska,Lincoln County,0,35815,17725,18090
Nebraska,Lincoln County,1,2263,1142,1121
Nebraska,Lincoln County,2,2582,1292,1290
Nebraska,Lincoln County,3,2497,1279,1218
Nebraska,Lincoln County,4,2237,1173,1064
Nebraska,Lincoln County,5,1959,1002,957
Nebraska,Lincoln County,6,1963,958,1005
Nebraska,Lincoln County,7,2243,1138,1105
Nebraska,Lincoln County,8,2159,1060,1099
Nebraska,Lincoln County,9,2212,1151,1061
Nebraska,Lincoln County,10,2029,1032,997
Nebraska,Lincoln County,11,2447,1194,1253
Nebraska,Lincoln County,12,2640,1330,1310
Nebraska,Lincoln County,13,2463,1228,1235
Nebraska,Lincoln County,14,1898,943,955
Nebraska,Lincoln County,15,1400,685,715
Nebraska,Lincoln County,16,1065,463,602
Nebraska,Lincoln County,17,841,334,507
Nebraska,Lincoln County,18,917,321,596
Nebraska,Logan County,0,750,373,377
Nebraska,Logan County,1,45,19,26
Nebraska,Logan County,2,61,31,30
Nebraska,Logan County,3,50,21,29
Nebraska,Logan County,4,40,17,23
Nebraska,Logan County,5,38,20,18
Nebraska,Logan County,6,39,22,17
Nebraska,Logan County,7,45,24,21
Nebraska,Logan County,8,39,22,17
Nebraska,Logan County,9,43,21,22
Nebraska,Logan County,10,41,19,22
Nebraska,Logan County,11,50,25,25
Nebraska,Logan County,12,59,36,23
Nebraska,Logan County,13,62,27,35
Nebraska,Logan County,14,40,21,19
Nebraska,Logan County,15,35,16,19
Nebraska,Logan County,16,25,14,11
Nebraska,Logan County,17,21,10,11
Nebraska,Logan County,18,17,8,9
Nebraska,Loup County,0,588,304,284
Nebraska,Loup County,1,24,10,14
Nebraska,Loup County,2,29,17,12
Nebraska,Loup County,3,38,22,16
Nebraska,Loup County,4,39,19,20
Nebraska,Loup County,5,18,8,10
Nebraska,Loup County,6,32,20,12
Nebraska,Loup County,7,17,11,6
Nebraska,Loup County,8,19,9,10
Nebraska,Loup County,9,26,14,12
Nebraska,Loup County,10,26,9,17
Nebraska,Loup County,11,50,25,25
Nebraska,Loup County,12,70,35,35
Nebraska,Loup County,13,54,28,26
Nebraska,Loup County,14,47,22,25
Nebraska,Loup County,15,43,24,19
Nebraska,Loup County,16,28,16,12
Nebraska,Loup County,17,14,8,6
Nebraska,Loup County,18,14,7,7
Nebraska,McPherson County,0,498,249,249
Nebraska,McPherson County,1,19,8,11
Nebraska,McPherson County,2,41,19,22
Nebraska,McPherson County,3,38,20,18
Nebraska,McPherson County,4,36,19,17
Nebraska,McPherson County,5,17,7,10
Nebraska,McPherson County,6,20,13,7
Nebraska,McPherson County,7,22,8,14
Nebraska,McPherson County,8,22,11,11
Nebraska,McPherson County,9,25,16,9
Nebraska,McPherson County,10,33,18,15
Nebraska,McPherson County,11,44,21,23
Nebraska,McPherson County,12,47,18,29
Nebraska,McPherson County,13,35,23,12
Nebraska,McPherson County,14,27,10,17
Nebraska,McPherson County,15,20,10,10
Nebraska,McPherson County,16,18,7,11
Nebraska,McPherson County,17,18,11,7
Nebraska,McPherson County,18,16,10,6
Nebraska,Madison County,0,35174,17440,17734
Nebraska,Madison County,1,2575,1261,1314
Nebraska,Madison County,2,2439,1239,1200
Nebraska,Madison County,3,2251,1155,1096
Nebraska,Madison County,4,2424,1240,1184
Nebraska,Madison County,5,2573,1364,1209
Nebraska,Madison County,6,2280,1164,1116
Nebraska,Madison County,7,2225,1149,1076
Nebraska,Madison County,8,1974,968,1006
Nebraska,Madison County,9,1784,899,885
Nebraska,Madison County,10,1926,961,965
Nebraska,Madison County,11,2539,1269,1270
Nebraska,Madison County,12,2683,1360,1323
Nebraska,Madison County,13,2030,1023,1007
Nebraska,Madison County,14,1547,751,796
Nebraska,Madison County,15,1186,540,646
Nebraska,Madison County,16,928,417,511
Nebraska,Madison County,17,797,308,489
Nebraska,Madison County,18,1013,372,641
Nebraska,Merrick County,0,7766,3873,3893
Nebraska,Merrick County,1,437,191,246
Nebraska,Merrick County,2,485,255,230
Nebraska,Merrick County,3,545,275,270
Nebraska,Merrick County,4,524,272,252
Nebraska,Merrick County,5,411,221,190
Nebraska,Merrick County,6,379,194,185
Nebraska,Merrick County,7,451,224,227
Nebraska,Merrick County,8,408,195,213
Nebraska,Merrick County,9,445,225,220
Nebraska,Merrick County,10,484,251,233
Nebraska,Merrick County,11,637,334,303
Nebraska,Merrick County,12,547,286,261
Nebraska,Merrick County,13,550,281,269
Nebraska,Merrick County,14,415,214,201
Nebraska,Merrick County,15,329,158,171
Nebraska,Merrick County,16,291,132,159
Nebraska,Merrick County,17,223,97,126
Nebraska,Merrick County,18,205,68,137
Nebraska,Morrill County,0,4862,2466,2396
Nebraska,Morrill County,1,261,147,114
Nebraska,Morrill County,2,352,180,172
Nebraska,Morrill County,3,367,190,177
Nebraska,Morrill County,4,320,160,160
Nebraska,Morrill County,5,238,121,117
Nebraska,Morrill County,6,235,121,114
Nebraska,Morrill County,7,271,134,137
Nebraska,Morrill County,8,281,144,137
Nebraska,Morrill County,9,301,141,160
Nebraska,Morrill County,10,264,151,113
Nebraska,Morrill County,11,345,166,179
Nebraska,Morrill County,12,384,200,184
Nebraska,Morrill County,13,360,192,168
Nebraska,Morrill County,14,223,124,99
Nebraska,Morrill County,15,223,110,113
Nebraska,Morrill County,16,164,72,92
Nebraska,Morrill County,17,132,63,69
Nebraska,Morrill County,18,141,50,91
Nebraska,Nance County,0,3570,1790,1780
Nebraska,Nance County,1,222,125,97
Nebraska,Nance County,2,214,111,103
Nebraska,Nance County,3,223,114,109
Nebraska,Nance County,4,213,108,105
Nebraska,Nance County,5,170,87,83
Nebraska,Nance County,6,165,87,78
Nebraska,Nance County,7,188,99,89
Nebraska,Nance County,8,184,99,85
Nebraska,Nance County,9,183,87,96
Nebraska,Nance County,10,177,86,91
Nebraska,Nance County,11,300,156,144
Nebraska,Nance County,12,311,167,144
Nebraska,Nance County,13,286,151,135
Nebraska,Nance County,14,199,101,98
Nebraska,Nance County,15,139,65,74
Nebraska,Nance County,16,131,48,83
Nebraska,Nance County,17,125,46,79
Nebraska,Nance County,18,140,53,87
Nebraska,Nemaha County,0,7175,3534,3641
Nebraska,Nemaha County,1,436,216,220
Nebraska,Nemaha County,2,444,226,218
Nebraska,Nemaha County,3,412,190,222
Nebraska,Nemaha County,4,584,272,312
Nebraska,Nemaha County,5,581,308,273
Nebraska,Nemaha County,6,438,247,191
Nebraska,Nemaha County,7,447,233,214
Nebraska,Nemaha County,8,331,176,155
Nebraska,Nemaha County,9,317,152,165
Nebraska,Nemaha County,10,387,193,194
Nebraska,Nemaha County,11,497,234,263
Nebraska,Nemaha County,12,502,244,258
Nebraska,Nemaha County,13,506,256,250
Nebraska,Nemaha County,14,379,198,181
Nebraska,Nemaha County,15,289,141,148
Nebraska,Nemaha County,16,230,100,130
Nebraska,Nemaha County,17,178,74,104
Nebraska,Nemaha County,18,217,74,143
Nebraska,Nuckolls County,0,4369,2173,2196
Nebraska,Nuckolls County,1,189,87,102
Nebraska,Nuckolls County,2,251,127,124
Nebraska,Nuckolls County,3,290,155,135
Nebraska,Nuckolls County,4,260,138,122
Nebraska,Nuckolls County,5,187,99,88
Nebraska,Nuckolls County,6,173,87,86
Nebraska,Nuckolls County,7,225,117,108
Nebraska,Nuckolls County,8,190,106,84
Nebraska,Nuckolls County,9,223,113,110
Nebraska,Nuckolls County,10,222,117,105
Nebraska,Nuckolls County,11,309,147,162
Nebraska,Nuckolls County,12,389,200,189
Nebraska,Nuckolls County,13,318,159,159
Nebraska,Nuckolls County,14,293,143,150
Nebraska,Nuckolls County,15,256,115,141
Nebraska,Nuckolls County,16,220,93,127
Nebraska,Nuckolls County,17,193,81,112
Nebraska,Nuckolls County,18,181,89,92
Nebraska,Otoe County,0,15797,7779,8018
Nebraska,Otoe County,1,963,492,471
Nebraska,Otoe County,2,1042,556,486
Nebraska,Otoe County,3,1033,506,527
Nebraska,Otoe County,4,1001,511,490
Nebraska,Otoe County,5,804,435,369
Nebraska,Otoe County,6,810,411,399
Nebraska,Otoe County,7,844,415,429
Nebraska,Otoe County,8,838,406,432
Nebraska,Otoe County,9,955,492,463
Nebraska,Otoe County,10,931,472,459
Nebraska,Otoe County,11,1227,630,597
Nebraska,Otoe County,12,1215,597,618
Nebraska,Otoe County,13,991,495,496
Nebraska,Otoe County,14,875,426,449
Nebraska,Otoe County,15,681,323,358
Nebraska,Otoe County,16,510,238,272
Nebraska,Otoe County,17,434,169,265
Nebraska,Otoe County,18,643,205,438
Nebraska,Pawnee County,0,2702,1348,1354
Nebraska,Pawnee County,1,147,79,68
Nebraska,Pawnee County,2,174,93,81
Nebraska,Pawnee County,3,158,82,76
Nebraska,Pawnee County,4,171,88,83
Nebraska,Pawnee County,5,129,64,65
Nebraska,Pawnee County,6,105,55,50
Nebraska,Pawnee County,7,120,63,57
Nebraska,Pawnee County,8,107,51,56
Nebraska,Pawnee County,9,138,67,71
Nebraska,Pawnee County,10,156,79,77
Nebraska,Pawnee County,11,186,85,101
Nebraska,Pawnee County,12,216,116,100
Nebraska,Pawnee County,13,203,107,96
Nebraska,Pawnee County,14,177,96,81
Nebraska,Pawnee County,15,145,71,74
Nebraska,Pawnee County,16,123,54,69
Nebraska,Pawnee County,17,97,41,56
Nebraska,Pawnee County,18,150,57,93
Nebraska,Perkins County,0,2891,1466,1425
Nebraska,Perkins County,1,191,96,95
Nebraska,Perkins County,2,197,101,96
Nebraska,Perkins County,3,202,126,76
Nebraska,Perkins County,4,167,99,68
Nebraska,Perkins County,5,115,61,54
Nebraska,Perkins County,6,137,74,63
Nebraska,Perkins County,7,149,79,70
Nebraska,Perkins County,8,163,86,77
Nebraska,Perkins County,9,142,65,77
Nebraska,Perkins County,10,152,74,78
Nebraska,Perkins County,11,204,101,103
Nebraska,Perkins County,12,219,106,113
Nebraska,Perkins County,13,220,116,104
Nebraska,Perkins County,14,174,90,84
Nebraska,Perkins County,15,124,68,56
Nebraska,Perkins County,16,121,48,73
Nebraska,Perkins County,17,69,29,40
Nebraska,Perkins County,18,145,47,98
Nebraska,Phelps County,0,9187,4570,4617
Nebraska,Phelps County,1,642,319,323
Nebraska,Phelps County,2,594,322,272
Nebraska,Phelps County,3,595,299,296
Nebraska,Phelps County,4,569,300,269
Nebraska,Phelps County,5,526,278,248
Nebraska,Phelps County,6,465,237,228
Nebraska,Phelps County,7,555,306,249
Nebraska,Phelps County,8,424,226,198
Nebraska,Phelps County,9,535,271,264
Nebraska,Phelps County,10,531,259,272
Nebraska,Phelps County,11,704,348,356
Nebraska,Phelps County,12,634,336,298
Nebraska,Phelps County,13,569,288,281
Nebraska,Phelps County,14,490,222,268
Nebraska,Phelps County,15,373,168,205
Nebraska,Phelps County,16,349,152,197
Nebraska,Phelps County,17,279,118,161
Nebraska,Phelps County,18,353,121,232
Nebraska,Pierce County,0,7202,3636,3566
Nebraska,Pierce County,1,438,225,213
Nebraska,Pierce County,2,508,260,248
Nebraska,Pierce County,3,516,272,244
Nebraska,Pierce County,4,506,268,238
Nebraska,Pierce County,5,373,199,174
Nebraska,Pierce County,6,339,175,164
Nebraska,Pierce County,7,428,234,194
Nebraska,Pierce County,8,362,189,173
Nebraska,Pierce County,9,413,206,207
Nebraska,Pierce County,10,432,203,229
Nebraska,Pierce County,11,615,312,303
Nebraska,Pierce County,12,537,281,256
Nebraska,Pierce County,13,438,226,212
Nebraska,Pierce County,14,345,174,171
Nebraska,Pierce County,15,307,153,154
Nebraska,Pierce County,16,240,102,138
Nebraska,Pierce County,17,181,65,116
Nebraska,Pierce County,18,224,92,132
Nebraska,Platte County,0,32666,16519,16147
Nebraska,Platte County,1,2431,1286,1145
Nebraska,Platte County,2,2337,1214,1123
Nebraska,Platte County,3,2335,1196,1139
Nebraska,Platte County,4,2209,1132,1077
Nebraska,Platte County,5,2052,1080,972
Nebraska,Platte County,6,1865,1005,860
Nebraska,Platte County,7,1993,1038,955
Nebraska,Platte County,8,1894,987,907
Nebraska,Platte County,9,1820,955,865
Nebraska,Platte County,10,1931,994,937
Nebraska,Platte County,11,2341,1150,1191
Nebraska,Platte County,12,2389,1225,1164
Nebraska,Platte County,13,1931,970,961
Nebraska,Platte County,14,1465,722,743
Nebraska,Platte County,15,1141,521,620
Nebraska,Platte County,16,945,428,517
Nebraska,Platte County,17,748,310,438
Nebraska,Platte County,18,839,306,533
Nebraska,Polk County,0,5271,2625,2646
Nebraska,Polk County,1,298,148,150
Nebraska,Polk County,2,353,167,186
Nebraska,Polk County,3,343,179,164
Nebraska,Polk County,4,353,183,170
Nebraska,Polk County,5,251,118,133
Nebraska,Polk County,6,219,120,99
Nebraska,Polk County,7,250,126,124
Nebraska,Polk County,8,252,122,130
Nebraska,Polk County,9,321,156,165
Nebraska,Polk County,10,327,180,147
Nebraska,Polk County,11,381,201,180
Nebraska,Polk County,12,425,207,218
Nebraska,Polk County,13,432,225,207
Nebraska,Polk County,14,309,165,144
Nebraska,Polk County,15,224,106,118
Nebraska,Polk County,16,184,89,95
Nebraska,Polk County,17,145,60,85
Nebraska,Polk County,18,204,73,131
Nebraska,Red Willow County,0,10867,5432,5435
Nebraska,Red Willow County,1,666,324,342
Nebraska,Red Willow County,2,645,315,330
Nebraska,Red Willow County,3,706,356,350
Nebraska,Red Willow County,4,754,423,331
Nebraska,Red Willow County,5,718,398,320
Nebraska,Red Willow County,6,582,309,273
Nebraska,Red Willow County,7,644,357,287
Nebraska,Red Willow County,8,557,267,290
Nebraska,Red Willow County,9,571,278,293
Nebraska,Red Willow County,10,574,308,266
Nebraska,Red Willow County,11,819,392,427
Nebraska,Red Willow County,12,818,414,404
Nebraska,Red Willow County,13,758,373,385
Nebraska,Red Willow County,14,501,258,243
Nebraska,Red Willow County,15,455,214,241
Nebraska,Red Willow County,16,406,184,222
Nebraska,Red Willow County,17,316,125,191
Nebraska,Red Willow County,18,377,137,240
Nebraska,Richardson County,0,8128,4032,4096
Nebraska,Richardson County,1,423,215,208
Nebraska,Richardson County,2,446,238,208
Nebraska,Richardson County,3,507,281,226
Nebraska,Richardson County,4,476,240,236
Nebraska,Richardson County,5,399,202,197
Nebraska,Richardson County,6,372,183,189
Nebraska,Richardson County,7,400,204,196
Nebraska,Richardson County,8,372,205,167
Nebraska,Richardson County,9,422,200,222
Nebraska,Richardson County,10,473,242,231
Nebraska,Richardson County,11,657,332,325
Nebraska,Richardson County,12,657,321,336
Nebraska,Richardson County,13,593,308,285
Nebraska,Richardson County,14,496,240,256
Nebraska,Richardson County,15,424,210,214
Nebraska,Richardson County,16,348,168,180
Nebraska,Richardson County,17,284,116,168
Nebraska,Richardson County,18,379,127,252
Nebraska,Rock County,0,1443,725,718
Nebraska,Rock County,1,69,41,28
Nebraska,Rock County,2,91,49,42
Nebraska,Rock County,3,87,47,40
Nebraska,Rock County,4,79,45,34
Nebraska,Rock County,5,55,25,30
Nebraska,Rock County,6,76,37,39
Nebraska,Rock County,7,74,42,32
Nebraska,Rock County,8,80,36,44
Nebraska,Rock County,9,56,28,28
Nebraska,Rock County,10,54,26,28
Nebraska,Rock County,11,114,53,61
Nebraska,Rock County,12,153,85,68
Nebraska,Rock County,13,140,67,73
Nebraska,Rock County,14,96,48,48
Nebraska,Rock County,15,57,32,25
Nebraska,Rock County,16,46,19,27
Nebraska,Rock County,17,47,22,25
Nebraska,Rock County,18,69,23,46
Nebraska,Saline County,0,14252,7240,7012
Nebraska,Saline County,1,989,491,498
Nebraska,Saline County,2,993,521,472
Nebraska,Saline County,3,927,464,463
Nebraska,Saline County,4,1207,607,600
Nebraska,Saline County,5,1239,659,580
Nebraska,Saline County,6,736,422,314
Nebraska,Saline County,7,825,441,384
Nebraska,Saline County,8,812,424,388
Nebraska,Saline County,9,862,431,431
Nebraska,Saline County,10,833,427,406
Nebraska,Saline County,11,973,517,456
Nebraska,Saline County,12,932,473,459
Nebraska,Saline County,13,791,406,385
Nebraska,Saline County,14,632,309,323
Nebraska,Saline County,15,435,214,221
Nebraska,Saline County,16,342,167,175
Nebraska,Saline County,17,336,134,202
Nebraska,Saline County,18,388,133,255
Nebraska,Sarpy County,0,172193,86217,85976
Nebraska,Sarpy County,1,13345,6949,6396
Nebraska,Sarpy County,2,14052,7295,6757
Nebraska,Sarpy County,3,13640,6883,6757
Nebraska,Sarpy County,4,11282,5910,5372
Nebraska,Sarpy County,5,11080,5933,5147
Nebraska,Sarpy County,6,12345,6357,5988
Nebraska,Sarpy County,7,13523,6763,6760
Nebraska,Sarpy County,8,12310,6076,6234
Nebraska,Sarpy County,9,11915,5996,5919
Nebraska,Sarpy County,10,11274,5657,5617
Nebraska,Sarpy County,11,11845,5869,5976
Nebraska,Sarpy County,12,9965,4898,5067
Nebraska,Sarpy County,13,7992,3748,4244
Nebraska,Sarpy County,14,6296,3042,3254
Nebraska,Sarpy County,15,4214,1965,2249
Nebraska,Sarpy County,16,3223,1404,1819
Nebraska,Sarpy County,17,2045,881,1164
Nebraska,Sarpy County,18,1847,591,1256
Nebraska,Saunders County,0,20919,10576,10343
Nebraska,Saunders County,1,1288,672,616
Nebraska,Saunders County,2,1437,767,670
Nebraska,Saunders County,3,1555,825,730
Nebraska,Saunders County,4,1403,719,684
Nebraska,Saunders County,5,1078,562,516
Nebraska,Saunders County,6,952,477,475
Nebraska,Saunders County,7,1217,604,613
Nebraska,Saunders County,8,1129,569,560
Nebraska,Saunders County,9,1154,589,565
Nebraska,Saunders County,10,1414,700,714
Nebraska,Saunders County,11,1766,904,862
Nebraska,Saunders County,12,1526,789,737
Nebraska,Saunders County,13,1366,689,677
Nebraska,Saunders County,14,1155,613,542
Nebraska,Saunders County,15,823,408,415
Nebraska,Saunders County,16,682,325,357
Nebraska,Saunders County,17,496,205,291
Nebraska,Saunders County,18,478,159,319
Nebraska,Scotts Bluff County,0,36465,17663,18802
Nebraska,Scotts Bluff County,1,2479,1240,1239
Nebraska,Scotts Bluff County,2,2612,1295,1317
Nebraska,Scotts Bluff County,3,2503,1264,1239
Nebraska,Scotts Bluff County,4,2229,1129,1100
Nebraska,Scotts Bluff County,5,2238,1136,1102
Nebraska,Scotts Bluff County,6,2053,1017,1036
Nebraska,Scotts Bluff County,7,2308,1124,1184
Nebraska,Scotts Bluff County,8,2092,1062,1030
Nebraska,Scotts Bluff County,9,2036,1027,1009
Nebraska,Scotts Bluff County,10,1944,961,983
Nebraska,Scotts Bluff County,11,2472,1207,1265
Nebraska,Scotts Bluff County,12,2618,1261,1357
Nebraska,Scotts Bluff County,13,2435,1165,1270
Nebraska,Scotts Bluff County,14,1871,893,978
Nebraska,Scotts Bluff County,15,1448,646,802
Nebraska,Scotts Bluff County,16,1141,505,636
Nebraska,Scotts Bluff County,17,908,358,550
Nebraska,Scotts Bluff County,18,1078,373,705
Nebraska,Seward County,0,17150,8770,8380
Nebraska,Seward County,1,1010,549,461
Nebraska,Seward County,2,1087,577,510
Nebraska,Seward County,3,1172,572,600
Nebraska,Seward County,4,1555,848,707
Nebraska,Seward County,5,1485,828,657
Nebraska,Seward County,6,833,446,387
Nebraska,Seward County,7,934,490,444
Nebraska,Seward County,8,922,464,458
Nebraska,Seward County,9,909,464,445
Nebraska,Seward County,10,973,493,480
Nebraska,Seward County,11,1216,608,608
Nebraska,Seward County,12,1190,610,580
Nebraska,Seward County,13,1013,504,509
Nebraska,Seward County,14,849,431,418
Nebraska,Seward County,15,629,324,305
Nebraska,Seward County,16,546,253,293
Nebraska,Seward County,17,364,149,215
Nebraska,Seward County,18,463,160,303
Nebraska,Sheridan County,0,5259,2578,2681
Nebraska,Sheridan County,1,256,139,117
Nebraska,Sheridan County,2,358,174,184
Nebraska,Sheridan County,3,365,194,171
Nebraska,Sheridan County,4,321,168,153
Nebraska,Sheridan County,5,203,108,95
Nebraska,Sheridan County,6,227,101,126
Nebraska,Sheridan County,7,300,161,139
Nebraska,Sheridan County,8,261,136,125
Nebraska,Sheridan County,9,274,126,148
Nebraska,Sheridan County,10,276,151,125
Nebraska,Sheridan County,11,315,168,147
Nebraska,Sheridan County,12,424,187,237
Nebraska,Sheridan County,13,450,231,219
Nebraska,Sheridan County,14,328,167,161
Nebraska,Sheridan County,15,269,110,159
Nebraska,Sheridan County,16,221,96,125
Nebraska,Sheridan County,17,191,82,109
Nebraska,Sheridan County,18,220,79,141
Nebraska,Sherman County,0,3074,1515,1559
Nebraska,Sherman County,1,158,91,67
Nebraska,Sherman County,2,182,91,91
Nebraska,Sherman County,3,199,95,104
Nebraska,Sherman County,4,160,84,76
Nebraska,Sherman County,5,137,78,59
Nebraska,Sherman County,6,109,53,56
Nebraska,Sherman County,7,129,67,62
Nebraska,Sherman County,8,130,71,59
Nebraska,Sherman County,9,163,81,82
Nebraska,Sherman County,10,177,83,94
Nebraska,Sherman County,11,221,110,111
Nebraska,Sherman County,12,258,128,130
Nebraska,Sherman County,13,248,137,111
Nebraska,Sherman County,14,213,109,104
Nebraska,Sherman County,15,164,66,98
Nebraska,Sherman County,16,159,66,93
Nebraska,Sherman County,17,141,53,88
Nebraska,Sherman County,18,126,52,74
Nebraska,Sioux County,0,1303,659,644
Nebraska,Sioux County,1,71,36,35
Nebraska,Sioux County,2,74,40,34
Nebraska,Sioux County,3,87,38,49
Nebraska,Sioux County,4,75,38,37
Nebraska,Sioux County,5,56,27,29
Nebraska,Sioux County,6,44,20,24
Nebraska,Sioux County,7,69,34,35
Nebraska,Sioux County,8,76,43,33
Nebraska,Sioux County,9,64,30,34
Nebraska,Sioux County,10,69,28,41
Nebraska,Sioux County,11,107,61,46
Nebraska,Sioux County,12,119,63,56
Nebraska,Sioux County,13,117,69,48
Nebraska,Sioux County,14,73,36,37
Nebraska,Sioux County,15,56,25,31
Nebraska,Sioux County,16,55,27,28
Nebraska,Sioux County,17,54,29,25
Nebraska,Sioux County,18,37,15,22
Nebraska,Stanton County,0,6069,3059,3010
Nebraska,Stanton County,1,363,205,158
Nebraska,Stanton County,2,447,218,229
Nebraska,Stanton County,3,469,233,236
Nebraska,Stanton County,4,429,211,218
Nebraska,Stanton County,5,343,182,161
Nebraska,Stanton County,6,335,175,160
Nebraska,Stanton County,7,369,189,180
Nebraska,Stanton County,8,341,181,160
Nebraska,Stanton County,9,340,167,173
Nebraska,Stanton County,10,378,202,176
Nebraska,Stanton County,11,483,230,253
Nebraska,Stanton County,12,463,249,214
Nebraska,Stanton County,13,398,189,209
Nebraska,Stanton County,14,284,148,136
Nebraska,Stanton County,15,202,95,107
Nebraska,Stanton County,16,179,77,102
Nebraska,Stanton County,17,126,54,72
Nebraska,Stanton County,18,120,54,66
Nebraska,Thayer County,0,5230,2560,2670
Nebraska,Thayer County,1,274,132,142
Nebraska,Thayer County,2,340,162,178
Nebraska,Thayer County,3,321,172,149
Nebraska,Thayer County,4,310,151,159
Nebraska,Thayer County,5,275,151,124
Nebraska,Thayer County,6,208,108,100
Nebraska,Thayer County,7,247,121,126
Nebraska,Thayer County,8,233,132,101
Nebraska,Thayer County,9,249,125,124
Nebraska,Thayer County,10,311,139,172
Nebraska,Thayer County,11,363,190,173
Nebraska,Thayer County,12,396,204,192
Nebraska,Thayer County,13,411,204,207
Nebraska,Thayer County,14,331,165,166
Nebraska,Thayer County,15,258,122,136
Nebraska,Thayer County,16,228,107,121
Nebraska,Thayer County,17,198,77,121
Nebraska,Thayer County,18,277,98,179
Nebraska,Thomas County,0,687,364,323
Nebraska,Thomas County,1,57,34,23
Nebraska,Thomas County,2,37,18,19
Nebraska,Thomas County,3,41,27,14
Nebraska,Thomas County,4,34,20,14
Nebraska,Thomas County,5,31,20,11
Nebraska,Thomas County,6,38,21,17
Nebraska,Thomas County,7,33,17,16
Nebraska,Thomas County,8,35,18,17
Nebraska,Thomas County,9,46,23,23
Nebraska,Thomas County,10,43,20,23
Nebraska,Thomas County,11,36,18,18
Nebraska,Thomas County,12,54,23,31
Nebraska,Thomas County,13,66,41,25
Nebraska,Thomas County,14,41,17,24
Nebraska,Thomas County,15,36,19,17
Nebraska,Thomas County,16,24,13,11
Nebraska,Thomas County,17,12,4,8
Nebraska,Thomas County,18,23,11,12
Nebraska,Thurston County,0,6969,3444,3525
Nebraska,Thurston County,1,702,333,369
Nebraska,Thurston County,2,733,391,342
Nebraska,Thurston County,3,697,355,342
Nebraska,Thurston County,4,537,278,259
Nebraska,Thurston County,5,512,265,247
Nebraska,Thurston County,6,406,204,202
Nebraska,Thurston County,7,393,197,196
Nebraska,Thurston County,8,318,154,164
Nebraska,Thurston County,9,325,153,172
Nebraska,Thurston County,10,352,160,192
Nebraska,Thurston County,11,395,186,209
Nebraska,Thurston County,12,415,221,194
Nebraska,Thurston County,13,339,180,159
Nebraska,Thurston County,14,244,114,130
Nebraska,Thurston County,15,187,86,101
Nebraska,Thurston County,16,138,62,76
Nebraska,Thurston County,17,135,46,89
Nebraska,Thurston County,18,141,59,82
Nebraska,Valley County,0,4204,2095,2109
Nebraska,Valley County,1,228,127,101
Nebraska,Valley County,2,261,139,122
Nebraska,Valley County,3,291,147,144
Nebraska,Valley County,4,275,135,140
Nebraska,Valley County,5,197,100,97
Nebraska,Valley County,6,175,83,92
Nebraska,Valley County,7,212,102,110
Nebraska,Valley County,8,207,102,105
Nebraska,Valley County,9,234,127,107
Nebraska,Valley County,10,247,130,117
Nebraska,Valley County,11,281,138,143
Nebraska,Valley County,12,287,143,144
Nebraska,Valley County,13,306,158,148
Nebraska,Valley County,14,267,121,146
Nebraska,Valley County,15,247,133,114
Nebraska,Valley County,16,179,87,92
Nebraska,Valley County,17,147,58,89
Nebraska,Valley County,18,163,65,98
Nebraska,Washington County,0,20258,10130,10128
Nebraska,Washington County,1,1096,567,529
Nebraska,Washington County,2,1273,641,632
Nebraska,Washington County,3,1553,812,741
Nebraska,Washington County,4,1531,808,723
Nebraska,Washington County,5,1223,629,594
Nebraska,Washington County,6,867,459,408
Nebraska,Washington County,7,1128,560,568
Nebraska,Washington County,8,1117,579,538
Nebraska,Washington County,9,1209,605,604
Nebraska,Washington County,10,1386,667,719
Nebraska,Washington County,11,1726,869,857
Nebraska,Washington County,12,1538,782,756
Nebraska,Washington County,13,1366,651,715
Nebraska,Washington County,14,1135,592,543
Nebraska,Washington County,15,715,339,376
Nebraska,Washington County,16,546,256,290
Nebraska,Washington County,17,389,167,222
Nebraska,Washington County,18,460,147,313
Nebraska,Wayne County,0,9431,4795,4636
Nebraska,Wayne County,1,539,316,223
Nebraska,Wayne County,2,521,287,234
Nebraska,Wayne County,3,491,249,242
Nebraska,Wayne County,4,1041,461,580
Nebraska,Wayne County,5,1679,897,782
Nebraska,Wayne County,6,462,243,219
Nebraska,Wayne County,7,488,241,247
Nebraska,Wayne County,8,437,220,217
Nebraska,Wayne County,9,387,205,182
Nebraska,Wayne County,10,449,231,218
Nebraska,Wayne County,11,537,261,276
Nebraska,Wayne County,12,573,303,270
Nebraska,Wayne County,13,495,258,237
Nebraska,Wayne County,14,342,178,164
Nebraska,Wayne County,15,288,144,144
Nebraska,Wayne County,16,230,109,121
Nebraska,Wayne County,17,216,84,132
Nebraska,Wayne County,18,256,108,148
Nebraska,Webster County,0,3658,1782,1876
Nebraska,Webster County,1,212,100,112
Nebraska,Webster County,2,227,112,115
Nebraska,Webster County,3,209,90,119
Nebraska,Webster County,4,239,121,118
Nebraska,Webster County,5,202,109,93
Nebraska,Webster County,6,153,82,71
Nebraska,Webster County,7,150,82,68
Nebraska,Webster County,8,179,95,84
Nebraska,Webster County,9,180,91,89
Nebraska,Webster County,10,224,108,116
Nebraska,Webster County,11,292,141,151
Nebraska,Webster County,12,297,160,137
Nebraska,Webster County,13,252,130,122
Nebraska,Webster County,14,208,111,97
Nebraska,Webster County,15,194,91,103
Nebraska,Webster County,16,174,69,105
Nebraska,Webster County,17,113,51,62
Nebraska,Webster County,18,153,39,114
Nebraska,Wheeler County,0,766,388,378
Nebraska,Wheeler County,1,49,27,22
Nebraska,Wheeler County,2,36,23,13
Nebraska,Wheeler County,3,36,16,20
Nebraska,Wheeler County,4,54,22,32
Nebraska,Wheeler County,5,35,20,15
Nebraska,Wheeler County,6,35,14,21
Nebraska,Wheeler County,7,29,15,14
Nebraska,Wheeler County,8,40,22,18
Nebraska,Wheeler County,9,45,23,22
Nebraska,Wheeler County,10,37,21,16
Nebraska,Wheeler County,11,65,31,34
Nebraska,Wheeler County,12,80,48,32
Nebraska,Wheeler County,13,57,29,28
Nebraska,Wheeler County,14,54,30,24
Nebraska,Wheeler County,15,40,17,23
Nebraska,Wheeler County,16,31,14,17
Nebraska,Wheeler County,17,21,8,13
Nebraska,Wheeler County,18,22,8,14
Nebraska,York County,0,13917,6775,7142
Nebraska,York County,1,923,458,465
Nebraska,York County,2,929,466,463
Nebraska,York County,3,795,410,385
Nebraska,York County,4,913,474,439
Nebraska,York County,5,966,509,457
Nebraska,York County,6,864,414,450
Nebraska,York County,7,828,419,409
Nebraska,York County,8,700,338,362
Nebraska,York County,9,721,355,366
Nebraska,York County,10,755,355,400
Nebraska,York County,11,1016,503,513
Nebraska,York County,12,1013,491,522
Nebraska,York County,13,913,450,463
Nebraska,York County,14,675,318,357
Nebraska,York County,15,558,260,298
Nebraska,York County,16,497,213,284
Nebraska,York County,17,387,176,211
Nebraska,York County,18,464,166,298
Nevada,Churchill County,0,23989,12129,11860
Nevada,Churchill County,1,1569,821,748
Nevada,Churchill County,2,1493,781,712
Nevada,Churchill County,3,1531,773,758
Nevada,Churchill County,4,1556,795,761
Nevada,Churchill County,5,1507,819,688
Nevada,Churchill County,6,1642,871,771
Nevada,Churchill County,7,1454,759,695
Nevada,Churchill County,8,1262,636,626
Nevada,Churchill County,9,1306,644,662
Nevada,Churchill County,10,1436,716,720
Nevada,Churchill County,11,1720,876,844
Nevada,Churchill County,12,1647,800,847
Nevada,Churchill County,13,1556,740,816
Nevada,Churchill County,14,1469,747,722
Nevada,Churchill County,15,1146,579,567
Nevada,Churchill County,16,775,374,401
Nevada,Churchill County,17,498,210,288
Nevada,Churchill County,18,422,188,234
Nevada,Clark County,0,2069681,1035874,1033807
Nevada,Clark County,1,131694,67389,64305
Nevada,Clark County,2,141154,71992,69162
Nevada,Clark County,3,138009,70443,67566
Nevada,Clark County,4,128932,66071,62861
Nevada,Clark County,5,139186,70440,68746
Nevada,Clark County,6,151829,76788,75041
Nevada,Clark County,7,153320,77735,75585
Nevada,Clark County,8,143943,72550,71393
Nevada,Clark County,9,148670,75412,73258
Nevada,Clark County,10,140771,72204,68567
Nevada,Clark County,11,138211,70152,68059
Nevada,Clark County,12,126050,61820,64230
Nevada,Clark County,13,112524,53997,58527
Nevada,Clark County,14,99659,47883,51776
Nevada,Clark County,15,72394,34515,37879
Nevada,Clark County,16,47966,22881,25085
Nevada,Clark County,17,29988,13763,16225
Nevada,Clark County,18,25381,9839,15542
Nevada,Douglas County,0,47536,23865,23671
Nevada,Douglas County,1,1929,980,949
Nevada,Douglas County,2,2376,1247,1129
Nevada,Douglas County,3,2669,1343,1326
Nevada,Douglas County,4,2576,1387,1189
Nevada,Douglas County,5,2200,1128,1072
Nevada,Douglas County,6,2246,1173,1073
Nevada,Douglas County,7,2354,1218,1136
Nevada,Douglas County,8,2178,1129,1049
Nevada,Douglas County,9,2409,1192,1217
Nevada,Douglas County,10,2734,1310,1424
Nevada,Douglas County,11,3831,1836,1995
Nevada,Douglas County,12,4253,2058,2195
Nevada,Douglas County,13,4115,2027,2088
Nevada,Douglas County,14,3988,2059,1929
Nevada,Douglas County,15,3091,1557,1534
Nevada,Douglas County,16,2010,1052,958
Nevada,Douglas County,17,1423,713,710
Nevada,Douglas County,18,1154,456,698
Nevada,Elko County,0,52766,27490,25276
Nevada,Elko County,1,3819,1938,1881
Nevada,Elko County,2,4453,2319,2134
Nevada,Elko County,3,3987,2055,1932
Nevada,Elko County,4,3941,2049,1892
Nevada,Elko County,5,3674,1959,1715
Nevada,Elko County,6,4010,2156,1854
Nevada,Elko County,7,3716,1968,1748
Nevada,Elko County,8,3387,1789,1598
Nevada,Elko County,9,3333,1697,1636
Nevada,Elko County,10,3460,1805,1655
Nevada,Elko County,11,3854,2048,1806
Nevada,Elko County,12,3588,1864,1724
Nevada,Elko County,13,2671,1430,1241
Nevada,Elko County,14,1865,954,911
Nevada,Elko County,15,1285,667,618
Nevada,Elko County,16,800,410,390
Nevada,Elko County,17,457,203,254
Nevada,Elko County,18,466,179,287
Nevada,Esmeralda County,0,822,465,357
Nevada,Esmeralda County,1,26,14,12
Nevada,Esmeralda County,2,54,31,23
Nevada,Esmeralda County,3,35,25,10
Nevada,Esmeralda County,4,38,22,16
Nevada,Esmeralda County,5,32,16,16
Nevada,Esmeralda County,6,39,21,18
Nevada,Esmeralda County,7,50,26,24
Nevada,Esmeralda County,8,51,29,22
Nevada,Esmeralda County,9,40,21,19
Nevada,Esmeralda County,10,41,25,16
Nevada,Esmeralda County,11,65,37,28
Nevada,Esmeralda County,12,69,41,28
Nevada,Esmeralda County,13,68,38,30
Nevada,Esmeralda County,14,72,39,33
Nevada,Esmeralda County,15,40,19,21
Nevada,Esmeralda County,16,49,30,19
Nevada,Esmeralda County,17,32,21,11
Nevada,Esmeralda County,18,21,10,11
Nevada,Eureka County,0,2018,1079,939
Nevada,Eureka County,1,140,81,59
Nevada,Eureka County,2,138,71,67
Nevada,Eureka County,3,105,55,50
Nevada,Eureka County,4,132,56,76
Nevada,Eureka County,5,102,50,52
Nevada,Eureka County,6,118,62,56
Nevada,Eureka County,7,95,53,42
Nevada,Eureka County,8,114,61,53
Nevada,Eureka County,9,122,72,50
Nevada,Eureka County,10,140,74,66
Nevada,Eureka County,11,187,103,84
Nevada,Eureka County,12,182,95,87
Nevada,Eureka County,13,141,88,53
Nevada,Eureka County,14,109,57,52
Nevada,Eureka County,15,79,50,29
Nevada,Eureka County,16,44,18,26
Nevada,Eureka County,17,42,20,22
Nevada,Eureka County,18,28,13,15
Nevada,Humboldt County,0,17279,9024,8255
Nevada,Humboldt County,1,1345,664,681
Nevada,Humboldt County,2,1346,668,678
Nevada,Humboldt County,3,1267,643,624
Nevada,Humboldt County,4,1170,611,559
Nevada,Humboldt County,5,1099,600,499
Nevada,Humboldt County,6,1207,627,580
Nevada,Humboldt County,7,1167,638,529
Nevada,Humboldt County,8,1042,549,493
Nevada,Humboldt County,9,1118,603,515
Nevada,Humboldt County,10,1104,594,510
Nevada,Humboldt County,11,1251,651,600
Nevada,Humboldt County,12,1267,673,594
Nevada,Humboldt County,13,1059,568,491
Nevada,Humboldt County,14,706,387,319
Nevada,Humboldt County,15,495,248,247
Nevada,Humboldt County,16,315,159,156
Nevada,Humboldt County,17,183,79,104
Nevada,Humboldt County,18,138,62,76
Nevada,Lander County,0,6009,3065,2944
Nevada,Lander County,1,486,220,266
Nevada,Lander County,2,449,204,245
Nevada,Lander County,3,423,225,198
Nevada,Lander County,4,398,216,182
Nevada,Lander County,5,382,195,187
Nevada,Lander County,6,409,228,181
Nevada,Lander County,7,383,186,197
Nevada,Lander County,8,300,157,143
Nevada,Lander County,9,349,176,173
Nevada,Lander County,10,425,221,204
Nevada,Lander County,11,437,232,205
Nevada,Lander County,12,412,225,187
Nevada,Lander County,13,361,185,176
Nevada,Lander County,14,276,144,132
Nevada,Lander County,15,229,120,109
Nevada,Lander County,16,135,76,59
Nevada,Lander County,17,98,36,62
Nevada,Lander County,18,57,19,38
Nevada,Lincoln County,0,5184,2798,2386
Nevada,Lincoln County,1,208,142,66
Nevada,Lincoln County,2,344,183,161
Nevada,Lincoln County,3,409,231,178
Nevada,Lincoln County,4,350,187,163
Nevada,Lincoln County,5,325,194,131
Nevada,Lincoln County,6,260,153,107
Nevada,Lincoln County,7,301,172,129
Nevada,Lincoln County,8,293,163,130
Nevada,Lincoln County,9,309,170,139
Nevada,Lincoln County,10,299,162,137
Nevada,Lincoln County,11,335,169,166
Nevada,Lincoln County,12,327,154,173
Nevada,Lincoln County,13,398,203,195
Nevada,Lincoln County,14,353,186,167
Nevada,Lincoln County,15,277,131,146
Nevada,Lincoln County,16,193,94,99
Nevada,Lincoln County,17,118,68,50
Nevada,Lincoln County,18,85,36,49
Nevada,Lyon County,0,51789,26226,25563
Nevada,Lyon County,1,2758,1426,1332
Nevada,Lyon County,2,3263,1669,1594
Nevada,Lyon County,3,3375,1684,1691
Nevada,Lyon County,4,3305,1780,1525
Nevada,Lyon County,5,2567,1379,1188
Nevada,Lyon County,6,2742,1404,1338
Nevada,Lyon County,7,2948,1501,1447
Nevada,Lyon County,8,2756,1361,1395
Nevada,Lyon County,9,3081,1559,1522
Nevada,Lyon County,10,3222,1643,1579
Nevada,Lyon County,11,3820,1901,1919
Nevada,Lyon County,12,3904,1979,1925
Nevada,Lyon County,13,3820,1801,2019
Nevada,Lyon County,14,3805,1951,1854
Nevada,Lyon County,15,2835,1474,1361
Nevada,Lyon County,16,1805,916,889
Nevada,Lyon County,17,1038,500,538
Nevada,Lyon County,18,745,298,447
Nevada,Mineral County,0,4500,2190,2310
Nevada,Mineral County,1,274,138,136
Nevada,Mineral County,2,225,131,94
Nevada,Mineral County,3,219,107,112
Nevada,Mineral County,4,235,103,132
Nevada,Mineral County,5,229,117,112
Nevada,Mineral County,6,262,129,133
Nevada,Mineral County,7,217,105,112
Nevada,Mineral County,8,172,100,72
Nevada,Mineral County,9,205,85,120
Nevada,Mineral County,10,246,123,123
Nevada,Mineral County,11,344,165,179
Nevada,Mineral County,12,389,182,207
Nevada,Mineral County,13,353,174,179
Nevada,Mineral County,14,374,180,194
Nevada,Mineral County,15,292,151,141
Nevada,Mineral County,16,228,108,120
Nevada,Mineral County,17,113,44,69
Nevada,Mineral County,18,123,48,75
Nevada,Nye County,0,42282,21335,20947
Nevada,Nye County,1,1801,889,912
Nevada,Nye County,2,2033,1010,1023
Nevada,Nye County,3,2220,1136,1084
Nevada,Nye County,4,2307,1198,1109
Nevada,Nye County,5,1894,1012,882
Nevada,Nye County,6,1759,935,824
Nevada,Nye County,7,1772,890,882
Nevada,Nye County,8,1748,887,861
Nevada,Nye County,9,1983,978,1005
Nevada,Nye County,10,2421,1159,1262
Nevada,Nye County,11,3166,1548,1618
Nevada,Nye County,12,3625,1756,1869
Nevada,Nye County,13,3770,1905,1865
Nevada,Nye County,14,3938,1945,1993
Nevada,Nye County,15,3404,1818,1586
Nevada,Nye County,16,2365,1245,1120
Nevada,Nye County,17,1273,683,590
Nevada,Nye County,18,803,341,462
Nevada,Pershing County,0,6698,4242,2456
Nevada,Pershing County,1,306,152,154
Nevada,Pershing County,2,335,167,168
Nevada,Pershing County,3,366,186,180
Nevada,Pershing County,4,376,211,165
Nevada,Pershing County,5,447,303,144
Nevada,Pershing County,6,454,330,124
Nevada,Pershing County,7,489,352,137
Nevada,Pershing County,8,456,340,116
Nevada,Pershing County,9,528,392,136
Nevada,Pershing County,10,593,406,187
Nevada,Pershing County,11,550,373,177
Nevada,Pershing County,12,484,292,192
Nevada,Pershing County,13,391,235,156
Nevada,Pershing County,14,311,183,128
Nevada,Pershing County,15,291,158,133
Nevada,Pershing County,16,160,86,74
Nevada,Pershing County,17,91,47,44
Nevada,Pershing County,18,70,29,41
Nevada,Storey County,0,3912,2034,1878
Nevada,Storey County,1,88,57,31
Nevada,Storey County,2,147,80,67
Nevada,Storey County,3,156,75,81
Nevada,Storey County,4,154,92,62
Nevada,Storey County,5,164,76,88
Nevada,Storey County,6,141,85,56
Nevada,Storey County,7,148,70,78
Nevada,Storey County,8,173,89,84
Nevada,Storey County,9,204,102,102
Nevada,Storey County,10,223,107,116
Nevada,Storey County,11,362,180,182
Nevada,Storey County,12,431,226,205
Nevada,Storey County,13,434,219,215
Nevada,Storey County,14,420,220,200
Nevada,Storey County,15,318,179,139
Nevada,Storey County,16,174,104,70
Nevada,Storey County,17,98,51,47
Nevada,Storey County,18,77,22,55
Nevada,Washoe County,0,440078,221347,218731
Nevada,Washoe County,1,26478,13348,13130
Nevada,Washoe County,2,28029,14418,13611
Nevada,Washoe County,3,27485,14365,13120
Nevada,Washoe County,4,27627,14202,13425
Nevada,Washoe County,5,31469,15875,15594
Nevada,Washoe County,6,33812,17528,16284
Nevada,Washoe County,7,29450,15033,14417
Nevada,Washoe County,8,26395,13330,13065
Nevada,Washoe County,9,27337,13916,13421
Nevada,Washoe County,10,28615,14492,14123
Nevada,Washoe County,11,30994,15555,15439
Nevada,Washoe County,12,30377,15109,15268
Nevada,Washoe County,13,27708,13558,14150
Nevada,Washoe County,14,24240,12124,12116
Nevada,Washoe County,15,16388,8152,8236
Nevada,Washoe County,16,10317,4872,5445
Nevada,Washoe County,17,6726,3036,3690
Nevada,Washoe County,18,6631,2434,4197
Nevada,White Pine County,0,10034,5754,4280
Nevada,White Pine County,1,637,312,325
Nevada,White Pine County,2,580,287,293
Nevada,White Pine County,3,578,270,308
Nevada,White Pine County,4,561,307,254
Nevada,White Pine County,5,656,416,240
Nevada,White Pine County,6,713,468,245
Nevada,White Pine County,7,797,557,240
Nevada,White Pine County,8,637,411,226
Nevada,White Pine County,9,613,381,232
Nevada,White Pine County,10,660,409,251
Nevada,White Pine County,11,741,426,315
Nevada,White Pine County,12,689,385,304
Nevada,White Pine County,13,653,365,288
Nevada,White Pine County,14,479,254,225
Nevada,White Pine County,15,396,193,203
Nevada,White Pine County,16,275,144,131
Nevada,White Pine County,17,188,91,97
Nevada,White Pine County,18,181,78,103
Nevada,Carson City,0,54522,27876,26646
Nevada,Carson City,1,2839,1454,1385
Nevada,Carson City,2,3228,1659,1569
Nevada,Carson City,3,3181,1603,1578
Nevada,Carson City,4,3129,1608,1521
Nevada,Carson City,5,3411,1832,1579
Nevada,Carson City,6,3397,1896,1501
Nevada,Carson City,7,3212,1784,1428
Nevada,Carson City,8,2975,1620,1355
Nevada,Carson City,9,3254,1729,1525
Nevada,Carson City,10,3614,1970,1644
Nevada,Carson City,11,3993,2096,1897
Nevada,Carson City,12,4068,2061,2007
Nevada,Carson City,13,3757,1816,1941
Nevada,Carson City,14,3404,1662,1742
Nevada,Carson City,15,2535,1232,1303
Nevada,Carson City,16,1825,820,1005
Nevada,Carson City,17,1318,548,770
Nevada,Carson City,18,1382,486,896
New Hampshire,Belknap County,0,60305,29642,30663
New Hampshire,Belknap County,1,2852,1452,1400
New Hampshire,Belknap County,2,3174,1610,1564
New Hampshire,Belknap County,3,3462,1778,1684
New Hampshire,Belknap County,4,3461,1799,1662
New Hampshire,Belknap County,5,3133,1615,1518
New Hampshire,Belknap County,6,3033,1535,1498
New Hampshire,Belknap County,7,3270,1564,1706
New Hampshire,Belknap County,8,3139,1544,1595
New Hampshire,Belknap County,9,3594,1729,1865
New Hampshire,Belknap County,10,4139,2026,2113
New Hampshire,Belknap County,11,5103,2503,2600
New Hampshire,Belknap County,12,5152,2491,2661
New Hampshire,Belknap County,13,4805,2404,2401
New Hampshire,Belknap County,14,4317,2096,2221
New Hampshire,Belknap County,15,2883,1449,1434
New Hampshire,Belknap County,16,1830,856,974
New Hampshire,Belknap County,17,1354,599,755
New Hampshire,Belknap County,18,1604,592,1012
New Hampshire,Carroll County,0,47399,23519,23880
New Hampshire,Carroll County,1,1782,924,858
New Hampshire,Carroll County,2,2098,1140,958
New Hampshire,Carroll County,3,2411,1241,1170
New Hampshire,Carroll County,4,2543,1323,1220
New Hampshire,Carroll County,5,2197,1150,1047
New Hampshire,Carroll County,6,1977,983,994
New Hampshire,Carroll County,7,2112,1050,1062
New Hampshire,Carroll County,8,2003,967,1036
New Hampshire,Carroll County,9,2655,1332,1323
New Hampshire,Carroll County,10,3178,1540,1638
New Hampshire,Carroll County,11,4027,1924,2103
New Hampshire,Carroll County,12,4477,2175,2302
New Hampshire,Carroll County,13,4319,2156,2163
New Hampshire,Carroll County,14,3972,1980,1992
New Hampshire,Carroll County,15,2903,1513,1390
New Hampshire,Carroll County,16,1900,915,985
New Hampshire,Carroll County,17,1409,652,757
New Hampshire,Carroll County,18,1436,554,882
New Hampshire,Cheshire County,0,76115,37190,38925
New Hampshire,Cheshire County,1,3598,1850,1748
New Hampshire,Cheshire County,2,3916,1983,1933
New Hampshire,Cheshire County,3,4164,2142,2022
New Hampshire,Cheshire County,4,5703,2728,2975
New Hampshire,Cheshire County,5,5997,3012,2985
New Hampshire,Cheshire County,6,4703,2375,2328
New Hampshire,Cheshire County,7,4231,2137,2094
New Hampshire,Cheshire County,8,3707,1813,1894
New Hampshire,Cheshire County,9,4357,2105,2252
New Hampshire,Cheshire County,10,5036,2517,2519
New Hampshire,Cheshire County,11,5913,2840,3073
New Hampshire,Cheshire County,12,6098,2962,3136
New Hampshire,Cheshire County,13,5511,2730,2781
New Hampshire,Cheshire County,14,4519,2180,2339
New Hampshire,Cheshire County,15,3187,1494,1693
New Hampshire,Cheshire County,16,2173,1006,1167
New Hampshire,Cheshire County,17,1633,729,904
New Hampshire,Cheshire County,18,1669,587,1082
New Hampshire,Coos County,0,31653,16149,15504
New Hampshire,Coos County,1,1318,661,657
New Hampshire,Coos County,2,1501,775,726
New Hampshire,Coos County,3,1642,832,810
New Hampshire,Coos County,4,1696,941,755
New Hampshire,Coos County,5,1630,893,737
New Hampshire,Coos County,6,1566,859,707
New Hampshire,Coos County,7,1560,826,734
New Hampshire,Coos County,8,1622,832,790
New Hampshire,Coos County,9,1954,1034,920
New Hampshire,Coos County,10,2162,1152,1010
New Hampshire,Coos County,11,2626,1300,1326
New Hampshire,Coos County,12,2792,1466,1326
New Hampshire,Coos County,13,2692,1321,1371
New Hampshire,Coos County,14,2218,1185,1033
New Hampshire,Coos County,15,1607,798,809
New Hampshire,Coos County,16,1190,563,627
New Hampshire,Coos County,17,886,350,536
New Hampshire,Coos County,18,991,361,630
New Hampshire,Grafton County,0,89658,44219,45439
New Hampshire,Grafton County,1,3852,1972,1880
New Hampshire,Grafton County,2,4213,2120,2093
New Hampshire,Grafton County,3,4391,2259,2132
New Hampshire,Grafton County,4,7147,3620,3527
New Hampshire,Grafton County,5,7931,4128,3803
New Hampshire,Grafton County,6,5802,2968,2834
New Hampshire,Grafton County,7,4919,2458,2461
New Hampshire,Grafton County,8,4374,2171,2203
New Hampshire,Grafton County,9,4912,2400,2512
New Hampshire,Grafton County,10,5553,2681,2872
New Hampshire,Grafton County,11,6650,3226,3424
New Hampshire,Grafton County,12,7296,3539,3757
New Hampshire,Grafton County,13,6436,3150,3286
New Hampshire,Grafton County,14,5489,2710,2779
New Hampshire,Grafton County,15,3915,1930,1985
New Hampshire,Grafton County,16,2586,1256,1330
New Hampshire,Grafton County,17,1944,856,1088
New Hampshire,Grafton County,18,2248,775,1473
New Hampshire,Hillsborough County,0,405184,200970,204214
New Hampshire,Hillsborough County,1,22017,11292,10725
New Hampshire,Hillsborough County,2,23702,11985,11717
New Hampshire,Hillsborough County,3,25672,13142,12530
New Hampshire,Hillsborough County,4,26626,13715,12911
New Hampshire,Hillsborough County,5,25966,13322,12644
New Hampshire,Hillsborough County,6,25923,13201,12722
New Hampshire,Hillsborough County,7,25650,13067,12583
New Hampshire,Hillsborough County,8,24292,12091,12201
New Hampshire,Hillsborough County,9,27592,13752,13840
New Hampshire,Hillsborough County,10,30916,15401,15515
New Hampshire,Hillsborough County,11,34557,17260,17297
New Hampshire,Hillsborough County,12,31309,15624,15685
New Hampshire,Hillsborough County,13,24691,12172,12519
New Hampshire,Hillsborough County,14,19662,9507,10155
New Hampshire,Hillsborough County,15,13025,6118,6907
New Hampshire,Hillsborough County,16,9044,4012,5032
New Hampshire,Hillsborough County,17,6827,2795,4032
New Hampshire,Hillsborough County,18,7713,2514,5199
New Hampshire,Merrimack County,0,147171,72514,74657
New Hampshire,Merrimack County,1,7003,3513,3490
New Hampshire,Merrimack County,2,7834,4020,3814
New Hampshire,Merrimack County,3,8818,4460,4358
New Hampshire,Merrimack County,4,10164,5182,4982
New Hampshire,Merrimack County,5,9848,5037,4811
New Hampshire,Merrimack County,6,8258,4360,3898
New Hampshire,Merrimack County,7,8423,4235,4188
New Hampshire,Merrimack County,8,8139,4056,4083
New Hampshire,Merrimack County,9,9501,4775,4726
New Hampshire,Merrimack County,10,10706,5357,5349
New Hampshire,Merrimack County,11,12391,6119,6272
New Hampshire,Merrimack County,12,12159,5856,6303
New Hampshire,Merrimack County,13,10272,5014,5258
New Hampshire,Merrimack County,14,8138,3921,4217
New Hampshire,Merrimack County,15,5539,2637,2902
New Hampshire,Merrimack County,16,3748,1688,2060
New Hampshire,Merrimack County,17,2918,1231,1687
New Hampshire,Merrimack County,18,3312,1053,2259
New Hampshire,Rockingham County,0,300621,148815,151806
New Hampshire,Rockingham County,1,13741,6932,6809
New Hampshire,Rockingham County,2,16486,8315,8171
New Hampshire,Rockingham County,3,19346,9907,9439
New Hampshire,Rockingham County,4,19134,9916,9218
New Hampshire,Rockingham County,5,16849,8899,7950
New Hampshire,Rockingham County,6,17005,8847,8158
New Hampshire,Rockingham County,7,16183,8125,8058
New Hampshire,Rockingham County,8,16255,7955,8300
New Hampshire,Rockingham County,9,20825,10176,10649
New Hampshire,Rockingham County,10,24577,12054,12523
New Hampshire,Rockingham County,11,27858,13767,14091
New Hampshire,Rockingham County,12,25802,12901,12901
New Hampshire,Rockingham County,13,20723,10232,10491
New Hampshire,Rockingham County,14,16659,8040,8619
New Hampshire,Rockingham County,15,10998,5293,5705
New Hampshire,Rockingham County,16,7323,3341,3982
New Hampshire,Rockingham County,17,5331,2269,3062
New Hampshire,Rockingham County,18,5526,1846,3680
New Hampshire,Strafford County,0,125604,61176,64428
New Hampshire,Strafford County,1,6339,3222,3117
New Hampshire,Strafford County,2,6816,3514,3302
New Hampshire,Strafford County,3,6974,3480,3494
New Hampshire,Strafford County,4,10492,4999,5493
New Hampshire,Strafford County,5,14349,6761,7588
New Hampshire,Strafford County,6,7386,3853,3533
New Hampshire,Strafford County,7,7533,3806,3727
New Hampshire,Strafford County,8,6830,3426,3404
New Hampshire,Strafford County,9,7725,3860,3865
New Hampshire,Strafford County,10,8302,4049,4253
New Hampshire,Strafford County,11,9515,4673,4842
New Hampshire,Strafford County,12,8952,4422,4530
New Hampshire,Strafford County,13,7117,3473,3644
New Hampshire,Strafford County,14,5888,2813,3075
New Hampshire,Strafford County,15,4078,1905,2173
New Hampshire,Strafford County,16,2734,1224,1510
New Hampshire,Strafford County,17,2232,918,1314
New Hampshire,Strafford County,18,2342,778,1564
New Hampshire,Sullivan County,0,43103,21275,21828
New Hampshire,Sullivan County,1,2043,1028,1015
New Hampshire,Sullivan County,2,2312,1203,1109
New Hampshire,Sullivan County,3,2517,1261,1256
New Hampshire,Sullivan County,4,2432,1276,1156
New Hampshire,Sullivan County,5,2255,1136,1119
New Hampshire,Sullivan County,6,2195,1095,1100
New Hampshire,Sullivan County,7,2353,1195,1158
New Hampshire,Sullivan County,8,2302,1114,1188
New Hampshire,Sullivan County,9,2713,1378,1335
New Hampshire,Sullivan County,10,3144,1569,1575
New Hampshire,Sullivan County,11,3582,1772,1810
New Hampshire,Sullivan County,12,3713,1854,1859
New Hampshire,Sullivan County,13,3379,1653,1726
New Hampshire,Sullivan County,14,2861,1407,1454
New Hampshire,Sullivan County,15,2007,972,1035
New Hampshire,Sullivan County,16,1317,628,689
New Hampshire,Sullivan County,17,944,402,542
New Hampshire,Sullivan County,18,1034,332,702
New Jersey,Atlantic County,0,275209,133183,142026
New Jersey,Atlantic County,1,16659,8431,8228
New Jersey,Atlantic County,2,16562,8361,8201
New Jersey,Atlantic County,3,16964,8721,8243
New Jersey,Atlantic County,4,17967,9174,8793
New Jersey,Atlantic County,5,19170,9658,9512
New Jersey,Atlantic County,6,16739,8332,8407
New Jersey,Atlantic County,7,16015,7798,8217
New Jersey,Atlantic County,8,15322,7357,7965
New Jersey,Atlantic County,9,17381,8169,9212
New Jersey,Atlantic County,10,19048,9135,9913
New Jersey,Atlantic County,11,21872,10665,11207
New Jersey,Atlantic County,12,21133,10182,10951
New Jersey,Atlantic County,13,16862,8107,8755
New Jersey,Atlantic County,14,14318,6771,7547
New Jersey,Atlantic County,15,10652,4850,5802
New Jersey,Atlantic County,16,7578,3353,4225
New Jersey,Atlantic County,17,5313,2230,3083
New Jersey,Atlantic County,18,5654,1889,3765
New Jersey,Bergen County,0,933572,452201,481371
New Jersey,Bergen County,1,48897,24986,23911
New Jersey,Bergen County,2,55428,28296,27132
New Jersey,Bergen County,3,60114,30627,29487
New Jersey,Bergen County,4,59718,30794,28924
New Jersey,Bergen County,5,53541,27234,26307
New Jersey,Bergen County,6,51884,26177,25707
New Jersey,Bergen County,7,57467,28209,29258
New Jersey,Bergen County,8,60860,29771,31089
New Jersey,Bergen County,9,65552,31972,33580
New Jersey,Bergen County,10,70800,34037,36763
New Jersey,Bergen County,11,74468,36327,38141
New Jersey,Bergen County,12,69317,33086,36231
New Jersey,Bergen County,13,56246,26847,29399
New Jersey,Bergen County,14,46190,21669,24521
New Jersey,Bergen County,15,33440,14926,18514
New Jersey,Bergen County,16,25404,10929,14475
New Jersey,Bergen County,17,20488,8267,12221
New Jersey,Bergen County,18,23758,8047,15711
New Jersey,Burlington County,0,449722,220932,228790
New Jersey,Burlington County,1,23308,11787,11521
New Jersey,Burlington County,2,26891,13668,13223
New Jersey,Burlington County,3,29045,14607,14438
New Jersey,Burlington County,4,28530,14858,13672
New Jersey,Burlington County,5,29570,16511,13059
New Jersey,Burlington County,6,27528,14495,13033
New Jersey,Burlington County,7,26831,13433,13398
New Jersey,Burlington County,8,26215,12833,13382
New Jersey,Burlington County,9,30021,14770,15251
New Jersey,Burlington County,10,33638,16372,17266
New Jersey,Burlington County,11,37452,18273,19179
New Jersey,Burlington County,12,33791,16480,17311
New Jersey,Burlington County,13,26919,12907,14012
New Jersey,Burlington County,14,22366,10405,11961
New Jersey,Burlington County,15,16062,7149,8913
New Jersey,Burlington County,16,12047,5169,6878
New Jersey,Burlington County,17,9305,3779,5526
New Jersey,Burlington County,18,10203,3436,6767
New Jersey,Camden County,0,511038,247052,263986
New Jersey,Camden County,1,32241,16603,15638
New Jersey,Camden County,2,32790,16744,16046
New Jersey,Camden County,3,33304,17107,16197
New Jersey,Camden County,4,32503,16737,15766
New Jersey,Camden County,5,33318,16790,16528
New Jersey,Camden County,6,35005,17632,17373
New Jersey,Camden County,7,34354,16853,17501
New Jersey,Camden County,8,31522,15352,16170
New Jersey,Camden County,9,33496,16140,17356
New Jersey,Camden County,10,35265,16874,18391
New Jersey,Camden County,11,38153,18201,19952
New Jersey,Camden County,12,36373,17423,18950
New Jersey,Camden County,13,29920,13987,15933
New Jersey,Camden County,14,23919,10911,13008
New Jersey,Camden County,15,16894,7565,9329
New Jersey,Camden County,16,11821,5023,6798
New Jersey,Camden County,17,9149,3639,5510
New Jersey,Camden County,18,11011,3471,7540
New Jersey,Cape May County,0,95344,46517,48827
New Jersey,Cape May County,1,4629,2295,2334
New Jersey,Cape May County,2,4436,2268,2168
New Jersey,Cape May County,3,4842,2491,2351
New Jersey,Cape May County,4,5095,2702,2393
New Jersey,Cape May County,5,5942,3231,2711
New Jersey,Cape May County,6,5174,2763,2411
New Jersey,Cape May County,7,4565,2333,2232
New Jersey,Cape May County,8,4239,2065,2174
New Jersey,Cape May County,9,4700,2312,2388
New Jersey,Cape May County,10,5875,2934,2941
New Jersey,Cape May County,11,7452,3548,3904
New Jersey,Cape May County,12,7901,3743,4158
New Jersey,Cape May County,13,7667,3651,4016
New Jersey,Cape May County,14,7245,3427,3818
New Jersey,Cape May County,15,5616,2645,2971
New Jersey,Cape May County,16,3991,1823,2168
New Jersey,Cape May County,17,2969,1276,1693
New Jersey,Cape May County,18,3006,1010,1996
New Jersey,Cumberland County,0,157389,81185,76204
New Jersey,Cumberland County,1,10644,5359,5285
New Jersey,Cumberland County,2,10706,5423,5283
New Jersey,Cumberland County,3,10109,5151,4958
New Jersey,Cumberland County,4,9273,4708,4565
New Jersey,Cumberland County,5,10581,5617,4964
New Jersey,Cumberland County,6,11567,6586,4981
New Jersey,Cumberland County,7,11661,6803,4858
New Jersey,Cumberland County,8,10601,6146,4455
New Jersey,Cumberland County,9,10833,5958,4875
New Jersey,Cumberland County,10,10763,5685,5078
New Jersey,Cumberland County,11,10770,5513,5257
New Jersey,Cumberland County,12,10062,4951,5111
New Jersey,Cumberland County,13,8366,4029,4337
New Jersey,Cumberland County,14,7049,3346,3703
New Jersey,Cumberland County,15,5101,2305,2796
New Jersey,Cumberland County,16,3621,1549,2072
New Jersey,Cumberland County,17,2676,1058,1618
New Jersey,Cumberland County,18,3006,998,2008
New Jersey,Essex County,0,795723,382401,413322
New Jersey,Essex County,1,53635,27371,26264
New Jersey,Essex County,2,53787,27629,26158
New Jersey,Essex County,3,52944,26844,26100
New Jersey,Essex County,4,52135,26449,25686
New Jersey,Essex County,5,55009,27776,27233
New Jersey,Essex County,6,53689,26427,27262
New Jersey,Essex County,7,54354,26192,28162
New Jersey,Essex County,8,54944,26499,28445
New Jersey,Essex County,9,57803,28162,29641
New Jersey,Essex County,10,57790,28050,29740
New Jersey,Essex County,11,57708,27932,29776
New Jersey,Essex County,12,51741,24174,27567
New Jersey,Essex County,13,41790,19104,22686
New Jersey,Essex County,14,32425,14440,17985
New Jersey,Essex County,15,22684,9710,12974
New Jersey,Essex County,16,16296,6618,9678
New Jersey,Essex County,17,12363,4586,7777
New Jersey,Essex County,18,14626,4438,10188
New Jersey,Gloucester County,0,290951,141417,149534
New Jersey,Gloucester County,1,15963,8090,7873
New Jersey,Gloucester County,2,18389,9378,9011
New Jersey,Gloucester County,3,19884,10241,9643
New Jersey,Gloucester County,4,19666,10142,9524
New Jersey,Gloucester County,5,19329,9805,9524
New Jersey,Gloucester County,6,17857,9168,8689
New Jersey,Gloucester County,7,17333,8438,8895
New Jersey,Gloucester County,8,17746,8485,9261
New Jersey,Gloucester County,9,19778,9402,10376
New Jersey,Gloucester County,10,21551,10335,11216
New Jersey,Gloucester County,11,23394,11490,11904
New Jersey,Gloucester County,12,21557,10422,11135
New Jersey,Gloucester County,13,17386,8297,9089
New Jersey,Gloucester County,14,13944,6516,7428
New Jersey,Gloucester County,15,9981,4559,5422
New Jersey,Gloucester County,16,6767,2905,3862
New Jersey,Gloucester County,17,5008,1983,3025
New Jersey,Gloucester County,18,5418,1761,3657
New Jersey,Hudson County,0,669115,332886,336229
New Jersey,Hudson County,1,46625,23845,22780
New Jersey,Hudson County,2,36529,18485,18044
New Jersey,Hudson County,3,32909,16922,15987
New Jersey,Hudson County,4,33935,17821,16114
New Jersey,Hudson County,5,47042,24480,22562
New Jersey,Hudson County,6,69108,35337,33771
New Jersey,Hudson County,7,71019,36714,34305
New Jersey,Hudson County,8,56614,29393,27221
New Jersey,Hudson County,9,47642,24489,23153
New Jersey,Hudson County,10,43537,21768,21769
New Jersey,Hudson County,11,42577,21102,21475
New Jersey,Hudson County,12,38336,18254,20082
New Jersey,Hudson County,13,31263,14463,16800
New Jersey,Hudson County,14,24021,10836,13185
New Jersey,Hudson County,15,16810,7229,9581
New Jersey,Hudson County,16,12794,5386,7408
New Jersey,Hudson County,17,9208,3462,5746
New Jersey,Hudson County,18,9146,2900,6246
New Jersey,Hunterdon County,0,126067,62278,63789
New Jersey,Hunterdon County,1,4927,2553,2374
New Jersey,Hunterdon County,2,6862,3534,3328
New Jersey,Hunterdon County,3,8961,4557,4404
New Jersey,Hunterdon County,4,9102,4692,4410
New Jersey,Hunterdon County,5,7407,4262,3145
New Jersey,Hunterdon County,6,5103,2651,2452
New Jersey,Hunterdon County,7,5359,2630,2729
New Jersey,Hunterdon County,8,6061,2904,3157
New Jersey,Hunterdon County,9,8181,3815,4366
New Jersey,Hunterdon County,10,11044,5126,5918
New Jersey,Hunterdon County,11,12575,6208,6367
New Jersey,Hunterdon County,12,11742,5871,5871
New Jersey,Hunterdon County,13,8948,4520,4428
New Jersey,Hunterdon County,14,6847,3358,3489
New Jersey,Hunterdon County,15,4855,2358,2497
New Jersey,Hunterdon County,16,2941,1382,1559
New Jersey,Hunterdon County,17,2351,974,1377
New Jersey,Hunterdon County,18,2801,883,1918
New Jersey,Mercer County,0,371537,181910,189627
New Jersey,Mercer County,1,21758,11050,10708
New Jersey,Mercer County,2,21924,11388,10536
New Jersey,Mercer County,3,23257,11802,11455
New Jersey,Mercer County,4,27371,13561,13810
New Jersey,Mercer County,5,28643,14616,14027
New Jersey,Mercer County,6,23284,12175,11109
New Jersey,Mercer County,7,23290,11920,11370
New Jersey,Mercer County,8,23631,11761,11870
New Jersey,Mercer County,9,25654,12748,12906
New Jersey,Mercer County,10,26668,13170,13498
New Jersey,Mercer County,11,27811,13660,14151
New Jersey,Mercer County,12,25819,12496,13323
New Jersey,Mercer County,13,21198,10015,11183
New Jersey,Mercer County,14,16595,7675,8920
New Jersey,Mercer County,15,11556,5152,6404
New Jersey,Mercer County,16,8533,3575,4958
New Jersey,Mercer County,17,6617,2635,3982
New Jersey,Mercer County,18,7928,2511,5417
New Jersey,Middlesex County,0,836297,411739,424558
New Jersey,Middlesex County,1,50370,25893,24477
New Jersey,Middlesex County,2,50824,25656,25168
New Jersey,Middlesex County,3,51451,26410,25041
New Jersey,Middlesex County,4,55945,29250,26695
New Jersey,Middlesex County,5,57048,28661,28387
New Jersey,Middlesex County,6,58874,29877,28997
New Jersey,Middlesex County,7,58894,29462,29432
New Jersey,Middlesex County,8,57743,28976,28767
New Jersey,Middlesex County,9,59072,29840,29232
New Jersey,Middlesex County,10,59110,29351,29759
New Jersey,Middlesex County,11,61297,30075,31222
New Jersey,Middlesex County,12,57206,27854,29352
New Jersey,Middlesex County,13,46456,22373,24083
New Jersey,Middlesex County,14,36343,17018,19325
New Jersey,Middlesex County,15,25728,11571,14157
New Jersey,Middlesex County,16,18803,8080,10723
New Jersey,Middlesex County,17,14654,5667,8987
New Jersey,Middlesex County,18,16479,5725,10754
New Jersey,Monmouth County,0,629279,306091,323188
New Jersey,Monmouth County,1,32637,16681,15956
New Jersey,Monmouth County,2,37411,18972,18439
New Jersey,Monmouth County,3,42862,21800,21062
New Jersey,Monmouth County,4,43002,22041,20961
New Jersey,Monmouth County,5,37264,19039,18225
New Jersey,Monmouth County,6,33641,17343,16298
New Jersey,Monmouth County,7,32966,16426,16540
New Jersey,Monmouth County,8,34484,16853,17631
New Jersey,Monmouth County,9,41482,20102,21380
New Jersey,Monmouth County,10,48852,23433,25419
New Jersey,Monmouth County,11,55275,26939,28336
New Jersey,Monmouth County,12,50941,24822,26119
New Jersey,Monmouth County,13,40083,19419,20664
New Jersey,Monmouth County,14,32670,15549,17121
New Jersey,Monmouth County,15,22609,10351,12258
New Jersey,Monmouth County,16,15477,6631,8846
New Jersey,Monmouth County,17,12646,4910,7736
New Jersey,Monmouth County,18,14977,4780,10197
New Jersey,Morris County,0,499727,244890,254837
New Jersey,Morris County,1,25584,13146,12438
New Jersey,Morris County,2,29769,15227,14542
New Jersey,Morris County,3,34489,17617,16872
New Jersey,Morris County,4,34348,17609,16739
New Jersey,Morris County,5,28446,14607,13839
New Jersey,Morris County,6,25586,13197,12389
New Jersey,Morris County,7,28140,14151,13989
New Jersey,Morris County,8,29223,14415,14808
New Jersey,Morris County,9,34575,16561,18014
New Jersey,Morris County,10,41126,20132,20994
New Jersey,Morris County,11,43251,21338,21913
New Jersey,Morris County,12,38108,18630,19478
New Jersey,Morris County,13,30217,14808,15409
New Jersey,Morris County,14,24359,11460,12899
New Jersey,Morris County,15,17906,8176,9730
New Jersey,Morris County,16,12628,5499,7129
New Jersey,Morris County,17,10108,4148,5960
New Jersey,Morris County,18,11864,4169,7695
New Jersey,Ocean County,0,586301,282090,304211
New Jersey,Ocean County,1,39995,20480,19515
New Jersey,Ocean County,2,38361,19677,18684
New Jersey,Ocean County,3,37504,19194,18310
New Jersey,Ocean County,4,33718,17479,16239
New Jersey,Ocean County,5,32681,16459,16222
New Jersey,Ocean County,6,32049,16459,15590
New Jersey,Ocean County,7,31281,15725,15556
New Jersey,Ocean County,8,29237,14744,14493
New Jersey,Ocean County,9,32093,15670,16423
New Jersey,Ocean County,10,35881,17588,18293
New Jersey,Ocean County,11,39784,19345,20439
New Jersey,Ocean County,12,39268,18728,20540
New Jersey,Ocean County,13,35859,16470,19389
New Jersey,Ocean County,14,36580,16394,20186
New Jersey,Ocean County,15,30413,13268,17145
New Jersey,Ocean County,16,23299,10061,13238
New Jersey,Ocean County,17,18389,7552,10837
New Jersey,Ocean County,18,19909,6797,13112
New Jersey,Passaic County,0,508856,247881,260975
New Jersey,Passaic County,1,35338,18075,17263
New Jersey,Passaic County,2,33918,17294,16624
New Jersey,Passaic County,3,34125,17531,16594
New Jersey,Passaic County,4,35090,17853,17237
New Jersey,Passaic County,5,37072,18378,18694
New Jersey,Passaic County,6,34188,17249,16939
New Jersey,Passaic County,7,33503,16698,16805
New Jersey,Passaic County,8,32799,16251,16548
New Jersey,Passaic County,9,33585,16370,17215
New Jersey,Passaic County,10,35285,17281,18004
New Jersey,Passaic County,11,36162,17610,18552
New Jersey,Passaic County,12,33646,16162,17484
New Jersey,Passaic County,13,27400,13065,14335
New Jersey,Passaic County,14,22173,10092,12081
New Jersey,Passaic County,15,15607,6861,8746
New Jersey,Passaic County,16,11162,4784,6378
New Jersey,Passaic County,17,8280,3208,5072
New Jersey,Passaic County,18,9523,3119,6404
New Jersey,Salem County,0,64715,31499,33216
New Jersey,Salem County,1,3671,1856,1815
New Jersey,Salem County,2,3877,1986,1891
New Jersey,Salem County,3,4135,2137,1998
New Jersey,Salem County,4,4136,2178,1958
New Jersey,Salem County,5,3979,2001,1978
New Jersey,Salem County,6,3699,1879,1820
New Jersey,Salem County,7,3799,1832,1967
New Jersey,Salem County,8,3532,1761,1771
New Jersey,Salem County,9,4085,1963,2122
New Jersey,Salem County,10,4370,2135,2235
New Jersey,Salem County,11,5099,2423,2676
New Jersey,Salem County,12,4933,2388,2545
New Jersey,Salem County,13,4267,2099,2168
New Jersey,Salem County,14,3628,1726,1902
New Jersey,Salem County,15,2555,1226,1329
New Jersey,Salem County,16,1792,819,973
New Jersey,Salem County,17,1437,557,880
New Jersey,Salem County,18,1721,533,1188
New Jersey,Somerset County,0,332568,161984,170584
New Jersey,Somerset County,1,18141,9121,9020
New Jersey,Somerset County,2,20879,10724,10155
New Jersey,Somerset County,3,23397,11921,11476
New Jersey,Somerset County,4,22463,11573,10890
New Jersey,Somerset County,5,18311,9494,8817
New Jersey,Somerset County,6,16567,8420,8147
New Jersey,Somerset County,7,19267,9396,9871
New Jersey,Somerset County,8,21262,10245,11017
New Jersey,Somerset County,9,24022,11712,12310
New Jersey,Somerset County,10,27129,13126,14003
New Jersey,Somerset County,11,29091,14224,14867
New Jersey,Somerset County,12,25806,12701,13105
New Jersey,Somerset County,13,19452,9396,10056
New Jersey,Somerset County,14,14984,7049,7935
New Jersey,Somerset County,15,10824,4857,5967
New Jersey,Somerset County,16,7720,3370,4350
New Jersey,Somerset County,17,5986,2361,3625
New Jersey,Somerset County,18,7267,2294,4973
New Jersey,Sussex County,0,144909,71945,72964
New Jersey,Sussex County,1,6670,3432,3238
New Jersey,Sussex County,2,8213,4163,4050
New Jersey,Sussex County,3,9787,4945,4842
New Jersey,Sussex County,4,10024,5164,4860
New Jersey,Sussex County,5,8843,4657,4186
New Jersey,Sussex County,6,7006,3729,3277
New Jersey,Sussex County,7,7091,3554,3537
New Jersey,Sussex County,8,7686,3767,3919
New Jersey,Sussex County,9,9677,4728,4949
New Jersey,Sussex County,10,12112,5892,6220
New Jersey,Sussex County,11,13533,6689,6844
New Jersey,Sussex County,12,12667,6259,6408
New Jersey,Sussex County,13,10204,5126,5078
New Jersey,Sussex County,14,7916,3863,4053
New Jersey,Sussex County,15,5341,2603,2738
New Jersey,Sussex County,16,3324,1559,1765
New Jersey,Sussex County,17,2222,938,1284
New Jersey,Sussex County,18,2593,877,1716
New Jersey,Union County,0,552939,269734,283205
New Jersey,Union County,1,35943,18213,17730
New Jersey,Union County,2,37120,18912,18208
New Jersey,Union County,3,36744,18765,17979
New Jersey,Union County,4,35622,18278,17344
New Jersey,Union County,5,35322,18248,17074
New Jersey,Union County,6,34562,17684,16878
New Jersey,Union County,7,36839,18297,18542
New Jersey,Union County,8,38089,18696,19393
New Jersey,Union County,9,39275,19472,19803
New Jersey,Union County,10,41056,19999,21057
New Jersey,Union County,11,42383,20684,21699
New Jersey,Union County,12,37873,18330,19543
New Jersey,Union County,13,29966,14171,15795
New Jersey,Union County,14,23080,10621,12459
New Jersey,Union County,15,16252,7223,9029
New Jersey,Union County,16,11970,4918,7052
New Jersey,Union County,17,9312,3552,5760
New Jersey,Union County,18,11531,3671,7860
New Jersey,Warren County,0,106917,52137,54780
New Jersey,Warren County,1,4884,2424,2460
New Jersey,Warren County,2,6173,3105,3068
New Jersey,Warren County,3,7097,3598,3499
New Jersey,Warren County,4,7098,3674,3424
New Jersey,Warren County,5,6696,3429,3267
New Jersey,Warren County,6,5723,2931,2792
New Jersey,Warren County,7,5561,2794,2767
New Jersey,Warren County,8,5648,2794,2854
New Jersey,Warren County,9,7238,3480,3758
New Jersey,Warren County,10,8558,4197,4361
New Jersey,Warren County,11,9607,4658,4949
New Jersey,Warren County,12,8719,4336,4383
New Jersey,Warren County,13,6820,3323,3497
New Jersey,Warren County,14,5483,2599,2884
New Jersey,Warren County,15,4070,1866,2204
New Jersey,Warren County,16,2758,1212,1546
New Jersey,Warren County,17,2245,888,1357
New Jersey,Warren County,18,2539,829,1710
New Mexico,Bernalillo County,0,675551,331160,344391
New Mexico,Bernalillo County,1,42502,21650,20852
New Mexico,Bernalillo County,2,43645,22345,21300
New Mexico,Bernalillo County,3,43349,21837,21512
New Mexico,Bernalillo County,4,42081,21462,20619
New Mexico,Bernalillo County,5,48232,24603,23629
New Mexico,Bernalillo County,6,52322,26511,25811
New Mexico,Bernalillo County,7,49898,25376,24522
New Mexico,Bernalillo County,8,42889,21622,21267
New Mexico,Bernalillo County,9,41243,20471,20772
New Mexico,Bernalillo County,10,41384,20268,21116
New Mexico,Bernalillo County,11,46535,22673,23862
New Mexico,Bernalillo County,12,45292,21503,23789
New Mexico,Bernalillo County,13,40409,18808,21601
New Mexico,Bernalillo County,14,33071,15608,17463
New Mexico,Bernalillo County,15,22535,10225,12310
New Mexico,Bernalillo County,16,16143,6950,9193
New Mexico,Bernalillo County,17,11622,4876,6746
New Mexico,Bernalillo County,18,12399,4372,8027
New Mexico,Catron County,0,3556,1848,1708
New Mexico,Catron County,1,114,42,72
New Mexico,Catron County,2,123,58,65
New Mexico,Catron County,3,153,81,72
New Mexico,Catron County,4,178,90,88
New Mexico,Catron County,5,120,69,51
New Mexico,Catron County,6,104,59,45
New Mexico,Catron County,7,122,59,63
New Mexico,Catron County,8,101,56,45
New Mexico,Catron County,9,122,63,59
New Mexico,Catron County,10,135,81,54
New Mexico,Catron County,11,244,110,134
New Mexico,Catron County,12,342,168,174
New Mexico,Catron County,13,455,232,223
New Mexico,Catron County,14,448,238,210
New Mexico,Catron County,15,331,191,140
New Mexico,Catron County,16,223,134,89
New Mexico,Catron County,17,127,74,53
New Mexico,Catron County,18,114,43,71
New Mexico,Chaves County,0,65878,32833,33045
New Mexico,Chaves County,1,4778,2413,2365
New Mexico,Chaves County,2,5171,2688,2483
New Mexico,Chaves County,3,4889,2472,2417
New Mexico,Chaves County,4,5164,2857,2307
New Mexico,Chaves County,5,4700,2444,2256
New Mexico,Chaves County,6,4064,2030,2034
New Mexico,Chaves County,7,4270,2155,2115
New Mexico,Chaves County,8,3644,1854,1790
New Mexico,Chaves County,9,3563,1735,1828
New Mexico,Chaves County,10,3774,1855,1919
New Mexico,Chaves County,11,4239,2088,2151
New Mexico,Chaves County,12,4228,2082,2146
New Mexico,Chaves County,13,3660,1757,1903
New Mexico,Chaves County,14,3049,1438,1611
New Mexico,Chaves County,15,2275,1077,1198
New Mexico,Chaves County,16,1726,797,929
New Mexico,Chaves County,17,1306,546,760
New Mexico,Chaves County,18,1378,545,833
New Mexico,Cibola County,0,27349,13969,13380
New Mexico,Cibola County,1,2025,1037,988
New Mexico,Cibola County,2,1824,906,918
New Mexico,Cibola County,3,1768,913,855
New Mexico,Cibola County,4,1736,909,827
New Mexico,Cibola County,5,1932,979,953
New Mexico,Cibola County,6,1929,1072,857
New Mexico,Cibola County,7,1873,1023,850
New Mexico,Cibola County,8,1690,929,761
New Mexico,Cibola County,9,1649,930,719
New Mexico,Cibola County,10,1618,857,761
New Mexico,Cibola County,11,1857,931,926
New Mexico,Cibola County,12,1920,940,980
New Mexico,Cibola County,13,1632,800,832
New Mexico,Cibola County,14,1297,621,676
New Mexico,Cibola County,15,944,430,514
New Mexico,Cibola County,16,758,308,450
New Mexico,Cibola County,17,516,238,278
New Mexico,Cibola County,18,381,146,235
New Mexico,Colfax County,0,12680,6450,6230
New Mexico,Colfax County,1,610,295,315
New Mexico,Colfax County,2,667,329,338
New Mexico,Colfax County,3,701,374,327
New Mexico,Colfax County,4,710,359,351
New Mexico,Colfax County,5,695,394,301
New Mexico,Colfax County,6,640,333,307
New Mexico,Colfax County,7,669,350,319
New Mexico,Colfax County,8,585,333,252
New Mexico,Colfax County,9,612,324,288
New Mexico,Colfax County,10,699,356,343
New Mexico,Colfax County,11,964,490,474
New Mexico,Colfax County,12,1064,508,556
New Mexico,Colfax County,13,1062,536,526
New Mexico,Colfax County,14,1012,514,498
New Mexico,Colfax County,15,738,387,351
New Mexico,Colfax County,16,546,271,275
New Mexico,Colfax County,17,362,172,190
New Mexico,Colfax County,18,344,125,219
New Mexico,Curry County,0,50969,26449,24520
New Mexico,Curry County,1,4390,2211,2179
New Mexico,Curry County,2,3877,1982,1895
New Mexico,Curry County,3,3536,1853,1683
New Mexico,Curry County,4,3381,1843,1538
New Mexico,Curry County,5,5090,3097,1993
New Mexico,Curry County,6,4663,2589,2074
New Mexico,Curry County,7,4129,2192,1937
New Mexico,Curry County,8,2976,1571,1405
New Mexico,Curry County,9,2683,1367,1316
New Mexico,Curry County,10,2566,1269,1297
New Mexico,Curry County,11,2845,1404,1441
New Mexico,Curry County,12,2744,1365,1379
New Mexico,Curry County,13,2212,1088,1124
New Mexico,Curry County,14,1841,889,952
New Mexico,Curry County,15,1392,633,759
New Mexico,Curry County,16,1105,499,606
New Mexico,Curry County,17,784,337,447
New Mexico,Curry County,18,755,260,495
New Mexico,De Baca County,0,1825,917,908
New Mexico,De Baca County,1,105,49,56
New Mexico,De Baca County,2,104,52,52
New Mexico,De Baca County,3,107,59,48
New Mexico,De Baca County,4,116,58,58
New Mexico,De Baca County,5,81,42,39
New Mexico,De Baca County,6,71,34,37
New Mexico,De Baca County,7,111,57,54
New Mexico,De Baca County,8,70,30,40
New Mexico,De Baca County,9,87,48,39
New Mexico,De Baca County,10,101,54,47
New Mexico,De Baca County,11,150,78,72
New Mexico,De Baca County,12,143,68,75
New Mexico,De Baca County,13,145,82,63
New Mexico,De Baca County,14,131,60,71
New Mexico,De Baca County,15,106,51,55
New Mexico,De Baca County,16,86,42,44
New Mexico,De Baca County,17,65,36,29
New Mexico,De Baca County,18,46,17,29
New Mexico,Eddy County,0,56395,28487,27908
New Mexico,Eddy County,1,3968,2054,1914
New Mexico,Eddy County,2,4119,2114,2005
New Mexico,Eddy County,3,4127,2033,2094
New Mexico,Eddy County,4,3987,2070,1917
New Mexico,Eddy County,5,3874,2081,1793
New Mexico,Eddy County,6,3855,2065,1790
New Mexico,Eddy County,7,3893,2073,1820
New Mexico,Eddy County,8,3341,1701,1640
New Mexico,Eddy County,9,3143,1580,1563
New Mexico,Eddy County,10,3244,1673,1571
New Mexico,Eddy County,11,3801,1888,1913
New Mexico,Eddy County,12,3862,1920,1942
New Mexico,Eddy County,13,3317,1692,1625
New Mexico,Eddy County,14,2477,1220,1257
New Mexico,Eddy County,15,1812,841,971
New Mexico,Eddy County,16,1442,669,773
New Mexico,Eddy County,17,1040,449,591
New Mexico,Eddy County,18,1093,364,729
New Mexico,Grant County,0,29096,14397,14699
New Mexico,Grant County,1,1598,822,776
New Mexico,Grant County,2,1741,918,823
New Mexico,Grant County,3,1734,925,809
New Mexico,Grant County,4,1743,915,828
New Mexico,Grant County,5,1693,915,778
New Mexico,Grant County,6,1439,715,724
New Mexico,Grant County,7,1463,731,732
New Mexico,Grant County,8,1444,708,736
New Mexico,Grant County,9,1409,686,723
New Mexico,Grant County,10,1472,706,766
New Mexico,Grant County,11,1830,847,983
New Mexico,Grant County,12,2093,1020,1073
New Mexico,Grant County,13,2432,1119,1313
New Mexico,Grant County,14,2236,1116,1120
New Mexico,Grant County,15,1766,894,872
New Mexico,Grant County,16,1209,576,633
New Mexico,Grant County,17,918,410,508
New Mexico,Grant County,18,876,374,502
New Mexico,Guadalupe County,0,4468,2531,1937
New Mexico,Guadalupe County,1,221,110,111
New Mexico,Guadalupe County,2,268,148,120
New Mexico,Guadalupe County,3,286,149,137
New Mexico,Guadalupe County,4,235,130,105
New Mexico,Guadalupe County,5,278,181,97
New Mexico,Guadalupe County,6,314,199,115
New Mexico,Guadalupe County,7,354,230,124
New Mexico,Guadalupe County,8,275,175,100
New Mexico,Guadalupe County,9,248,145,103
New Mexico,Guadalupe County,10,257,146,111
New Mexico,Guadalupe County,11,344,186,158
New Mexico,Guadalupe County,12,348,188,160
New Mexico,Guadalupe County,13,240,147,93
New Mexico,Guadalupe County,14,226,107,119
New Mexico,Guadalupe County,15,177,72,105
New Mexico,Guadalupe County,16,178,91,87
New Mexico,Guadalupe County,17,110,61,49
New Mexico,Guadalupe County,18,109,66,43
New Mexico,Harding County,0,683,362,321
New Mexico,Harding County,1,27,14,13
New Mexico,Harding County,2,29,15,14
New Mexico,Harding County,3,21,15,6
New Mexico,Harding County,4,35,15,20
New Mexico,Harding County,5,28,14,14
New Mexico,Harding County,6,29,16,13
New Mexico,Harding County,7,28,13,15
New Mexico,Harding County,8,26,14,12
New Mexico,Harding County,9,17,10,7
New Mexico,Harding County,10,41,20,21
New Mexico,Harding County,11,50,20,30
New Mexico,Harding County,12,65,42,23
New Mexico,Harding County,13,77,40,37
New Mexico,Harding County,14,62,31,31
New Mexico,Harding County,15,37,17,20
New Mexico,Harding County,16,37,20,17
New Mexico,Harding County,17,41,23,18
New Mexico,Harding County,18,33,23,10
New Mexico,Hidalgo County,0,4560,2309,2251
New Mexico,Hidalgo County,1,298,152,146
New Mexico,Hidalgo County,2,294,145,149
New Mexico,Hidalgo County,3,293,148,145
New Mexico,Hidalgo County,4,305,170,135
New Mexico,Hidalgo County,5,287,156,131
New Mexico,Hidalgo County,6,244,121,123
New Mexico,Hidalgo County,7,280,169,111
New Mexico,Hidalgo County,8,193,93,100
New Mexico,Hidalgo County,9,217,103,114
New Mexico,Hidalgo County,10,310,154,156
New Mexico,Hidalgo County,11,353,183,170
New Mexico,Hidalgo County,12,293,141,152
New Mexico,Hidalgo County,13,322,160,162
New Mexico,Hidalgo County,14,276,142,134
New Mexico,Hidalgo County,15,209,103,106
New Mexico,Hidalgo County,16,157,72,85
New Mexico,Hidalgo County,17,106,54,52
New Mexico,Hidalgo County,18,123,43,80
New Mexico,Lea County,0,69999,36082,33917
New Mexico,Lea County,1,6016,3049,2967
New Mexico,Lea County,2,6428,3309,3119
New Mexico,Lea County,3,5654,2927,2727
New Mexico,Lea County,4,5105,2609,2496
New Mexico,Lea County,5,5139,2780,2359
New Mexico,Lea County,6,5219,2794,2425
New Mexico,Lea County,7,5203,2869,2334
New Mexico,Lea County,8,4421,2339,2082
New Mexico,Lea County,9,4078,2056,2022
New Mexico,Lea County,10,3897,2025,1872
New Mexico,Lea County,11,4312,2327,1985
New Mexico,Lea County,12,3975,2060,1915
New Mexico,Lea County,13,3239,1595,1644
New Mexico,Lea County,14,2347,1158,1189
New Mexico,Lea County,15,1715,782,933
New Mexico,Lea County,16,1390,640,750
New Mexico,Lea County,17,954,414,540
New Mexico,Lea County,18,907,349,558
New Mexico,Lincoln County,0,19706,9791,9915
New Mexico,Lincoln County,1,973,525,448
New Mexico,Lincoln County,2,1028,557,471
New Mexico,Lincoln County,3,1059,532,527
New Mexico,Lincoln County,4,949,523,426
New Mexico,Lincoln County,5,922,473,449
New Mexico,Lincoln County,6,846,423,423
New Mexico,Lincoln County,7,916,483,433
New Mexico,Lincoln County,8,796,385,411
New Mexico,Lincoln County,9,919,475,444
New Mexico,Lincoln County,10,1104,536,568
New Mexico,Lincoln County,11,1503,703,800
New Mexico,Lincoln County,12,1737,804,933
New Mexico,Lincoln County,13,1770,842,928
New Mexico,Lincoln County,14,1752,856,896
New Mexico,Lincoln County,15,1421,706,715
New Mexico,Lincoln County,16,951,462,489
New Mexico,Lincoln County,17,590,303,287
New Mexico,Lincoln County,18,470,203,267
New Mexico,Los Alamos County,0,17682,8983,8699
New Mexico,Los Alamos County,1,977,505,472
New Mexico,Los Alamos County,2,1120,583,537
New Mexico,Los Alamos County,3,1230,630,600
New Mexico,Los Alamos County,4,1213,609,604
New Mexico,Los Alamos County,5,754,409,345
New Mexico,Los Alamos County,6,701,386,315
New Mexico,Los Alamos County,7,1029,559,470
New Mexico,Los Alamos County,8,1049,550,499
New Mexico,Los Alamos County,9,1110,544,566
New Mexico,Los Alamos County,10,1245,603,642
New Mexico,Los Alamos County,11,1545,775,770
New Mexico,Los Alamos County,12,1484,773,711
New Mexico,Los Alamos County,13,1285,638,647
New Mexico,Los Alamos County,14,946,487,459
New Mexico,Los Alamos County,15,718,352,366
New Mexico,Los Alamos County,16,481,238,243
New Mexico,Los Alamos County,17,356,164,192
New Mexico,Los Alamos County,18,439,178,261
New Mexico,Luna County,0,24673,12344,12329
New Mexico,Luna County,1,1863,968,895
New Mexico,Luna County,2,1749,891,858
New Mexico,Luna County,3,1743,879,864
New Mexico,Luna County,4,1724,861,863
New Mexico,Luna County,5,1621,846,775
New Mexico,Luna County,6,1433,760,673
New Mexico,Luna County,7,1271,651,620
New Mexico,Luna County,8,1179,576,603
New Mexico,Luna County,9,1253,620,633
New Mexico,Luna County,10,1316,653,663
New Mexico,Luna County,11,1498,763,735
New Mexico,Luna County,12,1464,670,794
New Mexico,Luna County,13,1434,723,711
New Mexico,Luna County,14,1510,724,786
New Mexico,Luna County,15,1274,607,667
New Mexico,Luna County,16,1071,568,503
New Mexico,Luna County,17,719,344,375
New Mexico,Luna County,18,551,240,311
New Mexico,McKinley County,0,74098,35585,38513
New Mexico,McKinley County,1,6652,3398,3254
New Mexico,McKinley County,2,6555,3359,3196
New Mexico,McKinley County,3,6071,3059,3012
New Mexico,McKinley County,4,5589,2745,2844
New Mexico,McKinley County,5,5981,2941,3040
New Mexico,McKinley County,6,5481,2711,2770
New Mexico,McKinley County,7,4722,2331,2391
New Mexico,McKinley County,8,4342,2085,2257
New Mexico,McKinley County,9,4180,2034,2146
New Mexico,McKinley County,10,4170,1977,2193
New Mexico,McKinley County,11,4701,2158,2543
New Mexico,McKinley County,12,4357,2003,2354
New Mexico,McKinley County,13,3447,1512,1935
New Mexico,McKinley County,14,2632,1174,1458
New Mexico,McKinley County,15,1946,839,1107
New Mexico,McKinley County,16,1463,586,877
New Mexico,McKinley County,17,982,390,592
New Mexico,McKinley County,18,827,283,544
New Mexico,Mora County,0,4592,2374,2218
New Mexico,Mora County,1,202,106,96
New Mexico,Mora County,2,228,116,112
New Mexico,Mora County,3,276,149,127
New Mexico,Mora County,4,280,161,119
New Mexico,Mora County,5,238,119,119
New Mexico,Mora County,6,209,107,102
New Mexico,Mora County,7,242,116,126
New Mexico,Mora County,8,179,93,86
New Mexico,Mora County,9,245,124,121
New Mexico,Mora County,10,290,142,148
New Mexico,Mora County,11,364,198,166
New Mexico,Mora County,12,386,188,198
New Mexico,Mora County,13,411,216,195
New Mexico,Mora County,14,363,182,181
New Mexico,Mora County,15,238,142,96
New Mexico,Mora County,16,192,104,88
New Mexico,Mora County,17,147,59,88
New Mexico,Mora County,18,102,52,50
New Mexico,Otero County,0,65082,33165,31917
New Mexico,Otero County,1,4936,2432,2504
New Mexico,Otero County,2,4479,2269,2210
New Mexico,Otero County,3,4038,2047,1991
New Mexico,Otero County,4,3898,2073,1825
New Mexico,Otero County,5,5582,3397,2185
New Mexico,Otero County,6,4949,2671,2278
New Mexico,Otero County,7,4227,2226,2001
New Mexico,Otero County,8,3620,1853,1767
New Mexico,Otero County,9,3366,1709,1657
New Mexico,Otero County,10,3420,1649,1771
New Mexico,Otero County,11,4195,2046,2149
New Mexico,Otero County,12,4143,1984,2159
New Mexico,Otero County,13,3588,1759,1829
New Mexico,Otero County,14,3364,1696,1668
New Mexico,Otero County,15,2602,1267,1335
New Mexico,Otero County,16,2102,996,1106
New Mexico,Otero County,17,1429,639,790
New Mexico,Otero County,18,1144,452,692
New Mexico,Quay County,0,8501,4138,4363
New Mexico,Quay County,1,534,235,299
New Mexico,Quay County,2,463,245,218
New Mexico,Quay County,3,533,267,266
New Mexico,Quay County,4,439,236,203
New Mexico,Quay County,5,429,219,210
New Mexico,Quay County,6,344,175,169
New Mexico,Quay County,7,484,233,251
New Mexico,Quay County,8,395,197,198
New Mexico,Quay County,9,428,186,242
New Mexico,Quay County,10,510,257,253
New Mexico,Quay County,11,600,291,309
New Mexico,Quay County,12,661,316,345
New Mexico,Quay County,13,666,312,354
New Mexico,Quay County,14,655,315,340
New Mexico,Quay County,15,530,261,269
New Mexico,Quay County,16,371,184,187
New Mexico,Quay County,17,274,128,146
New Mexico,Quay County,18,185,81,104
New Mexico,Rio Arriba County,0,39777,19574,20203
New Mexico,Rio Arriba County,1,2824,1359,1465
New Mexico,Rio Arriba County,2,2603,1305,1298
New Mexico,Rio Arriba County,3,2660,1357,1303
New Mexico,Rio Arriba County,4,2532,1265,1267
New Mexico,Rio Arriba County,5,2465,1283,1182
New Mexico,Rio Arriba County,6,2308,1151,1157
New Mexico,Rio Arriba County,7,2261,1112,1149
New Mexico,Rio Arriba County,8,2179,1120,1059
New Mexico,Rio Arriba County,9,2404,1170,1234
New Mexico,Rio Arriba County,10,2340,1187,1153
New Mexico,Rio Arriba County,11,2876,1441,1435
New Mexico,Rio Arriba County,12,2995,1475,1520
New Mexico,Rio Arriba County,13,2763,1329,1434
New Mexico,Rio Arriba County,14,2318,1129,1189
New Mexico,Rio Arriba County,15,1627,782,845
New Mexico,Rio Arriba County,16,1157,537,620
New Mexico,Rio Arriba County,17,784,347,437
New Mexico,Rio Arriba County,18,681,225,456
New Mexico,Roosevelt County,0,19536,9777,9759
New Mexico,Roosevelt County,1,1476,786,690
New Mexico,Roosevelt County,2,1349,694,655
New Mexico,Roosevelt County,3,1244,636,608
New Mexico,Roosevelt County,4,1707,840,867
New Mexico,Roosevelt County,5,2781,1391,1390
New Mexico,Roosevelt County,6,1348,716,632
New Mexico,Roosevelt County,7,1201,633,568
New Mexico,Roosevelt County,8,1007,503,504
New Mexico,Roosevelt County,9,989,495,494
New Mexico,Roosevelt County,10,958,503,455
New Mexico,Roosevelt County,11,1057,531,526
New Mexico,Roosevelt County,12,1051,476,575
New Mexico,Roosevelt County,13,905,453,452
New Mexico,Roosevelt County,14,726,343,383
New Mexico,Roosevelt County,15,617,298,319
New Mexico,Roosevelt County,16,466,210,256
New Mexico,Roosevelt County,17,324,147,177
New Mexico,Roosevelt County,18,330,122,208
New Mexico,Sandoval County,0,137608,67508,70100
New Mexico,Sandoval County,1,7950,4071,3879
New Mexico,Sandoval County,2,9698,4998,4700
New Mexico,Sandoval County,3,10165,5177,4988
New Mexico,Sandoval County,4,9475,4893,4582
New Mexico,Sandoval County,5,7920,4079,3841
New Mexico,Sandoval County,6,7980,4068,3912
New Mexico,Sandoval County,7,8700,4271,4429
New Mexico,Sandoval County,8,8468,4148,4320
New Mexico,Sandoval County,9,9057,4440,4617
New Mexico,Sandoval County,10,8617,4225,4392
New Mexico,Sandoval County,11,10100,4943,5157
New Mexico,Sandoval County,12,9690,4577,5113
New Mexico,Sandoval County,13,8944,4138,4806
New Mexico,Sandoval County,14,7739,3663,4076
New Mexico,Sandoval County,15,5358,2545,2813
New Mexico,Sandoval County,16,3333,1544,1789
New Mexico,Sandoval County,17,2193,930,1263
New Mexico,Sandoval County,18,2221,798,1423
New Mexico,San Juan County,0,123785,61160,62625
New Mexico,San Juan County,1,8986,4445,4541
New Mexico,San Juan County,2,9934,5004,4930
New Mexico,San Juan County,3,9417,4774,4643
New Mexico,San Juan County,4,8339,4231,4108
New Mexico,San Juan County,5,8467,4282,4185
New Mexico,San Juan County,6,8601,4417,4184
New Mexico,San Juan County,7,8729,4416,4313
New Mexico,San Juan County,8,7626,3866,3760
New Mexico,San Juan County,9,7099,3503,3596
New Mexico,San Juan County,10,6807,3314,3493
New Mexico,San Juan County,11,8289,4106,4183
New Mexico,San Juan County,12,8338,4209,4129
New Mexico,San Juan County,13,6994,3422,3572
New Mexico,San Juan County,14,5305,2517,2788
New Mexico,San Juan County,15,3901,1802,2099
New Mexico,San Juan County,16,2903,1264,1639
New Mexico,San Juan County,17,2068,895,1173
New Mexico,San Juan County,18,1982,693,1289
New Mexico,San Miguel County,0,28239,13952,14287
New Mexico,San Miguel County,1,1538,733,805
New Mexico,San Miguel County,2,1472,755,717
New Mexico,San Miguel County,3,1548,792,756
New Mexico,San Miguel County,4,2054,1044,1010
New Mexico,San Miguel County,5,2102,1102,1000
New Mexico,San Miguel County,6,1670,891,779
New Mexico,San Miguel County,7,1517,769,748
New Mexico,San Miguel County,8,1357,641,716
New Mexico,San Miguel County,9,1629,768,861
New Mexico,San Miguel County,10,1665,874,791
New Mexico,San Miguel County,11,2221,1111,1110
New Mexico,San Miguel County,12,2186,1090,1096
New Mexico,San Miguel County,13,2090,993,1097
New Mexico,San Miguel County,14,1796,855,941
New Mexico,San Miguel County,15,1363,667,696
New Mexico,San Miguel County,16,959,442,517
New Mexico,San Miguel County,17,543,247,296
New Mexico,San Miguel County,18,529,178,351
New Mexico,Santa Fe County,0,148164,72191,75973
New Mexico,Santa Fe County,1,7171,3568,3603
New Mexico,Santa Fe County,2,8390,4198,4192
New Mexico,Santa Fe County,3,8332,4146,4186
New Mexico,Santa Fe County,4,8189,4217,3972
New Mexico,Santa Fe County,5,8129,4248,3881
New Mexico,Santa Fe County,6,8236,4248,3988
New Mexico,Santa Fe County,7,8503,4370,4133
New Mexico,Santa Fe County,8,8599,4401,4198
New Mexico,Santa Fe County,9,8839,4443,4396
New Mexico,Santa Fe County,10,9357,4609,4748
New Mexico,Santa Fe County,11,11016,5251,5765
New Mexico,Santa Fe County,12,11728,5484,6244
New Mexico,Santa Fe County,13,12587,5823,6764
New Mexico,Santa Fe County,14,11234,5313,5921
New Mexico,Santa Fe County,15,7380,3416,3964
New Mexico,Santa Fe County,16,4683,2135,2548
New Mexico,Santa Fe County,17,2947,1333,1614
New Mexico,Santa Fe County,18,2844,988,1856
New Mexico,Sierra County,0,11325,5642,5683
New Mexico,Sierra County,1,455,248,207
New Mexico,Sierra County,2,521,243,278
New Mexico,Sierra County,3,452,235,217
New Mexico,Sierra County,4,470,257,213
New Mexico,Sierra County,5,477,233,244
New Mexico,Sierra County,6,479,258,221
New Mexico,Sierra County,7,455,235,220
New Mexico,Sierra County,8,368,190,178
New Mexico,Sierra County,9,442,224,218
New Mexico,Sierra County,10,594,285,309
New Mexico,Sierra County,11,762,370,392
New Mexico,Sierra County,12,916,438,478
New Mexico,Sierra County,13,1084,512,572
New Mexico,Sierra County,14,1126,562,564
New Mexico,Sierra County,15,1006,511,495
New Mexico,Sierra County,16,751,372,379
New Mexico,Sierra County,17,498,265,233
New Mexico,Sierra County,18,469,204,265
New Mexico,Socorro County,0,17310,8805,8505
New Mexico,Socorro County,1,1075,556,519
New Mexico,Socorro County,2,1167,588,579
New Mexico,Socorro County,3,1120,554,566
New Mexico,Socorro County,4,1352,759,593
New Mexico,Socorro County,5,1325,732,593
New Mexico,Socorro County,6,1068,562,506
New Mexico,Socorro County,7,966,515,451
New Mexico,Socorro County,8,901,426,475
New Mexico,Socorro County,9,882,444,438
New Mexico,Socorro County,10,949,465,484
New Mexico,Socorro County,11,1234,601,633
New Mexico,Socorro County,12,1248,596,652
New Mexico,Socorro County,13,1120,569,551
New Mexico,Socorro County,14,979,500,479
New Mexico,Socorro County,15,740,372,368
New Mexico,Socorro County,16,569,294,275
New Mexico,Socorro County,17,329,155,174
New Mexico,Socorro County,18,286,117,169
New Mexico,Taos County,0,33084,16222,16862
New Mexico,Taos County,1,1671,862,809
New Mexico,Taos County,2,1746,882,864
New Mexico,Taos County,3,1822,966,856
New Mexico,Taos County,4,1719,917,802
New Mexico,Taos County,5,1628,857,771
New Mexico,Taos County,6,1617,819,798
New Mexico,Taos County,7,1786,891,895
New Mexico,Taos County,8,1655,801,854
New Mexico,Taos County,9,1918,951,967
New Mexico,Taos County,10,2026,995,1031
New Mexico,Taos County,11,2513,1199,1314
New Mexico,Taos County,12,2638,1266,1372
New Mexico,Taos County,13,2978,1416,1562
New Mexico,Taos County,14,2688,1286,1402
New Mexico,Taos County,15,1870,883,987
New Mexico,Taos County,16,1258,589,669
New Mexico,Taos County,17,789,349,440
New Mexico,Taos County,18,762,293,469
New Mexico,Torrance County,0,15611,8177,7434
New Mexico,Torrance County,1,832,462,370
New Mexico,Torrance County,2,931,439,492
New Mexico,Torrance County,3,1059,557,502
New Mexico,Torrance County,4,1034,560,474
New Mexico,Torrance County,5,934,535,399
New Mexico,Torrance County,6,903,554,349
New Mexico,Torrance County,7,824,424,400
New Mexico,Torrance County,8,829,476,353
New Mexico,Torrance County,9,889,460,429
New Mexico,Torrance County,10,928,483,445
New Mexico,Torrance County,11,1135,536,599
New Mexico,Torrance County,12,1267,638,629
New Mexico,Torrance County,13,1239,631,608
New Mexico,Torrance County,14,1044,530,514
New Mexico,Torrance County,15,746,384,362
New Mexico,Torrance County,16,482,255,227
New Mexico,Torrance County,17,300,146,154
New Mexico,Torrance County,18,235,107,128
New Mexico,Union County,0,4297,2444,1853
New Mexico,Union County,1,210,108,102
New Mexico,Union County,2,225,117,108
New Mexico,Union County,3,222,113,109
New Mexico,Union County,4,224,129,95
New Mexico,Union County,5,288,189,99
New Mexico,Union County,6,315,226,89
New Mexico,Union County,7,307,205,102
New Mexico,Union County,8,261,174,87
New Mexico,Union County,9,269,165,104
New Mexico,Union County,10,255,155,100
New Mexico,Union County,11,312,177,135
New Mexico,Union County,12,313,173,140
New Mexico,Union County,13,248,130,118
New Mexico,Union County,14,237,117,120
New Mexico,Union County,15,211,98,113
New Mexico,Union County,16,157,75,82
New Mexico,Union County,17,126,57,69
New Mexico,Union County,18,117,36,81
New Mexico,Valencia County,0,75817,38089,37728
New Mexico,Valencia County,1,4678,2371,2307
New Mexico,Valencia County,2,5300,2776,2524
New Mexico,Valencia County,3,5364,2703,2661
New Mexico,Valencia County,4,5212,2630,2582
New Mexico,Valencia County,5,4951,2650,2301
New Mexico,Valencia County,6,4534,2335,2199
New Mexico,Valencia County,7,4494,2290,2204
New Mexico,Valencia County,8,4331,2199,2132
New Mexico,Valencia County,9,4543,2309,2234
New Mexico,Valencia County,10,4812,2466,2346
New Mexico,Valencia County,11,5660,2811,2849
New Mexico,Valencia County,12,5372,2598,2774
New Mexico,Valencia County,13,4853,2378,2475
New Mexico,Valencia County,14,4231,2089,2142
New Mexico,Valencia County,15,2957,1438,1519
New Mexico,Valencia County,16,2082,965,1117
New Mexico,Valencia County,17,1372,634,738
New Mexico,Valencia County,18,1071,447,624
New York,Albany County,0,308171,148968,159203
New York,Albany County,1,15418,7852,7566
New York,Albany County,2,15432,7904,7528
New York,Albany County,3,16664,8417,8247
New York,Albany County,4,23929,11882,12047
New York,Albany County,5,32513,16015,16498
New York,Albany County,6,20038,10104,9934
New York,Albany County,7,20049,9897,10152
New York,Albany County,8,17059,8495,8564
New York,Albany County,9,17518,8590,8928
New York,Albany County,10,19651,9643,10008
New York,Albany County,11,22100,10738,11362
New York,Albany County,12,21412,10385,11027
New York,Albany County,13,19133,9106,10027
New York,Albany County,14,15445,7326,8119
New York,Albany County,15,10316,4633,5683
New York,Albany County,16,7451,3108,4343
New York,Albany County,17,6314,2444,3870
New York,Albany County,18,7729,2429,5300
New York,Allegany County,0,47736,24170,23566
New York,Allegany County,1,2421,1242,1179
New York,Allegany County,2,2681,1343,1338
New York,Allegany County,3,2875,1491,1384
New York,Allegany County,4,4693,2559,2134
New York,Allegany County,5,4413,2333,2080
New York,Allegany County,6,2542,1335,1207
New York,Allegany County,7,2400,1171,1229
New York,Allegany County,8,2349,1192,1157
New York,Allegany County,9,2504,1251,1253
New York,Allegany County,10,2749,1352,1397
New York,Allegany County,11,3322,1657,1665
New York,Allegany County,12,3468,1782,1686
New York,Allegany County,13,3179,1583,1596
New York,Allegany County,14,2623,1338,1285
New York,Allegany County,15,1927,963,964
New York,Allegany County,16,1458,694,764
New York,Allegany County,17,1075,503,572
New York,Allegany County,18,1057,381,676
New York,Bronx County,0,1438159,678127,760032
New York,Bronx County,1,108932,55938,52994
New York,Bronx County,2,100020,50841,49179
New York,Bronx County,3,98552,50216,48336
New York,Bronx County,4,100879,51857,49022
New York,Bronx County,5,122910,61672,61238
New York,Bronx County,6,116147,56678,59469
New York,Bronx County,7,104535,49243,55292
New York,Bronx County,8,93259,42805,50454
New York,Bronx County,9,91289,42007,49282
New York,Bronx County,10,95783,44405,51378
New York,Bronx County,11,94813,43222,51591
New York,Bronx County,12,82911,37398,45513
New York,Bronx County,13,66522,29483,37039
New York,Bronx County,14,52100,22243,29857
New York,Bronx County,15,38704,15480,23224
New York,Bronx County,16,28482,11116,17366
New York,Bronx County,17,20109,7027,13082
New York,Bronx County,18,22212,6496,15716
New York,Broome County,0,197349,96996,100353
New York,Broome County,1,10107,5130,4977
New York,Broome County,2,10481,5414,5067
New York,Broome County,3,11180,5810,5370
New York,Broome County,4,15285,7869,7416
New York,Broome County,5,19722,10148,9574
New York,Broome County,6,11265,5890,5375
New York,Broome County,7,11131,5633,5498
New York,Broome County,8,9814,4854,4960
New York,Broome County,9,10242,5072,5170
New York,Broome County,10,11826,5847,5979
New York,Broome County,11,14772,7275,7497
New York,Broome County,12,14665,7266,7399
New York,Broome County,13,12292,6076,6216
New York,Broome County,14,10158,4762,5396
New York,Broome County,15,7540,3458,4082
New York,Broome County,16,6142,2609,3533
New York,Broome County,17,4878,1989,2889
New York,Broome County,18,5849,1894,3955
New York,Cattaraugus County,0,78600,38914,39686
New York,Cattaraugus County,1,4592,2287,2305
New York,Cattaraugus County,2,4976,2499,2477
New York,Cattaraugus County,3,5028,2604,2424
New York,Cattaraugus County,4,5533,2868,2665
New York,Cattaraugus County,5,5189,2647,2542
New York,Cattaraugus County,6,4349,2188,2161
New York,Cattaraugus County,7,4286,2176,2110
New York,Cattaraugus County,8,4127,2046,2081
New York,Cattaraugus County,9,4512,2217,2295
New York,Cattaraugus County,10,5042,2494,2548
New York,Cattaraugus County,11,5900,2954,2946
New York,Cattaraugus County,12,6208,3083,3125
New York,Cattaraugus County,13,5428,2672,2756
New York,Cattaraugus County,14,4384,2197,2187
New York,Cattaraugus County,15,3175,1542,1633
New York,Cattaraugus County,16,2346,1094,1252
New York,Cattaraugus County,17,1747,723,1024
New York,Cattaraugus County,18,1778,623,1155
New York,Cayuga County,0,78823,40268,38555
New York,Cayuga County,1,4119,2125,1994
New York,Cayuga County,2,4262,2234,2028
New York,Cayuga County,3,4626,2347,2279
New York,Cayuga County,4,4987,2544,2443
New York,Cayuga County,5,5094,2698,2396
New York,Cayuga County,6,4792,2712,2080
New York,Cayuga County,7,4855,2612,2243
New York,Cayuga County,8,4343,2346,1997
New York,Cayuga County,9,4806,2589,2217
New York,Cayuga County,10,5537,2928,2609
New York,Cayuga County,11,6395,3235,3160
New York,Cayuga County,12,6277,3122,3155
New York,Cayuga County,13,5252,2697,2555
New York,Cayuga County,14,4350,2147,2203
New York,Cayuga County,15,3113,1501,1612
New York,Cayuga County,16,2229,1031,1198
New York,Cayuga County,17,1675,728,947
New York,Cayuga County,18,2111,672,1439
New York,Chautauqua County,0,132053,65429,66624
New York,Chautauqua County,1,7048,3632,3416
New York,Chautauqua County,2,7500,3858,3642
New York,Chautauqua County,3,7924,4093,3831
New York,Chautauqua County,4,9630,4907,4723
New York,Chautauqua County,5,9282,4891,4391
New York,Chautauqua County,6,8141,4251,3890
New York,Chautauqua County,7,7030,3492,3538
New York,Chautauqua County,8,6710,3300,3410
New York,Chautauqua County,9,7436,3727,3709
New York,Chautauqua County,10,8299,4165,4134
New York,Chautauqua County,11,9809,4887,4922
New York,Chautauqua County,12,10161,5036,5125
New York,Chautauqua County,13,9190,4632,4558
New York,Chautauqua County,14,7310,3535,3775
New York,Chautauqua County,15,5533,2612,2921
New York,Chautauqua County,16,4117,1862,2255
New York,Chautauqua County,17,3213,1334,1879
New York,Chautauqua County,18,3720,1215,2505
New York,Chemung County,0,87770,43566,44204
New York,Chemung County,1,5264,2687,2577
New York,Chemung County,2,5240,2662,2578
New York,Chemung County,3,5475,2786,2689
New York,Chemung County,4,5322,2641,2681
New York,Chemung County,5,5880,2996,2884
New York,Chemung County,6,5202,2785,2417
New York,Chemung County,7,5510,2873,2637
New York,Chemung County,8,4958,2625,2333
New York,Chemung County,9,5141,2667,2474
New York,Chemung County,10,5812,2990,2822
New York,Chemung County,11,6618,3267,3351
New York,Chemung County,12,6619,3226,3393
New York,Chemung County,13,5786,2818,2968
New York,Chemung County,14,4692,2247,2445
New York,Chemung County,15,3363,1557,1806
New York,Chemung County,16,2570,1135,1435
New York,Chemung County,17,2011,822,1189
New York,Chemung County,18,2307,782,1525
New York,Chenango County,0,49426,24704,24722
New York,Chenango County,1,2665,1314,1351
New York,Chenango County,2,2769,1477,1292
New York,Chenango County,3,3099,1571,1528
New York,Chenango County,4,3092,1569,1523
New York,Chenango County,5,2959,1534,1425
New York,Chenango County,6,2541,1342,1199
New York,Chenango County,7,2661,1355,1306
New York,Chenango County,8,2612,1304,1308
New York,Chenango County,9,2953,1448,1505
New York,Chenango County,10,3327,1677,1650
New York,Chenango County,11,3938,1946,1992
New York,Chenango County,12,4073,2034,2039
New York,Chenango County,13,3412,1743,1669
New York,Chenango County,14,3039,1516,1523
New York,Chenango County,15,2324,1186,1138
New York,Chenango County,16,1626,743,883
New York,Chenango County,17,1085,463,622
New York,Chenango County,18,1251,482,769
New York,Clinton County,0,81632,41930,39702
New York,Clinton County,1,3930,1961,1969
New York,Clinton County,2,4121,2115,2006
New York,Clinton County,3,4194,2201,1993
New York,Clinton County,4,5861,2896,2965
New York,Clinton County,5,8057,4053,4004
New York,Clinton County,6,4988,2923,2065
New York,Clinton County,7,5097,2799,2298
New York,Clinton County,8,4709,2634,2075
New York,Clinton County,9,4991,2697,2294
New York,Clinton County,10,5644,3016,2628
New York,Clinton County,11,6563,3396,3167
New York,Clinton County,12,6123,3114,3009
New York,Clinton County,13,4913,2498,2415
New York,Clinton County,14,4136,2004,2132
New York,Clinton County,15,2928,1398,1530
New York,Clinton County,16,2249,1013,1236
New York,Clinton County,17,1673,721,952
New York,Clinton County,18,1455,491,964
New York,Columbia County,0,62122,31200,30922
New York,Columbia County,1,2673,1377,1296
New York,Columbia County,2,3103,1621,1482
New York,Columbia County,3,3359,1714,1645
New York,Columbia County,4,3613,2041,1572
New York,Columbia County,5,3605,1892,1713
New York,Columbia County,6,3133,1633,1500
New York,Columbia County,7,3066,1554,1512
New York,Columbia County,8,3146,1549,1597
New York,Columbia County,9,3615,1771,1844
New York,Columbia County,10,4526,2302,2224
New York,Columbia County,11,5230,2641,2589
New York,Columbia County,12,5173,2627,2546
New York,Columbia County,13,4922,2423,2499
New York,Columbia County,14,4305,2151,2154
New York,Columbia County,15,3173,1549,1624
New York,Columbia County,16,2111,945,1166
New York,Columbia County,17,1650,756,894
New York,Columbia County,18,1719,654,1065
New York,Cortland County,0,49024,23936,25088
New York,Cortland County,1,2349,1189,1160
New York,Cortland County,2,2725,1386,1339
New York,Cortland County,3,2778,1419,1359
New York,Cortland County,4,4719,2252,2467
New York,Cortland County,5,6079,2802,3277
New York,Cortland County,6,2815,1475,1340
New York,Cortland County,7,2530,1220,1310
New York,Cortland County,8,2501,1290,1211
New York,Cortland County,9,2636,1316,1320
New York,Cortland County,10,2985,1494,1491
New York,Cortland County,11,3465,1725,1740
New York,Cortland County,12,3215,1612,1603
New York,Cortland County,13,2894,1426,1468
New York,Cortland County,14,2430,1174,1256
New York,Cortland County,15,1761,832,929
New York,Cortland County,16,1243,608,635
New York,Cortland County,17,924,379,545
New York,Cortland County,18,975,337,638
New York,Delaware County,0,46581,23430,23151
New York,Delaware County,1,2216,1123,1093
New York,Delaware County,2,2302,1146,1156
New York,Delaware County,3,2266,1162,1104
New York,Delaware County,4,3489,1883,1606
New York,Delaware County,5,3027,1588,1439
New York,Delaware County,6,2297,1202,1095
New York,Delaware County,7,2154,1078,1076
New York,Delaware County,8,2125,1050,1075
New York,Delaware County,9,2460,1233,1227
New York,Delaware County,10,2905,1478,1427
New York,Delaware County,11,3628,1797,1831
New York,Delaware County,12,3882,1993,1889
New York,Delaware County,13,3637,1832,1805
New York,Delaware County,14,3317,1675,1642
New York,Delaware County,15,2598,1310,1288
New York,Delaware County,16,1764,856,908
New York,Delaware County,17,1296,581,715
New York,Delaware County,18,1218,443,775
New York,Dutchess County,0,296579,147592,148987
New York,Dutchess County,1,14113,7202,6911
New York,Dutchess County,2,15552,8008,7544
New York,Dutchess County,3,18027,9110,8917
New York,Dutchess County,4,22764,11604,11160
New York,Dutchess County,5,23077,11799,11278
New York,Dutchess County,6,16902,8995,7907
New York,Dutchess County,7,16282,8468,7814
New York,Dutchess County,8,16149,8240,7909
New York,Dutchess County,9,18891,9449,9442
New York,Dutchess County,10,22504,11200,11304
New York,Dutchess County,11,25110,12572,12538
New York,Dutchess County,12,22831,11549,11282
New York,Dutchess County,13,18426,9067,9359
New York,Dutchess County,14,14908,7057,7851
New York,Dutchess County,15,10801,4977,5824
New York,Dutchess County,16,7765,3518,4247
New York,Dutchess County,17,6229,2667,3562
New York,Dutchess County,18,6248,2110,4138
New York,Erie County,0,922835,446774,476061
New York,Erie County,1,49954,25437,24517
New York,Erie County,2,50483,25795,24688
New York,Erie County,3,55642,28428,27214
New York,Erie County,4,60387,30639,29748
New York,Erie County,5,67666,34319,33347
New York,Erie County,6,67565,34263,33302
New York,Erie County,7,56886,28455,28431
New York,Erie County,8,49180,24344,24836
New York,Erie County,9,53709,26249,27460
New York,Erie County,10,61539,29950,31589
New York,Erie County,11,68807,33323,35484
New York,Erie County,12,69985,33598,36387
New York,Erie County,13,58397,27819,30578
New York,Erie County,14,46548,21821,24727
New York,Erie County,15,34413,15304,19109
New York,Erie County,16,25824,10879,14945
New York,Erie County,17,20978,8159,12819
New York,Erie County,18,24872,7992,16880
New York,Essex County,0,38679,20152,18527
New York,Essex County,1,1634,832,802
New York,Essex County,2,1773,908,865
New York,Essex County,3,1865,959,906
New York,Essex County,4,2262,1233,1029
New York,Essex County,5,2140,1235,905
New York,Essex County,6,2242,1329,913
New York,Essex County,7,2263,1339,924
New York,Essex County,8,2181,1202,979
New York,Essex County,9,2292,1253,1039
New York,Essex County,10,2680,1418,1262
New York,Essex County,11,3107,1557,1550
New York,Essex County,12,3146,1586,1560
New York,Essex County,13,2979,1505,1474
New York,Essex County,14,2513,1270,1243
New York,Essex County,15,2005,1003,1002
New York,Essex County,16,1400,649,751
New York,Essex County,17,1072,481,591
New York,Essex County,18,1125,393,732
New York,Franklin County,0,51262,28118,23144
New York,Franklin County,1,2679,1366,1313
New York,Franklin County,2,2895,1444,1451
New York,Franklin County,3,2856,1473,1383
New York,Franklin County,4,3217,1785,1432
New York,Franklin County,5,3889,2487,1402
New York,Franklin County,6,3618,2322,1296
New York,Franklin County,7,3579,2178,1401
New York,Franklin County,8,3094,1834,1260
New York,Franklin County,9,3288,1920,1368
New York,Franklin County,10,3666,2063,1603
New York,Franklin County,11,3983,2126,1857
New York,Franklin County,12,3742,1935,1807
New York,Franklin County,13,3137,1638,1499
New York,Franklin County,14,2600,1311,1289
New York,Franklin County,15,1838,893,945
New York,Franklin County,16,1307,602,705
New York,Franklin County,17,993,418,575
New York,Franklin County,18,881,323,558
New York,Fulton County,0,54105,26758,27347
New York,Fulton County,1,2711,1405,1306
New York,Fulton County,2,3068,1556,1512
New York,Fulton County,3,3321,1691,1630
New York,Fulton County,4,3311,1713,1598
New York,Fulton County,5,3257,1656,1601
New York,Fulton County,6,3052,1586,1466
New York,Fulton County,7,3205,1606,1599
New York,Fulton County,8,2981,1508,1473
New York,Fulton County,9,3465,1720,1745
New York,Fulton County,10,3822,1931,1891
New York,Fulton County,11,4393,2208,2185
New York,Fulton County,12,4085,2027,2058
New York,Fulton County,13,3667,1813,1854
New York,Fulton County,14,3225,1599,1626
New York,Fulton County,15,2255,1032,1223
New York,Fulton County,16,1690,778,912
New York,Fulton County,17,1188,493,695
New York,Fulton County,18,1409,436,973
New York,Genesee County,0,59162,29516,29646
New York,Genesee County,1,3095,1613,1482
New York,Genesee County,2,3387,1729,1658
New York,Genesee County,3,3487,1761,1726
New York,Genesee County,4,3831,1938,1893
New York,Genesee County,5,3905,2026,1879
New York,Genesee County,6,3481,1892,1589
New York,Genesee County,7,3436,1771,1665
New York,Genesee County,8,3045,1615,1430
New York,Genesee County,9,3603,1824,1779
New York,Genesee County,10,4241,2107,2134
New York,Genesee County,11,4899,2460,2439
New York,Genesee County,12,4769,2375,2394
New York,Genesee County,13,3825,1906,1919
New York,Genesee County,14,3079,1505,1574
New York,Genesee County,15,2375,1117,1258
New York,Genesee County,16,1773,806,967
New York,Genesee County,17,1358,587,771
New York,Genesee County,18,1573,484,1089
New York,Greene County,0,47967,24983,22984
New York,Greene County,1,2121,1034,1087
New York,Greene County,2,2192,1157,1035
New York,Greene County,3,2344,1158,1186
New York,Greene County,4,2948,1750,1198
New York,Greene County,5,3329,2101,1228
New York,Greene County,6,2657,1458,1199
New York,Greene County,7,2493,1369,1124
New York,Greene County,8,2534,1346,1188
New York,Greene County,9,2925,1500,1425
New York,Greene County,10,3395,1824,1571
New York,Greene County,11,4032,2082,1950
New York,Greene County,12,3855,1938,1917
New York,Greene County,13,3568,1803,1765
New York,Greene County,14,3184,1545,1639
New York,Greene County,15,2434,1195,1239
New York,Greene County,16,1618,790,828
New York,Greene County,17,1181,505,676
New York,Greene County,18,1157,428,729
New York,Hamilton County,0,4715,2391,2324
New York,Hamilton County,1,160,77,83
New York,Hamilton County,2,185,112,73
New York,Hamilton County,3,224,112,112
New York,Hamilton County,4,226,119,107
New York,Hamilton County,5,207,100,107
New York,Hamilton County,6,153,85,68
New York,Hamilton County,7,187,90,97
New York,Hamilton County,8,174,89,85
New York,Hamilton County,9,252,132,120
New York,Hamilton County,10,303,154,149
New York,Hamilton County,11,388,196,192
New York,Hamilton County,12,474,237,237
New York,Hamilton County,13,518,268,250
New York,Hamilton County,14,455,231,224
New York,Hamilton County,15,327,169,158
New York,Hamilton County,16,192,97,95
New York,Hamilton County,17,148,68,80
New York,Hamilton County,18,142,55,87
New York,Herkimer County,0,63744,31399,32345
New York,Herkimer County,1,3416,1761,1655
New York,Herkimer County,2,3668,1823,1845
New York,Herkimer County,3,3905,2001,1904
New York,Herkimer County,4,4178,2155,2023
New York,Herkimer County,5,4075,2021,2054
New York,Herkimer County,6,3536,1762,1774
New York,Herkimer County,7,3444,1752,1692
New York,Herkimer County,8,3226,1611,1615
New York,Herkimer County,9,3731,1848,1883
New York,Herkimer County,10,4212,2089,2123
New York,Herkimer County,11,4983,2495,2488
New York,Herkimer County,12,4904,2440,2464
New York,Herkimer County,13,4473,2215,2258
New York,Herkimer County,14,3751,1904,1847
New York,Herkimer County,15,2813,1327,1486
New York,Herkimer County,16,2079,972,1107
New York,Herkimer County,17,1540,640,900
New York,Herkimer County,18,1810,583,1227
New York,Jefferson County,0,119103,62283,56820
New York,Jefferson County,1,10360,5250,5110
New York,Jefferson County,2,8038,4110,3928
New York,Jefferson County,3,7059,3525,3534
New York,Jefferson County,4,6838,3658,3180
New York,Jefferson County,5,12734,7903,4831
New York,Jefferson County,6,11149,6444,4705
New York,Jefferson County,7,9146,4956,4190
New York,Jefferson County,8,7120,3812,3308
New York,Jefferson County,9,6531,3407,3124
New York,Jefferson County,10,6569,3351,3218
New York,Jefferson County,11,6987,3439,3548
New York,Jefferson County,12,6560,3211,3349
New York,Jefferson County,13,5480,2725,2755
New York,Jefferson County,14,4785,2342,2443
New York,Jefferson County,15,3554,1718,1836
New York,Jefferson County,16,2420,1091,1329
New York,Jefferson County,17,1821,735,1086
New York,Jefferson County,18,1952,606,1346
New York,Kings County,0,2621793,1242763,1379030
New York,Kings County,1,199420,102108,97312
New York,Kings County,2,164330,83760,80570
New York,Kings County,3,155396,79399,75997
New York,Kings County,4,149447,75396,74051
New York,Kings County,5,189693,92424,97269
New York,Kings County,6,244792,118207,126585
New York,Kings County,7,227681,109812,117869
New York,Kings County,8,191534,92219,99315
New York,Kings County,9,172024,81683,90341
New York,Kings County,10,160161,74791,85370
New York,Kings County,11,162125,74742,87383
New York,Kings County,12,154010,70373,83637
New York,Kings County,13,133625,59593,74032
New York,Kings County,14,106271,46769,59502
New York,Kings County,15,70741,29619,41122
New York,Kings County,16,56130,22662,33468
New York,Kings County,17,39001,14643,24358
New York,Kings County,18,45412,14563,30849
New York,Lewis County,0,27220,13784,13436
New York,Lewis County,1,1716,880,836
New York,Lewis County,2,1743,923,820
New York,Lewis County,3,1806,904,902
New York,Lewis County,4,1779,902,877
New York,Lewis County,5,1609,842,767
New York,Lewis County,6,1487,781,706
New York,Lewis County,7,1580,796,784
New York,Lewis County,8,1491,752,739
New York,Lewis County,9,1619,834,785
New York,Lewis County,10,1722,889,833
New York,Lewis County,11,2194,1128,1066
New York,Lewis County,12,2157,1109,1048
New York,Lewis County,13,1786,894,892
New York,Lewis County,14,1373,709,664
New York,Lewis County,15,1065,526,539
New York,Lewis County,16,825,387,438
New York,Lewis County,17,648,291,357
New York,Lewis County,18,620,237,383
New York,Livingston County,0,64586,32368,32218
New York,Livingston County,1,2806,1466,1340
New York,Livingston County,2,3312,1677,1635
New York,Livingston County,3,3614,1862,1752
New York,Livingston County,4,5712,2755,2957
New York,Livingston County,5,6882,3342,3540
New York,Livingston County,6,3233,1856,1377
New York,Livingston County,7,3355,1779,1576
New York,Livingston County,8,3191,1724,1467
New York,Livingston County,9,3740,1989,1751
New York,Livingston County,10,4413,2233,2180
New York,Livingston County,11,5084,2556,2528
New York,Livingston County,12,4920,2497,2423
New York,Livingston County,13,4146,2059,2087
New York,Livingston County,14,3354,1632,1722
New York,Livingston County,15,2371,1128,1243
New York,Livingston County,16,1712,784,928
New York,Livingston County,17,1292,536,756
New York,Livingston County,18,1449,493,956
New York,Madison County,0,72369,35628,36741
New York,Madison County,1,3412,1770,1642
New York,Madison County,2,4016,2013,2003
New York,Madison County,3,4377,2195,2182
New York,Madison County,4,6499,3184,3315
New York,Madison County,5,5978,2978,3000
New York,Madison County,6,3801,1938,1863
New York,Madison County,7,3723,1891,1832
New York,Madison County,8,3615,1794,1821
New York,Madison County,9,4125,2022,2103
New York,Madison County,10,4998,2491,2507
New York,Madison County,11,5830,2872,2958
New York,Madison County,12,5775,2841,2934
New York,Madison County,13,4747,2390,2357
New York,Madison County,14,3787,1852,1935
New York,Madison County,15,2855,1366,1489
New York,Madison County,16,2036,944,1092
New York,Madison County,17,1381,598,783
New York,Madison County,18,1414,489,925
New York,Monroe County,0,749857,362304,387553
New York,Monroe County,1,42241,21436,20805
New York,Monroe County,2,43499,22210,21289
New York,Monroe County,3,46026,23551,22475
New York,Monroe County,4,53026,27141,25885
New York,Monroe County,5,56989,28574,28415
New York,Monroe County,6,55126,27612,27514
New York,Monroe County,7,47614,23393,24221
New York,Monroe County,8,41116,19674,21442
New York,Monroe County,9,43981,21081,22900
New York,Monroe County,10,49749,24007,25742
New York,Monroe County,11,55517,26655,28862
New York,Monroe County,12,53241,25791,27450
New York,Monroe County,13,45684,21723,23961
New York,Monroe County,14,37095,17118,19977
New York,Monroe County,15,26599,12042,14557
New York,Monroe County,16,18933,8190,10743
New York,Monroe County,17,14806,5985,8821
New York,Monroe County,18,18615,6121,12494
New York,Montgomery County,0,49779,24545,25234
New York,Montgomery County,1,2914,1533,1381
New York,Montgomery County,2,3111,1628,1483
New York,Montgomery County,3,3192,1664,1528
New York,Montgomery County,4,3118,1606,1512
New York,Montgomery County,5,3039,1535,1504
New York,Montgomery County,6,3015,1537,1478
New York,Montgomery County,7,3009,1469,1540
New York,Montgomery County,8,2738,1362,1376
New York,Montgomery County,9,3071,1508,1563
New York,Montgomery County,10,3209,1585,1624
New York,Montgomery County,11,3530,1719,1811
New York,Montgomery County,12,3678,1823,1855
New York,Montgomery County,13,3366,1720,1646
New York,Montgomery County,14,2745,1330,1415
New York,Montgomery County,15,1905,920,985
New York,Montgomery County,16,1370,581,789
New York,Montgomery County,17,1195,484,711
New York,Montgomery County,18,1574,541,1033
New York,Nassau County,0,1358627,658610,700017
New York,Nassau County,1,73351,37381,35970
New York,Nassau County,2,80756,41426,39330
New York,Nassau County,3,88566,45531,43035
New York,Nassau County,4,92878,47695,45183
New York,Nassau County,5,86490,43797,42693
New York,Nassau County,6,77671,39747,37924
New York,Nassau County,7,75716,37543,38173
New York,Nassau County,8,78344,38404,39940
New York,Nassau County,9,87284,42464,44820
New York,Nassau County,10,99395,47749,51646
New York,Nassau County,11,108624,52366,56258
New York,Nassau County,12,101643,48942,52701
New York,Nassau County,13,84864,40634,44230
New York,Nassau County,14,68904,32636,36268
New York,Nassau County,15,48237,21599,26638
New York,Nassau County,16,36788,15318,21470
New York,Nassau County,17,31006,12259,18747
New York,Nassau County,18,38110,13119,24991
New York,New York County,0,1636268,772708,863560
New York,New York County,1,85268,43681,41587
New York,New York County,2,63025,31992,31033
New York,New York County,3,57647,29230,28417
New York,New York County,4,70961,33229,37732
New York,New York County,5,120283,54685,65598
New York,New York County,6,199984,91700,108284
New York,New York County,7,172251,83625,88626
New York,New York County,8,128050,63833,64217
New York,New York County,9,111718,55801,55917
New York,New York County,10,105144,53270,51874
New York,New York County,11,102050,50825,51225
New York,New York County,12,96045,45711,50334
New York,New York County,13,88937,40096,48841
New York,New York County,14,74369,31722,42647
New York,New York County,15,55675,23203,32472
New York,New York County,16,41241,16969,24272
New York,New York County,17,29571,11932,17639
New York,New York County,18,34049,11204,22845
New York,Niagara County,0,213525,104006,109519
New York,Niagara County,1,11022,5653,5369
New York,Niagara County,2,11610,5841,5769
New York,Niagara County,3,12773,6530,6243
New York,Niagara County,4,13285,6807,6478
New York,Niagara County,5,14241,7126,7115
New York,Niagara County,6,13200,6710,6490
New York,Niagara County,7,12137,6001,6136
New York,Niagara County,8,11451,5603,5848
New York,Niagara County,9,12646,6250,6396
New York,Niagara County,10,14599,7062,7537
New York,Niagara County,11,17399,8489,8910
New York,Niagara County,12,17589,8674,8915
New York,Niagara County,13,14522,7175,7347
New York,Niagara County,14,11770,5685,6085
New York,Niagara County,15,8438,3866,4572
New York,Niagara County,16,6211,2699,3512
New York,Niagara County,17,4989,1989,3000
New York,Niagara County,18,5643,1846,3797
New York,Oneida County,0,232871,115956,116915
New York,Oneida County,1,13392,6760,6632
New York,Oneida County,2,13598,6966,6632
New York,Oneida County,3,13840,7059,6781
New York,Oneida County,4,15390,8020,7370
New York,Oneida County,5,16540,8722,7818
New York,Oneida County,6,14540,7656,6884
New York,Oneida County,7,13813,7193,6620
New York,Oneida County,8,12213,6189,6024
New York,Oneida County,9,13935,7105,6830
New York,Oneida County,10,15698,8069,7629
New York,Oneida County,11,17636,8917,8719
New York,Oneida County,12,16897,8394,8503
New York,Oneida County,13,14698,7305,7393
New York,Oneida County,14,12434,5944,6490
New York,Oneida County,15,9116,4192,4924
New York,Oneida County,16,6731,2965,3766
New York,Oneida County,17,5479,2214,3265
New York,Oneida County,18,6921,2286,4635
New York,Onondaga County,0,468196,226044,242152
New York,Onondaga County,1,27026,13662,13364
New York,Onondaga County,2,27470,14157,13313
New York,Onondaga County,3,29551,15080,14471
New York,Onondaga County,4,34302,16931,17371
New York,Onondaga County,5,34526,16959,17567
New York,Onondaga County,6,32330,16173,16157
New York,Onondaga County,7,28930,14220,14710
New York,Onondaga County,8,25553,12338,13215
New York,Onondaga County,9,27146,13096,14050
New York,Onondaga County,10,31458,15285,16173
New York,Onondaga County,11,35488,17187,18301
New York,Onondaga County,12,34008,16472,17536
New York,Onondaga County,13,28735,13814,14921
New York,Onondaga County,14,22324,10482,11842
New York,Onondaga County,15,15988,7211,8777
New York,Onondaga County,16,11845,5065,6780
New York,Onondaga County,17,9798,3970,5828
New York,Onondaga County,18,11718,3942,7776
New York,Ontario County,0,109707,53909,55798
New York,Ontario County,1,5449,2834,2615
New York,Ontario County,2,6251,3195,3056
New York,Ontario County,3,6881,3579,3302
New York,Ontario County,4,7382,3694,3688
New York,Ontario County,5,7467,3854,3613
New York,Ontario County,6,5868,3013,2855
New York,Ontario County,7,5738,2846,2892
New York,Ontario County,8,5640,2788,2852
New York,Ontario County,9,6555,3236,3319
New York,Ontario County,10,7829,3852,3977
New York,Ontario County,11,8906,4311,4595
New York,Ontario County,12,8521,4205,4316
New York,Ontario County,13,7792,3826,3966
New York,Ontario County,14,6669,3223,3446
New York,Ontario County,15,4547,2155,2392
New York,Ontario County,16,3187,1425,1762
New York,Ontario County,17,2276,971,1305
New York,Ontario County,18,2749,902,1847
New York,Orange County,0,376099,188196,187903
New York,Orange County,1,24606,12620,11986
New York,Orange County,2,27178,13939,13239
New York,Orange County,3,28419,14606,13813
New York,Orange County,4,29181,15566,13615
New York,Orange County,5,29102,16525,12577
New York,Orange County,6,20151,10365,9786
New York,Orange County,7,21474,10664,10810
New York,Orange County,8,21487,10716,10771
New York,Orange County,9,25057,12208,12849
New York,Orange County,10,27529,13532,13997
New York,Orange County,11,28781,14142,14639
New York,Orange County,12,25358,12719,12639
New York,Orange County,13,20474,9847,10627
New York,Orange County,14,16273,7754,8519
New York,Orange County,15,11322,5222,6100
New York,Orange County,16,7714,3374,4340
New York,Orange County,17,5824,2357,3467
New York,Orange County,18,6169,2040,4129
New York,Orleans County,0,41984,20862,21122
New York,Orleans County,1,2046,1054,992
New York,Orleans County,2,2272,1143,1129
New York,Orleans County,3,2540,1252,1288
New York,Orleans County,4,2685,1415,1270
New York,Orleans County,5,3044,1626,1418
New York,Orleans County,6,2569,1349,1220
New York,Orleans County,7,2481,1231,1250
New York,Orleans County,8,2209,1103,1106
New York,Orleans County,9,2638,1270,1368
New York,Orleans County,10,3075,1518,1557
New York,Orleans County,11,3622,1838,1784
New York,Orleans County,12,3335,1659,1676
New York,Orleans County,13,2675,1324,1351
New York,Orleans County,14,2268,1120,1148
New York,Orleans County,15,1649,790,859
New York,Orleans County,16,1182,542,640
New York,Orleans County,17,828,355,473
New York,Orleans County,18,866,273,593
New York,Oswego County,0,120913,60498,60415
New York,Oswego County,1,6704,3451,3253
New York,Oswego County,2,7119,3654,3465
New York,Oswego County,3,7601,3944,3657
New York,Oswego County,4,9256,4554,4702
New York,Oswego County,5,9612,4990,4622
New York,Oswego County,6,7519,3984,3535
New York,Oswego County,7,6734,3367,3367
New York,Oswego County,8,6334,3148,3186
New York,Oswego County,9,7246,3548,3698
New York,Oswego County,10,8732,4394,4338
New York,Oswego County,11,9959,5027,4932
New York,Oswego County,12,9037,4614,4423
New York,Oswego County,13,7560,3796,3764
New York,Oswego County,14,5995,3002,2993
New York,Oswego County,15,4428,2085,2343
New York,Oswego County,16,2916,1325,1591
New York,Oswego County,17,2009,889,1120
New York,Oswego County,18,2152,726,1426
New York,Otsego County,0,61128,29736,31392
New York,Otsego County,1,2523,1346,1177
New York,Otsego County,2,2719,1385,1334
New York,Otsego County,3,2952,1487,1465
New York,Otsego County,4,5684,2641,3043
New York,Otsego County,5,7161,3390,3771
New York,Otsego County,6,2913,1548,1365
New York,Otsego County,7,2916,1483,1433
New York,Otsego County,8,2643,1356,1287
New York,Otsego County,9,3154,1565,1589
New York,Otsego County,10,3695,1813,1882
New York,Otsego County,11,4542,2277,2265
New York,Otsego County,12,4574,2161,2413
New York,Otsego County,13,4300,2090,2210
New York,Otsego County,14,3642,1775,1867
New York,Otsego County,15,2765,1340,1425
New York,Otsego County,16,1893,923,970
New York,Otsego County,17,1437,600,837
New York,Otsego County,18,1615,556,1059
New York,Putnam County,0,99487,49527,49960
New York,Putnam County,1,4520,2263,2257
New York,Putnam County,2,5538,2844,2694
New York,Putnam County,3,6797,3484,3313
New York,Putnam County,4,6931,3592,3339
New York,Putnam County,5,5994,3204,2790
New York,Putnam County,6,4966,2636,2330
New York,Putnam County,7,5039,2605,2434
New York,Putnam County,8,5368,2678,2690
New York,Putnam County,9,6925,3398,3527
New York,Putnam County,10,8518,4211,4307
New York,Putnam County,11,9417,4581,4836
New York,Putnam County,12,8251,4158,4093
New York,Putnam County,13,6507,3227,3280
New York,Putnam County,14,5222,2552,2670
New York,Putnam County,15,3698,1757,1941
New York,Putnam County,16,2393,1081,1312
New York,Putnam County,17,1625,690,935
New York,Putnam County,18,1778,566,1212
New York,Queens County,0,2321580,1126005,1195575
New York,Queens County,1,146405,74809,71596
New York,Queens County,2,126688,64954,61734
New York,Queens County,3,124680,63600,61080
New York,Queens County,4,123265,63031,60234
New York,Queens County,5,159906,79761,80145
New York,Queens County,6,193021,96319,96702
New York,Queens County,7,186196,92910,93286
New York,Queens County,8,168779,83956,84823
New York,Queens County,9,162970,81125,81845
New York,Queens County,10,161232,79335,81897
New York,Queens County,11,166398,80700,85698
New York,Queens County,12,155958,74323,81635
New York,Queens County,13,130366,60511,69855
New York,Queens County,14,101664,45859,55805
New York,Queens County,15,72670,31153,41517
New York,Queens County,16,55541,23191,32350
New York,Queens County,17,39836,15362,24474
New York,Queens County,18,46005,15106,30899
New York,Rensselaer County,0,159774,78905,80869
New York,Rensselaer County,1,8501,4416,4085
New York,Rensselaer County,2,8761,4486,4275
New York,Rensselaer County,3,9179,4587,4592
New York,Rensselaer County,4,11142,6091,5051
New York,Rensselaer County,5,11841,6350,5491
New York,Rensselaer County,6,11452,5891,5561
New York,Rensselaer County,7,10042,4910,5132
New York,Rensselaer County,8,9104,4510,4594
New York,Rensselaer County,9,9753,4805,4948
New York,Rensselaer County,10,10977,5349,5628
New York,Rensselaer County,11,12342,5949,6393
New York,Rensselaer County,12,11969,5820,6149
New York,Rensselaer County,13,10375,5093,5282
New York,Rensselaer County,14,8385,4038,4347
New York,Rensselaer County,15,5602,2556,3046
New York,Rensselaer County,16,4008,1766,2242
New York,Rensselaer County,17,2957,1214,1743
New York,Rensselaer County,18,3384,1074,2310
New York,Richmond County,0,473279,228841,244438
New York,Richmond County,1,27521,13947,13574
New York,Richmond County,2,28808,14800,14008
New York,Richmond County,3,30269,15481,14788
New York,Richmond County,4,29602,15224,14378
New York,Richmond County,5,32480,16173,16307
New York,Richmond County,6,31643,16135,15508
New York,Richmond County,7,29647,14667,14980
New York,Richmond County,8,29989,14470,15519
New York,Richmond County,9,31934,15433,16501
New York,Richmond County,10,33727,16210,17517
New York,Richmond County,11,35689,17134,18555
New York,Richmond County,12,34128,16319,17809
New York,Richmond County,13,28757,13444,15313
New York,Richmond County,14,23918,11030,12888
New York,Richmond County,15,16516,7470,9046
New York,Richmond County,16,11256,4784,6472
New York,Richmond County,17,8389,3307,5082
New York,Richmond County,18,9006,2813,6193
New York,Rockland County,0,323866,158772,165094
New York,Rockland County,1,24425,12477,11948
New York,Rockland County,2,25010,12870,12140
New York,Rockland County,3,25091,12853,12238
New York,Rockland County,4,23956,12319,11637
New York,Rockland County,5,21877,11069,10808
New York,Rockland County,6,18682,9744,8938
New York,Rockland County,7,18148,9225,8923
New York,Rockland County,8,17769,8835,8934
New York,Rockland County,9,18603,9014,9589
New York,Rockland County,10,21183,10345,10838
New York,Rockland County,11,22447,10951,11496
New York,Rockland County,12,20896,10187,10709
New York,Rockland County,13,17685,8419,9266
New York,Rockland County,14,15240,6903,8337
New York,Rockland County,15,11161,5017,6144
New York,Rockland County,16,8408,3561,4847
New York,Rockland County,17,6419,2646,3773
New York,Rockland County,18,6866,2337,4529
New York,Saratoga County,0,224921,111196,113725
New York,Saratoga County,1,11552,5820,5732
New York,Saratoga County,2,12932,6600,6332
New York,Saratoga County,3,14239,7369,6870
New York,Saratoga County,4,14244,7174,7070
New York,Saratoga County,5,13572,7193,6379
New York,Saratoga County,6,12887,6746,6141
New York,Saratoga County,7,13315,6665,6650
New York,Saratoga County,8,13590,6716,6874
New York,Saratoga County,9,15754,7825,7929
New York,Saratoga County,10,17504,8676,8828
New York,Saratoga County,11,18224,8986,9238
New York,Saratoga County,12,16935,8283,8652
New York,Saratoga County,13,14509,7122,7387
New York,Saratoga County,14,12529,6010,6519
New York,Saratoga County,15,8701,4112,4589
New York,Saratoga County,16,5728,2580,3148
New York,Saratoga County,17,4101,1729,2372
New York,Saratoga County,18,4605,1590,3015
New York,Schenectady County,0,155735,75851,79884
New York,Schenectady County,1,9372,4803,4569
New York,Schenectady County,2,9360,4838,4522
New York,Schenectady County,3,9642,4909,4733
New York,Schenectady County,4,10322,5362,4960
New York,Schenectady County,5,10665,5459,5206
New York,Schenectady County,6,9862,4948,4914
New York,Schenectady County,7,9928,4888,5040
New York,Schenectady County,8,9230,4528,4702
New York,Schenectady County,9,9715,4785,4930
New York,Schenectady County,10,10583,5127,5456
New York,Schenectady County,11,11823,5694,6129
New York,Schenectady County,12,11361,5596,5765
New York,Schenectady County,13,9576,4658,4918
New York,Schenectady County,14,7483,3537,3946
New York,Schenectady County,15,5338,2386,2952
New York,Schenectady County,16,3764,1579,2185
New York,Schenectady County,17,3336,1271,2065
New York,Schenectady County,18,4375,1483,2892
New York,Schoharie County,0,31566,15715,15851
New York,Schoharie County,1,1447,684,763
New York,Schoharie County,2,1560,793,767
New York,Schoharie County,3,1772,888,884
New York,Schoharie County,4,2495,1269,1226
New York,Schoharie County,5,2215,1117,1098
New York,Schoharie County,6,1579,844,735
New York,Schoharie County,7,1589,813,776
New York,Schoharie County,8,1586,775,811
New York,Schoharie County,9,1847,933,914
New York,Schoharie County,10,2165,1089,1076
New York,Schoharie County,11,2509,1245,1264
New York,Schoharie County,12,2514,1242,1272
New York,Schoharie County,13,2399,1185,1214
New York,Schoharie County,14,2001,1003,998
New York,Schoharie County,15,1485,750,735
New York,Schoharie County,16,1005,492,513
New York,Schoharie County,17,724,337,387
New York,Schoharie County,18,674,256,418
New York,Schuyler County,0,18479,9307,9172
New York,Schuyler County,1,947,510,437
New York,Schuyler County,2,933,471,462
New York,Schuyler County,3,1057,544,513
New York,Schuyler County,4,1090,581,509
New York,Schuyler County,5,1101,614,487
New York,Schuyler County,6,966,525,441
New York,Schuyler County,7,988,475,513
New York,Schuyler County,8,935,459,476
New York,Schuyler County,9,1127,574,553
New York,Schuyler County,10,1304,657,647
New York,Schuyler County,11,1510,748,762
New York,Schuyler County,12,1577,783,794
New York,Schuyler County,13,1399,717,682
New York,Schuyler County,14,1152,573,579
New York,Schuyler County,15,895,464,431
New York,Schuyler County,16,654,288,366
New York,Schuyler County,17,457,203,254
New York,Schuyler County,18,387,121,266
New York,Seneca County,0,34884,18224,16660
New York,Seneca County,1,1796,866,930
New York,Seneca County,2,1907,972,935
New York,Seneca County,3,2018,1047,971
New York,Seneca County,4,2060,1064,996
New York,Seneca County,5,2516,1510,1006
New York,Seneca County,6,2474,1491,983
New York,Seneca County,7,2065,1175,890
New York,Seneca County,8,1817,1014,803
New York,Seneca County,9,2109,1126,983
New York,Seneca County,10,2241,1187,1054
New York,Seneca County,11,2680,1388,1292
New York,Seneca County,12,2746,1413,1333
New York,Seneca County,13,2375,1167,1208
New York,Seneca County,14,2064,995,1069
New York,Seneca County,15,1414,695,719
New York,Seneca County,16,985,473,512
New York,Seneca County,17,750,329,421
New York,Seneca County,18,867,312,555
New York,Steuben County,0,98394,48782,49612
New York,Steuben County,1,5619,2749,2870
New York,Steuben County,2,5999,3044,2955
New York,Steuben County,3,6395,3268,3127
New York,Steuben County,4,6214,3160,3054
New York,Steuben County,5,5911,2969,2942
New York,Steuben County,6,5406,2793,2613
New York,Steuben County,7,5718,2925,2793
New York,Steuben County,8,5428,2717,2711
New York,Steuben County,9,5924,2925,2999
New York,Steuben County,10,6648,3339,3309
New York,Steuben County,11,7598,3826,3772
New York,Steuben County,12,7565,3834,3731
New York,Steuben County,13,6818,3439,3379
New York,Steuben County,14,5478,2661,2817
New York,Steuben County,15,4085,1949,2136
New York,Steuben County,16,2973,1392,1581
New York,Steuben County,17,2288,994,1294
New York,Steuben County,18,2327,798,1529
New York,Suffolk County,0,1502968,740440,762528
New York,Suffolk County,1,80971,41423,39548
New York,Suffolk County,2,89407,45844,43563
New York,Suffolk County,3,100029,51338,48691
New York,Suffolk County,4,103554,53601,49953
New York,Suffolk County,5,101017,51914,49103
New York,Suffolk County,6,87053,45583,41470
New York,Suffolk County,7,83266,42368,40898
New York,Suffolk County,8,87551,43776,43775
New York,Suffolk County,9,101089,49657,51432
New York,Suffolk County,10,117891,57817,60074
New York,Suffolk County,11,125551,62030,63521
New York,Suffolk County,12,109392,54121,55271
New York,Suffolk County,13,87091,42034,45057
New York,Suffolk County,14,74156,34544,39612
New York,Suffolk County,15,54736,24606,30130
New York,Suffolk County,16,38587,16824,21763
New York,Suffolk County,17,29605,12215,17390
New York,Suffolk County,18,32022,10745,21277
New York,Sullivan County,0,75943,38932,37011
New York,Sullivan County,1,4473,2285,2188
New York,Sullivan County,2,4453,2300,2153
New York,Sullivan County,3,4589,2426,2163
New York,Sullivan County,4,4624,2438,2186
New York,Sullivan County,5,4752,2529,2223
New York,Sullivan County,6,4252,2217,2035
New York,Sullivan County,7,4374,2194,2180
New York,Sullivan County,8,4189,2195,1994
New York,Sullivan County,9,4523,2383,2140
New York,Sullivan County,10,5539,2926,2613
New York,Sullivan County,11,6268,3248,3020
New York,Sullivan County,12,5912,3072,2840
New York,Sullivan County,13,5241,2616,2625
New York,Sullivan County,14,4480,2220,2260
New York,Sullivan County,15,3364,1662,1702
New York,Sullivan County,16,2177,1097,1080
New York,Sullivan County,17,1407,655,752
New York,Sullivan County,18,1326,469,857
New York,Tioga County,0,49870,24797,25073
New York,Tioga County,1,2587,1339,1248
New York,Tioga County,2,3033,1601,1432
New York,Tioga County,3,3268,1649,1619
New York,Tioga County,4,3142,1618,1524
New York,Tioga County,5,2809,1457,1352
New York,Tioga County,6,2568,1302,1266
New York,Tioga County,7,2728,1382,1346
New York,Tioga County,8,2664,1340,1324
New York,Tioga County,9,2880,1440,1440
New York,Tioga County,10,3419,1697,1722
New York,Tioga County,11,4312,2091,2221
New York,Tioga County,12,4307,2156,2151
New York,Tioga County,13,3209,1607,1602
New York,Tioga County,14,2884,1356,1528
New York,Tioga County,15,2163,1087,1076
New York,Tioga County,16,1629,744,885
New York,Tioga County,17,1176,544,632
New York,Tioga County,18,1092,387,705
New York,Tompkins County,0,104691,51646,53045
New York,Tompkins County,1,4443,2243,2200
New York,Tompkins County,2,4236,2191,2045
New York,Tompkins County,3,4444,2341,2103
New York,Tompkins County,4,12341,6151,6190
New York,Tompkins County,5,19833,10250,9583
New York,Tompkins County,6,7074,3658,3416
New York,Tompkins County,7,6270,3116,3154
New York,Tompkins County,8,5311,2585,2726
New York,Tompkins County,9,4977,2416,2561
New York,Tompkins County,10,5336,2606,2730
New York,Tompkins County,11,5822,2758,3064
New York,Tompkins County,12,6021,2848,3173
New York,Tompkins County,13,5750,2782,2968
New York,Tompkins County,14,4523,2147,2376
New York,Tompkins County,15,2991,1395,1596
New York,Tompkins County,16,1939,881,1058
New York,Tompkins County,17,1520,635,885
New York,Tompkins County,18,1860,643,1217
New York,Ulster County,0,180445,89783,90662
New York,Ulster County,1,8119,4133,3986
New York,Ulster County,2,9110,4594,4516
New York,Ulster County,3,9765,4992,4773
New York,Ulster County,4,11613,5829,5784
New York,Ulster County,5,12664,6472,6192
New York,Ulster County,6,11176,5981,5195
New York,Ulster County,7,10232,5319,4913
New York,Ulster County,8,10256,5340,4916
New York,Ulster County,9,11322,5799,5523
New York,Ulster County,10,12920,6595,6325
New York,Ulster County,11,14944,7465,7479
New York,Ulster County,12,14314,7122,7192
New York,Ulster County,13,12684,6160,6524
New York,Ulster County,14,10667,5113,5554
New York,Ulster County,15,7350,3469,3881
New York,Ulster County,16,4970,2290,2680
New York,Ulster County,17,3863,1625,2238
New York,Ulster County,18,4476,1485,2991
New York,Warren County,0,64973,31803,33170
New York,Warren County,1,3077,1565,1512
New York,Warren County,2,3257,1666,1591
New York,Warren County,3,3611,1888,1723
New York,Warren County,4,3712,1904,1808
New York,Warren County,5,3878,1945,1933
New York,Warren County,6,3709,1874,1835
New York,Warren County,7,3488,1768,1720
New York,Warren County,8,3375,1694,1681
New York,Warren County,9,3858,1840,2018
New York,Warren County,10,4730,2339,2391
New York,Warren County,11,5335,2574,2761
New York,Warren County,12,5207,2501,2706
New York,Warren County,13,4878,2433,2445
New York,Warren County,14,4285,2107,2178
New York,Warren County,15,3108,1486,1622
New York,Warren County,16,2081,952,1129
New York,Warren County,17,1644,664,980
New York,Warren County,18,1740,603,1137
New York,Washington County,0,62372,32339,30033
New York,Washington County,1,3040,1658,1382
New York,Washington County,2,3441,1754,1687
New York,Washington County,3,3560,1855,1705
New York,Washington County,4,3724,2043,1681
New York,Washington County,5,3914,2249,1665
New York,Washington County,6,3822,2100,1722
New York,Washington County,7,3628,1950,1678
New York,Washington County,8,3617,1991,1626
New York,Washington County,9,4039,2167,1872
New York,Washington County,10,4720,2457,2263
New York,Washington County,11,4996,2539,2457
New York,Washington County,12,4886,2460,2426
New York,Washington County,13,4218,2164,2054
New York,Washington County,14,3575,1754,1821
New York,Washington County,15,2678,1292,1386
New York,Washington County,16,1791,844,947
New York,Washington County,17,1356,616,740
New York,Washington County,18,1367,446,921
New York,Wayne County,0,92051,45601,46450
New York,Wayne County,1,5006,2532,2474
New York,Wayne County,2,5637,2860,2777
New York,Wayne County,3,5848,2864,2984
New York,Wayne County,4,5858,3052,2806
New York,Wayne County,5,5579,2868,2711
New York,Wayne County,6,4913,2503,2410
New York,Wayne County,7,5119,2565,2554
New York,Wayne County,8,4845,2440,2405
New York,Wayne County,9,5814,2871,2943
New York,Wayne County,10,6821,3477,3344
New York,Wayne County,11,7764,3837,3927
New York,Wayne County,12,7376,3609,3767
New York,Wayne County,13,6247,3161,3086
New York,Wayne County,14,5232,2538,2694
New York,Wayne County,15,3716,1747,1969
New York,Wayne County,16,2510,1215,1295
New York,Wayne County,17,1878,795,1083
New York,Wayne County,18,1888,667,1221
New York,Westchester County,0,972634,469886,502748
New York,Westchester County,1,55183,28173,27010
New York,Westchester County,2,61069,31560,29509
New York,Westchester County,3,64971,33357,31614
New York,Westchester County,4,67542,34291,33251
New York,Westchester County,5,59853,30218,29635
New York,Westchester County,6,54052,27513,26539
New York,Westchester County,7,56569,28036,28533
New York,Westchester County,8,60635,29658,30977
New York,Westchester County,9,66946,32470,34476
New York,Westchester County,10,72532,35000,37532
New York,Westchester County,11,75441,36340,39101
New York,Westchester County,12,69166,33239,35927
New York,Westchester County,13,56543,26538,30005
New York,Westchester County,14,45990,21195,24795
New York,Westchester County,15,33534,14786,18748
New York,Westchester County,16,25617,10587,15030
New York,Westchester County,17,20960,8420,12540
New York,Westchester County,18,26031,8505,17526
New York,Wyoming County,0,41188,22374,18814
New York,Wyoming County,1,1994,990,1004
New York,Wyoming County,2,2107,1066,1041
New York,Wyoming County,3,2339,1177,1162
New York,Wyoming County,4,2292,1166,1126
New York,Wyoming County,5,2591,1445,1146
New York,Wyoming County,6,2828,1809,1019
New York,Wyoming County,7,2844,1784,1060
New York,Wyoming County,8,2465,1467,998
New York,Wyoming County,9,2861,1685,1176
New York,Wyoming County,10,3197,1836,1361
New York,Wyoming County,11,3379,1831,1548
New York,Wyoming County,12,3105,1618,1487
New York,Wyoming County,13,2816,1517,1299
New York,Wyoming County,14,2171,1091,1080
New York,Wyoming County,15,1641,835,806
New York,Wyoming County,16,1065,506,559
New York,Wyoming County,17,755,305,450
New York,Wyoming County,18,738,246,492
New York,Yates County,0,25208,12277,12931
New York,Yates County,1,1604,815,789
New York,Yates County,2,1528,751,777
New York,Yates County,3,1567,826,741
New York,Yates County,4,2021,1005,1016
New York,Yates County,5,1972,910,1062
New York,Yates County,6,1253,663,590
New York,Yates County,7,1245,610,635
New York,Yates County,8,1137,552,585
New York,Yates County,9,1261,612,649
New York,Yates County,10,1387,686,701
New York,Yates County,11,1837,849,988
New York,Yates County,12,1949,952,997
New York,Yates County,13,1798,846,952
New York,Yates County,14,1557,814,743
New York,Yates County,15,1114,538,576
New York,Yates County,16,802,381,421
New York,Yates County,17,566,241,325
New York,Yates County,18,610,226,384
North Carolina,Alamance County,0,155792,74313,81479
North Carolina,Alamance County,1,9006,4688,4318
North Carolina,Alamance County,2,9955,5104,4851
North Carolina,Alamance County,3,10396,5352,5044
North Carolina,Alamance County,4,11238,5499,5739
North Carolina,Alamance County,5,10465,5191,5274
North Carolina,Alamance County,6,9709,4659,5050
North Carolina,Alamance County,7,8773,4149,4624
North Carolina,Alamance County,8,9056,4299,4757
North Carolina,Alamance County,9,10478,5019,5459
North Carolina,Alamance County,10,10802,5219,5583
North Carolina,Alamance County,11,11348,5489,5859
North Carolina,Alamance County,12,10429,5006,5423
North Carolina,Alamance County,13,9011,4180,4831
North Carolina,Alamance County,14,8039,3641,4398
North Carolina,Alamance County,15,5965,2610,3355
North Carolina,Alamance County,16,4280,1765,2515
North Carolina,Alamance County,17,3317,1315,2002
North Carolina,Alamance County,18,3525,1128,2397
North Carolina,Alexander County,0,37392,18989,18403
North Carolina,Alexander County,1,1851,964,887
North Carolina,Alexander County,2,2239,1131,1108
North Carolina,Alexander County,3,2334,1136,1198
North Carolina,Alexander County,4,2165,1138,1027
North Carolina,Alexander County,5,2188,1213,975
North Carolina,Alexander County,6,1957,1050,907
North Carolina,Alexander County,7,2130,1179,951
North Carolina,Alexander County,8,2172,1187,985
North Carolina,Alexander County,9,2677,1405,1272
North Carolina,Alexander County,10,2655,1401,1254
North Carolina,Alexander County,11,2872,1488,1384
North Carolina,Alexander County,12,2609,1284,1325
North Carolina,Alexander County,13,2474,1208,1266
North Carolina,Alexander County,14,2419,1187,1232
North Carolina,Alexander County,15,1874,881,993
North Carolina,Alexander County,16,1258,595,663
North Carolina,Alexander County,17,863,339,524
North Carolina,Alexander County,18,655,203,452
North Carolina,Alleghany County,0,10879,5409,5470
North Carolina,Alleghany County,1,471,247,224
North Carolina,Alleghany County,2,550,275,275
North Carolina,Alleghany County,3,564,289,275
North Carolina,Alleghany County,4,599,296,303
North Carolina,Alleghany County,5,570,324,246
North Carolina,Alleghany County,6,438,225,213
North Carolina,Alleghany County,7,506,265,241
North Carolina,Alleghany County,8,548,293,255
North Carolina,Alleghany County,9,667,326,341
North Carolina,Alleghany County,10,726,382,344
North Carolina,Alleghany County,11,834,426,408
North Carolina,Alleghany County,12,855,405,450
North Carolina,Alleghany County,13,885,441,444
North Carolina,Alleghany County,14,879,435,444
North Carolina,Alleghany County,15,649,313,336
North Carolina,Alleghany County,16,468,211,257
North Carolina,Alleghany County,17,377,155,222
North Carolina,Alleghany County,18,293,101,192
North Carolina,Anson County,0,25765,13350,12415
North Carolina,Anson County,1,1255,655,600
North Carolina,Anson County,2,1503,743,760
North Carolina,Anson County,3,1605,803,802
North Carolina,Anson County,4,1414,703,711
North Carolina,Anson County,5,1853,1051,802
North Carolina,Anson County,6,1819,1111,708
North Carolina,Anson County,7,1634,965,669
North Carolina,Anson County,8,1630,939,691
North Carolina,Anson County,9,1661,914,747
North Carolina,Anson County,10,1784,937,847
North Carolina,Anson County,11,1849,969,880
North Carolina,Anson County,12,1826,956,870
North Carolina,Anson County,13,1697,819,878
North Carolina,Anson County,14,1422,695,727
North Carolina,Anson County,15,1026,444,582
North Carolina,Anson County,16,705,298,407
North Carolina,Anson County,17,527,191,336
North Carolina,Anson County,18,555,157,398
North Carolina,Ashe County,0,27126,13442,13684
North Carolina,Ashe County,1,1287,689,598
North Carolina,Ashe County,2,1418,721,697
North Carolina,Ashe County,3,1404,716,688
North Carolina,Ashe County,4,1419,727,692
North Carolina,Ashe County,5,1362,769,593
North Carolina,Ashe County,6,1245,654,591
North Carolina,Ashe County,7,1446,758,688
North Carolina,Ashe County,8,1482,729,753
North Carolina,Ashe County,9,1701,892,809
North Carolina,Ashe County,10,1769,884,885
North Carolina,Ashe County,11,2042,1027,1015
North Carolina,Ashe County,12,2018,956,1062
North Carolina,Ashe County,13,2140,1041,1099
North Carolina,Ashe County,14,2089,1027,1062
North Carolina,Ashe County,15,1603,746,857
North Carolina,Ashe County,16,1229,561,668
North Carolina,Ashe County,17,746,320,426
North Carolina,Ashe County,18,726,225,501
North Carolina,Avery County,0,17773,9685,8088
North Carolina,Avery County,1,690,342,348
North Carolina,Avery County,2,749,392,357
North Carolina,Avery County,3,839,398,441
North Carolina,Avery County,4,1115,549,566
North Carolina,Avery County,5,1210,698,512
North Carolina,Avery County,6,1191,768,423
North Carolina,Avery County,7,1031,672,359
North Carolina,Avery County,8,1158,710,448
North Carolina,Avery County,9,1250,779,471
North Carolina,Avery County,10,1267,765,502
North Carolina,Avery County,11,1254,713,541
North Carolina,Avery County,12,1231,632,599
North Carolina,Avery County,13,1173,600,573
North Carolina,Avery County,14,1206,599,607
North Carolina,Avery County,15,885,417,468
North Carolina,Avery County,16,665,315,350
North Carolina,Avery County,17,448,184,264
North Carolina,Avery County,18,411,152,259
North Carolina,Beaufort County,0,47585,22870,24715
North Carolina,Beaufort County,1,2591,1338,1253
North Carolina,Beaufort County,2,2773,1457,1316
North Carolina,Beaufort County,3,2962,1498,1464
North Carolina,Beaufort County,4,2692,1386,1306
North Carolina,Beaufort County,5,2612,1331,1281
North Carolina,Beaufort County,6,2315,1129,1186
North Carolina,Beaufort County,7,2328,1111,1217
North Carolina,Beaufort County,8,2669,1276,1393
North Carolina,Beaufort County,9,2786,1301,1485
North Carolina,Beaufort County,10,2818,1387,1431
North Carolina,Beaufort County,11,3380,1618,1762
North Carolina,Beaufort County,12,3704,1741,1963
North Carolina,Beaufort County,13,3700,1747,1953
North Carolina,Beaufort County,14,3591,1697,1894
North Carolina,Beaufort County,15,2651,1229,1422
North Carolina,Beaufort County,16,1803,830,973
North Carolina,Beaufort County,17,1154,476,678
North Carolina,Beaufort County,18,1056,318,738
North Carolina,Bertie County,0,20106,10076,10030
North Carolina,Bertie County,1,890,463,427
North Carolina,Bertie County,2,1102,565,537
North Carolina,Bertie County,3,1112,583,529
North Carolina,Bertie County,4,1089,545,544
North Carolina,Bertie County,5,1330,808,522
North Carolina,Bertie County,6,1328,779,549
North Carolina,Bertie County,7,1111,627,484
North Carolina,Bertie County,8,997,536,461
North Carolina,Bertie County,9,1165,603,562
North Carolina,Bertie County,10,1249,619,630
North Carolina,Bertie County,11,1595,772,823
North Carolina,Bertie County,12,1664,809,855
North Carolina,Bertie County,13,1493,700,793
North Carolina,Bertie County,14,1193,553,640
North Carolina,Bertie County,15,942,410,532
North Carolina,Bertie County,16,778,311,467
North Carolina,Bertie County,17,535,206,329
North Carolina,Bertie County,18,533,187,346
North Carolina,Bladen County,0,34657,16707,17950
North Carolina,Bladen County,1,1784,893,891
North Carolina,Bladen County,2,2165,1106,1059
North Carolina,Bladen County,3,2195,1115,1080
North Carolina,Bladen County,4,2066,1087,979
North Carolina,Bladen County,5,2144,1158,986
North Carolina,Bladen County,6,1809,846,963
North Carolina,Bladen County,7,1884,927,957
North Carolina,Bladen County,8,1962,975,987
North Carolina,Bladen County,9,2197,1048,1149
North Carolina,Bladen County,10,2149,1029,1120
North Carolina,Bladen County,11,2461,1149,1312
North Carolina,Bladen County,12,2692,1298,1394
North Carolina,Bladen County,13,2671,1272,1399
North Carolina,Bladen County,14,2279,1114,1165
North Carolina,Bladen County,15,1643,714,929
North Carolina,Bladen County,16,1204,511,693
North Carolina,Bladen County,17,714,272,442
North Carolina,Bladen County,18,638,193,445
North Carolina,Brunswick County,0,118836,57703,61133
North Carolina,Brunswick County,1,5299,2777,2522
North Carolina,Brunswick County,2,5929,3061,2868
North Carolina,Brunswick County,3,5792,2980,2812
North Carolina,Brunswick County,4,5250,2731,2519
North Carolina,Brunswick County,5,5480,2906,2574
North Carolina,Brunswick County,6,5382,2558,2824
North Carolina,Brunswick County,7,5937,2878,3059
North Carolina,Brunswick County,8,6043,2937,3106
North Carolina,Brunswick County,9,6439,3203,3236
North Carolina,Brunswick County,10,6638,3242,3396
North Carolina,Brunswick County,11,7853,3645,4208
North Carolina,Brunswick County,12,9091,4065,5026
North Carolina,Brunswick County,13,11656,5196,6460
North Carolina,Brunswick County,14,12963,6269,6694
North Carolina,Brunswick County,15,9015,4594,4421
North Carolina,Brunswick County,16,4998,2513,2485
North Carolina,Brunswick County,17,2734,1355,1379
North Carolina,Brunswick County,18,2337,793,1544
North Carolina,Buncombe County,0,250539,120333,130206
North Carolina,Buncombe County,1,13286,6729,6557
North Carolina,Buncombe County,2,13469,6855,6614
North Carolina,Buncombe County,3,13736,7035,6701
North Carolina,Buncombe County,4,13749,7058,6691
North Carolina,Buncombe County,5,15352,7740,7612
North Carolina,Buncombe County,6,17061,8247,8814
North Carolina,Buncombe County,7,16989,8302,8687
North Carolina,Buncombe County,8,16424,8108,8316
North Carolina,Buncombe County,9,16487,8264,8223
North Carolina,Buncombe County,10,16107,7940,8167
North Carolina,Buncombe County,11,17220,8284,8936
North Carolina,Buncombe County,12,17975,8231,9744
North Carolina,Buncombe County,13,17342,8018,9324
North Carolina,Buncombe County,14,15202,7039,8163
North Carolina,Buncombe County,15,10776,4864,5912
North Carolina,Buncombe County,16,7555,3300,4255
North Carolina,Buncombe County,17,5500,2289,3211
North Carolina,Buncombe County,18,6309,2030,4279
North Carolina,Burke County,0,89486,44662,44824
North Carolina,Burke County,1,4338,2115,2223
North Carolina,Burke County,2,4764,2453,2311
North Carolina,Burke County,3,5193,2705,2488
North Carolina,Burke County,4,6032,3558,2474
North Carolina,Burke County,5,5974,3359,2615
North Carolina,Burke County,6,4999,2560,2439
North Carolina,Burke County,7,4751,2434,2317
North Carolina,Burke County,8,4878,2412,2466
North Carolina,Burke County,9,5867,2925,2942
North Carolina,Burke County,10,6451,3298,3153
North Carolina,Burke County,11,7191,3564,3627
North Carolina,Burke County,12,6587,3169,3418
North Carolina,Burke County,13,6030,2898,3132
North Carolina,Burke County,14,5339,2588,2751
North Carolina,Burke County,15,4173,1881,2292
North Carolina,Burke County,16,2992,1330,1662
North Carolina,Burke County,17,2062,805,1257
North Carolina,Burke County,18,1865,608,1257
North Carolina,Cabarrus County,0,192103,93671,98432
North Carolina,Cabarrus County,1,12150,6258,5892
North Carolina,Cabarrus County,2,14465,7433,7032
North Carolina,Cabarrus County,3,15098,7716,7382
North Carolina,Cabarrus County,4,13185,6865,6320
North Carolina,Cabarrus County,5,11469,5972,5497
North Carolina,Cabarrus County,6,10909,5275,5634
North Carolina,Cabarrus County,7,12069,5685,6384
North Carolina,Cabarrus County,8,13417,6426,6991
North Carolina,Cabarrus County,9,15283,7475,7808
North Carolina,Cabarrus County,10,14515,7163,7352
North Carolina,Cabarrus County,11,13669,6655,7014
North Carolina,Cabarrus County,12,11939,5760,6179
North Carolina,Cabarrus County,13,9844,4554,5290
North Carolina,Cabarrus County,14,8380,3980,4400
North Carolina,Cabarrus County,15,6029,2739,3290
North Carolina,Cabarrus County,16,4066,1694,2372
North Carolina,Cabarrus County,17,2774,1071,1703
North Carolina,Cabarrus County,18,2842,950,1892
North Carolina,Caldwell County,0,81484,40243,41241
North Carolina,Caldwell County,1,4129,2098,2031
North Carolina,Caldwell County,2,4678,2371,2307
North Carolina,Caldwell County,3,5112,2569,2543
North Carolina,Caldwell County,4,4998,2602,2396
North Carolina,Caldwell County,5,4902,2524,2378
North Carolina,Caldwell County,6,4306,2183,2123
North Carolina,Caldwell County,7,4154,2094,2060
North Carolina,Caldwell County,8,4705,2410,2295
North Carolina,Caldwell County,9,5801,2940,2861
North Carolina,Caldwell County,10,6164,3134,3030
North Carolina,Caldwell County,11,6368,3164,3204
North Carolina,Caldwell County,12,6057,2993,3064
North Carolina,Caldwell County,13,5579,2712,2867
North Carolina,Caldwell County,14,5025,2366,2659
North Carolina,Caldwell County,15,3835,1831,2004
North Carolina,Caldwell County,16,2602,1137,1465
North Carolina,Caldwell County,17,1679,649,1030
North Carolina,Caldwell County,18,1390,466,924
North Carolina,Camden County,0,10331,5179,5152
North Carolina,Camden County,1,462,237,225
North Carolina,Camden County,2,692,375,317
North Carolina,Camden County,3,806,413,393
North Carolina,Camden County,4,756,386,370
North Carolina,Camden County,5,521,283,238
North Carolina,Camden County,6,474,234,240
North Carolina,Camden County,7,578,259,319
North Carolina,Camden County,8,655,333,322
North Carolina,Camden County,9,786,377,409
North Carolina,Camden County,10,799,385,414
North Carolina,Camden County,11,880,462,418
North Carolina,Camden County,12,774,399,375
North Carolina,Camden County,13,612,312,300
North Carolina,Camden County,14,529,266,263
North Carolina,Camden County,15,424,204,220
North Carolina,Camden County,16,257,113,144
North Carolina,Camden County,17,184,89,95
North Carolina,Camden County,18,142,52,90
North Carolina,Carteret County,0,68811,33907,34904
North Carolina,Carteret County,1,3096,1606,1490
North Carolina,Carteret County,2,3431,1789,1642
North Carolina,Carteret County,3,3801,1960,1841
North Carolina,Carteret County,4,3576,1876,1700
North Carolina,Carteret County,5,3773,2063,1710
North Carolina,Carteret County,6,3769,1955,1814
North Carolina,Carteret County,7,3719,1901,1818
North Carolina,Carteret County,8,3643,1807,1836
North Carolina,Carteret County,9,4131,2046,2085
North Carolina,Carteret County,10,4482,2214,2268
North Carolina,Carteret County,11,5273,2487,2786
North Carolina,Carteret County,12,5615,2603,3012
North Carolina,Carteret County,13,5506,2595,2911
North Carolina,Carteret County,14,5233,2553,2680
North Carolina,Carteret County,15,3853,1891,1962
North Carolina,Carteret County,16,2534,1186,1348
North Carolina,Carteret County,17,1756,742,1014
North Carolina,Carteret County,18,1620,633,987
North Carolina,Caswell County,0,23082,11716,11366
North Carolina,Caswell County,1,1093,541,552
North Carolina,Caswell County,2,1163,590,573
North Carolina,Caswell County,3,1372,716,656
North Carolina,Caswell County,4,1185,594,591
North Carolina,Caswell County,5,1372,796,576
North Carolina,Caswell County,6,1250,706,544
North Carolina,Caswell County,7,1242,695,547
North Carolina,Caswell County,8,1309,739,570
North Carolina,Caswell County,9,1451,794,657
North Carolina,Caswell County,10,1594,845,749
North Carolina,Caswell County,11,1882,968,914
North Carolina,Caswell County,12,1890,912,978
North Carolina,Caswell County,13,1762,814,948
North Carolina,Caswell County,14,1568,771,797
North Carolina,Caswell County,15,1142,554,588
North Carolina,Caswell County,16,824,347,477
North Carolina,Caswell County,17,515,196,319
North Carolina,Caswell County,18,468,138,330
North Carolina,Catawba County,0,154534,75815,78719
North Carolina,Catawba County,1,8845,4544,4301
North Carolina,Catawba County,2,9935,5067,4868
North Carolina,Catawba County,3,10489,5434,5055
North Carolina,Catawba County,4,9973,5166,4807
North Carolina,Catawba County,5,9634,4888,4746
North Carolina,Catawba County,6,8569,4172,4397
North Carolina,Catawba County,7,8582,4252,4330
North Carolina,Catawba County,8,9238,4629,4609
North Carolina,Catawba County,9,10878,5361,5517
North Carolina,Catawba County,10,11100,5561,5539
North Carolina,Catawba County,11,11642,5807,5835
North Carolina,Catawba County,12,10944,5327,5617
North Carolina,Catawba County,13,9701,4580,5121
North Carolina,Catawba County,14,8657,4182,4475
North Carolina,Catawba County,15,6345,2924,3421
North Carolina,Catawba County,16,4389,1938,2451
North Carolina,Catawba County,17,2876,1114,1762
North Carolina,Catawba County,18,2737,869,1868
North Carolina,Chatham County,0,68698,32913,35785
North Carolina,Chatham County,1,3283,1590,1693
North Carolina,Chatham County,2,4132,2063,2069
North Carolina,Chatham County,3,4203,2110,2093
North Carolina,Chatham County,4,3611,1904,1707
North Carolina,Chatham County,5,3115,1654,1461
North Carolina,Chatham County,6,2936,1454,1482
North Carolina,Chatham County,7,3302,1625,1677
North Carolina,Chatham County,8,3789,1836,1953
North Carolina,Chatham County,9,4418,2165,2253
North Carolina,Chatham County,10,4448,2197,2251
North Carolina,Chatham County,11,5008,2364,2644
North Carolina,Chatham County,12,5012,2403,2609
North Carolina,Chatham County,13,5236,2462,2774
North Carolina,Chatham County,14,5197,2349,2848
North Carolina,Chatham County,15,4082,1878,2204
North Carolina,Chatham County,16,2732,1198,1534
North Carolina,Chatham County,17,2068,907,1161
North Carolina,Chatham County,18,2126,754,1372
North Carolina,Cherokee County,0,27141,13208,13933
North Carolina,Cherokee County,1,1182,614,568
North Carolina,Cherokee County,2,1334,697,637
North Carolina,Cherokee County,3,1443,738,705
North Carolina,Cherokee County,4,1392,749,643
North Carolina,Cherokee County,5,1265,648,617
North Carolina,Cherokee County,6,1139,573,566
North Carolina,Cherokee County,7,1217,555,662
North Carolina,Cherokee County,8,1314,652,662
North Carolina,Cherokee County,9,1540,764,776
North Carolina,Cherokee County,10,1657,833,824
North Carolina,Cherokee County,11,1853,886,967
North Carolina,Cherokee County,12,2131,1009,1122
North Carolina,Cherokee County,13,2429,1162,1267
North Carolina,Cherokee County,14,2473,1127,1346
North Carolina,Cherokee County,15,2021,969,1052
North Carolina,Cherokee County,16,1289,629,660
North Carolina,Cherokee County,17,743,338,405
North Carolina,Cherokee County,18,719,265,454
North Carolina,Chowan County,0,14572,6931,7641
North Carolina,Chowan County,1,792,438,354
North Carolina,Chowan County,2,843,425,418
North Carolina,Chowan County,3,880,438,442
North Carolina,Chowan County,4,858,463,395
North Carolina,Chowan County,5,768,397,371
North Carolina,Chowan County,6,754,340,414
North Carolina,Chowan County,7,755,370,385
North Carolina,Chowan County,8,728,336,392
North Carolina,Chowan County,9,735,357,378
North Carolina,Chowan County,10,824,364,460
North Carolina,Chowan County,11,1107,527,580
North Carolina,Chowan County,12,1136,530,606
North Carolina,Chowan County,13,1129,508,621
North Carolina,Chowan County,14,1062,490,572
North Carolina,Chowan County,15,802,373,429
North Carolina,Chowan County,16,569,272,297
North Carolina,Chowan County,17,396,158,238
North Carolina,Chowan County,18,434,145,289
North Carolina,Clay County,0,10581,5210,5371
North Carolina,Clay County,1,450,239,211
North Carolina,Clay County,2,511,256,255
North Carolina,Clay County,3,584,324,260
North Carolina,Clay County,4,529,294,235
North Carolina,Clay County,5,493,280,213
North Carolina,Clay County,6,407,201,206
North Carolina,Clay County,7,450,226,224
North Carolina,Clay County,8,518,263,255
North Carolina,Clay County,9,573,288,285
North Carolina,Clay County,10,585,274,311
North Carolina,Clay County,11,694,341,353
North Carolina,Clay County,12,852,386,466
North Carolina,Clay County,13,949,422,527
North Carolina,Clay County,14,1025,487,538
North Carolina,Clay County,15,793,382,411
North Carolina,Clay County,16,523,263,260
North Carolina,Clay County,17,348,185,163
North Carolina,Clay County,18,297,99,198
North Carolina,Cleveland County,0,97076,46752,50324
North Carolina,Cleveland County,1,5496,2829,2667
North Carolina,Cleveland County,2,5968,3030,2938
North Carolina,Cleveland County,3,6238,3205,3033
North Carolina,Cleveland County,4,6612,3369,3243
North Carolina,Cleveland County,5,6817,3472,3345
North Carolina,Cleveland County,6,5346,2578,2768
North Carolina,Cleveland County,7,5096,2358,2738
North Carolina,Cleveland County,8,5215,2511,2704
North Carolina,Cleveland County,9,6277,2992,3285
North Carolina,Cleveland County,10,6786,3324,3462
North Carolina,Cleveland County,11,7334,3613,3721
North Carolina,Cleveland County,12,6911,3325,3586
North Carolina,Cleveland County,13,6374,3032,3342
North Carolina,Cleveland County,14,5723,2637,3086
North Carolina,Cleveland County,15,4238,1942,2296
North Carolina,Cleveland County,16,2926,1175,1751
North Carolina,Cleveland County,17,2018,805,1213
North Carolina,Cleveland County,18,1701,555,1146
North Carolina,Columbus County,0,56953,28102,28851
North Carolina,Columbus County,1,3123,1571,1552
North Carolina,Columbus County,2,3487,1747,1740
North Carolina,Columbus County,3,3828,1889,1939
North Carolina,Columbus County,4,3537,1770,1767
North Carolina,Columbus County,5,3681,2045,1636
North Carolina,Columbus County,6,3348,1809,1539
North Carolina,Columbus County,7,3392,1830,1562
North Carolina,Columbus County,8,3284,1728,1556
North Carolina,Columbus County,9,3494,1781,1713
North Carolina,Columbus County,10,3730,1856,1874
North Carolina,Columbus County,11,4072,1983,2089
North Carolina,Columbus County,12,4096,1969,2127
North Carolina,Columbus County,13,3786,1837,1949
North Carolina,Columbus County,14,3430,1611,1819
North Carolina,Columbus County,15,2547,1137,1410
North Carolina,Columbus County,16,1868,772,1096
North Carolina,Columbus County,17,1244,473,771
North Carolina,Columbus County,18,1006,294,712
North Carolina,Craven County,0,104510,53090,51420
North Carolina,Craven County,1,7332,3797,3535
North Carolina,Craven County,2,6545,3260,3285
North Carolina,Craven County,3,6089,3059,3030
North Carolina,Craven County,4,6093,3287,2806
North Carolina,Craven County,5,11281,7348,3933
North Carolina,Craven County,6,7710,4093,3617
North Carolina,Craven County,7,6399,3313,3086
North Carolina,Craven County,8,5696,2917,2779
North Carolina,Craven County,9,5207,2579,2628
North Carolina,Craven County,10,5339,2667,2672
North Carolina,Craven County,11,6275,2943,3332
North Carolina,Craven County,12,6574,3081,3493
North Carolina,Craven County,13,6074,2780,3294
North Carolina,Craven County,14,5707,2677,3030
North Carolina,Craven County,15,4446,2050,2396
North Carolina,Craven County,16,3308,1492,1816
North Carolina,Craven County,17,2289,972,1317
North Carolina,Craven County,18,2146,775,1371
North Carolina,Cumberland County,0,326328,159809,166519
North Carolina,Cumberland County,1,26602,13374,13228
North Carolina,Cumberland County,2,23396,11886,11510
North Carolina,Cumberland County,3,21376,10860,10516
North Carolina,Cumberland County,4,21602,11171,10431
North Carolina,Cumberland County,5,32413,18169,14244
North Carolina,Cumberland County,6,30666,16003,14663
North Carolina,Cumberland County,7,24512,12257,12255
North Carolina,Cumberland County,8,19570,9331,10239
North Carolina,Cumberland County,9,18952,8884,10068
North Carolina,Cumberland County,10,18533,8582,9951
North Carolina,Cumberland County,11,19929,9112,10817
North Carolina,Cumberland County,12,18354,8486,9868
North Carolina,Cumberland County,13,15087,6941,8146
North Carolina,Cumberland County,14,12055,5509,6546
North Carolina,Cumberland County,15,8809,3743,5066
North Carolina,Cumberland County,16,6378,2605,3773
North Carolina,Cumberland County,17,4463,1754,2709
North Carolina,Cumberland County,18,3631,1142,2489
North Carolina,Currituck County,0,24976,12406,12570
North Carolina,Currituck County,1,1273,648,625
North Carolina,Currituck County,2,1568,779,789
North Carolina,Currituck County,3,1684,819,865
North Carolina,Currituck County,4,1575,819,756
North Carolina,Currituck County,5,1323,711,612
North Carolina,Currituck County,6,1373,668,705
North Carolina,Currituck County,7,1401,685,716
North Carolina,Currituck County,8,1453,715,738
North Carolina,Currituck County,9,1719,884,835
North Carolina,Currituck County,10,1921,929,992
North Carolina,Currituck County,11,2224,1125,1099
North Carolina,Currituck County,12,2070,1059,1011
North Carolina,Currituck County,13,1668,800,868
North Carolina,Currituck County,14,1365,693,672
North Carolina,Currituck County,15,1016,489,527
North Carolina,Currituck County,16,617,306,311
North Carolina,Currituck County,17,391,163,228
North Carolina,Currituck County,18,335,114,221
North Carolina,Dare County,0,35104,17353,17751
North Carolina,Dare County,1,1863,938,925
North Carolina,Dare County,2,1977,964,1013
North Carolina,Dare County,3,1918,953,965
North Carolina,Dare County,4,1733,899,834
North Carolina,Dare County,5,1657,935,722
North Carolina,Dare County,6,1837,948,889
North Carolina,Dare County,7,2084,985,1099
North Carolina,Dare County,8,2009,1039,970
North Carolina,Dare County,9,2232,1132,1100
North Carolina,Dare County,10,2457,1232,1225
North Carolina,Dare County,11,2840,1362,1478
North Carolina,Dare County,12,3094,1492,1602
North Carolina,Dare County,13,2853,1367,1486
North Carolina,Dare County,14,2546,1257,1289
North Carolina,Dare County,15,1629,759,870
North Carolina,Dare County,16,1074,545,529
North Carolina,Dare County,17,702,334,368
North Carolina,Dare County,18,599,212,387
North Carolina,Davidson County,0,164072,80435,83637
North Carolina,Davidson County,1,8754,4512,4242
North Carolina,Davidson County,2,10490,5460,5030
North Carolina,Davidson County,3,11155,5621,5534
North Carolina,Davidson County,4,10419,5363,5056
North Carolina,Davidson County,5,9631,5035,4596
North Carolina,Davidson County,6,8579,4201,4378
North Carolina,Davidson County,7,9147,4434,4713
North Carolina,Davidson County,8,9460,4599,4861
North Carolina,Davidson County,9,11721,5771,5950
North Carolina,Davidson County,10,12268,6116,6152
North Carolina,Davidson County,11,12806,6262,6544
North Carolina,Davidson County,12,11947,5978,5969
North Carolina,Davidson County,13,10168,4885,5283
North Carolina,Davidson County,14,9405,4475,4930
North Carolina,Davidson County,15,7007,3278,3729
North Carolina,Davidson County,16,4982,2140,2842
North Carolina,Davidson County,17,3298,1343,1955
North Carolina,Davidson County,18,2835,962,1873
North Carolina,Davie County,0,41434,20261,21173
North Carolina,Davie County,1,2105,1126,979
North Carolina,Davie County,2,2446,1310,1136
North Carolina,Davie County,3,2784,1396,1388
North Carolina,Davie County,4,2661,1383,1278
North Carolina,Davie County,5,2244,1178,1066
North Carolina,Davie County,6,1739,860,879
North Carolina,Davie County,7,2015,959,1056
North Carolina,Davie County,8,2260,1113,1147
North Carolina,Davie County,9,2811,1339,1472
North Carolina,Davie County,10,2964,1450,1514
North Carolina,Davie County,11,3300,1599,1701
North Carolina,Davie County,12,3167,1549,1618
North Carolina,Davie County,13,2961,1413,1548
North Carolina,Davie County,14,2580,1286,1294
North Carolina,Davie County,15,1951,922,1029
North Carolina,Davie County,16,1416,646,770
North Carolina,Davie County,17,1013,386,627
North Carolina,Davie County,18,1017,346,671
North Carolina,Duplin County,0,59882,29443,30439
North Carolina,Duplin County,1,3980,1970,2010
North Carolina,Duplin County,2,4281,2155,2126
North Carolina,Duplin County,3,4115,2193,1922
North Carolina,Duplin County,4,3979,2037,1942
North Carolina,Duplin County,5,3742,1982,1760
North Carolina,Duplin County,6,3443,1750,1693
North Carolina,Duplin County,7,3553,1797,1756
North Carolina,Duplin County,8,3635,1847,1788
North Carolina,Duplin County,9,3922,1903,2019
North Carolina,Duplin County,10,3709,1844,1865
North Carolina,Duplin County,11,4225,2060,2165
North Carolina,Duplin County,12,4140,2017,2123
North Carolina,Duplin County,13,3686,1767,1919
North Carolina,Duplin County,14,3235,1539,1696
North Carolina,Duplin County,15,2323,1064,1259
North Carolina,Duplin County,16,1672,727,945
North Carolina,Duplin County,17,1237,470,767
North Carolina,Duplin County,18,1005,321,684
North Carolina,Durham County,0,294460,140995,153465
North Carolina,Durham County,1,20732,10782,9950
North Carolina,Durham County,2,18591,9612,8979
North Carolina,Durham County,3,16565,8234,8331
North Carolina,Durham County,4,18375,9237,9138
North Carolina,Durham County,5,21674,10633,11041
North Carolina,Durham County,6,27099,12572,14527
North Carolina,Durham County,7,26082,12583,13499
North Carolina,Durham County,8,22199,10936,11263
North Carolina,Durham County,9,20560,10148,10412
North Carolina,Durham County,10,17912,8705,9207
North Carolina,Durham County,11,18573,8715,9858
North Carolina,Durham County,12,17718,8154,9564
North Carolina,Durham County,13,15729,7082,8647
North Carolina,Durham County,14,11792,5307,6485
North Carolina,Durham County,15,7504,3305,4199
North Carolina,Durham County,16,4976,2094,2882
North Carolina,Durham County,17,3786,1453,2333
North Carolina,Durham County,18,4593,1443,3150
North Carolina,Edgecombe County,0,54933,25498,29435
North Carolina,Edgecombe County,1,3505,1784,1721
North Carolina,Edgecombe County,2,3572,1837,1735
North Carolina,Edgecombe County,3,3524,1732,1792
North Carolina,Edgecombe County,4,3424,1802,1622
North Carolina,Edgecombe County,5,3683,1778,1905
North Carolina,Edgecombe County,6,3325,1505,1820
North Carolina,Edgecombe County,7,3064,1361,1703
North Carolina,Edgecombe County,8,2939,1394,1545
North Carolina,Edgecombe County,9,3157,1404,1753
North Carolina,Edgecombe County,10,3374,1553,1821
North Carolina,Edgecombe County,11,3920,1791,2129
North Carolina,Edgecombe County,12,4246,1948,2298
North Carolina,Edgecombe County,13,3892,1810,2082
North Carolina,Edgecombe County,14,3139,1421,1718
North Carolina,Edgecombe County,15,2231,977,1254
North Carolina,Edgecombe County,16,1658,652,1006
North Carolina,Edgecombe County,17,1181,433,748
North Carolina,Edgecombe County,18,1099,316,783
North Carolina,Forsyth County,0,365298,173488,191810
North Carolina,Forsyth County,1,23149,11714,11435
North Carolina,Forsyth County,2,24514,12508,12006
North Carolina,Forsyth County,3,24776,12542,12234
North Carolina,Forsyth County,4,25159,12537,12622
North Carolina,Forsyth County,5,25593,12524,13069
North Carolina,Forsyth County,6,24070,11287,12783
North Carolina,Forsyth County,7,22849,10805,12044
North Carolina,Forsyth County,8,22243,10749,11494
North Carolina,Forsyth County,9,23943,11348,12595
North Carolina,Forsyth County,10,24195,11689,12506
North Carolina,Forsyth County,11,26301,12337,13964
North Carolina,Forsyth County,12,24611,11468,13143
North Carolina,Forsyth County,13,21328,9799,11529
North Carolina,Forsyth County,14,17734,8043,9691
North Carolina,Forsyth County,15,12286,5445,6841
North Carolina,Forsyth County,16,8963,3823,5140
North Carolina,Forsyth County,17,6685,2589,4096
North Carolina,Forsyth County,18,6899,2281,4618
North Carolina,Franklin County,0,62860,31196,31664
North Carolina,Franklin County,1,3530,1862,1668
North Carolina,Franklin County,2,4146,2111,2035
North Carolina,Franklin County,3,4314,2232,2082
North Carolina,Franklin County,4,4230,2260,1970
North Carolina,Franklin County,5,3784,2097,1687
North Carolina,Franklin County,6,3370,1674,1696
North Carolina,Franklin County,7,3599,1809,1790
North Carolina,Franklin County,8,3718,1902,1816
North Carolina,Franklin County,9,4464,2197,2267
North Carolina,Franklin County,10,4517,2218,2299
North Carolina,Franklin County,11,4950,2487,2463
North Carolina,Franklin County,12,4623,2259,2364
North Carolina,Franklin County,13,4060,1887,2173
North Carolina,Franklin County,14,3467,1650,1817
North Carolina,Franklin County,15,2398,1064,1334
North Carolina,Franklin County,16,1639,742,897
North Carolina,Franklin County,17,1057,430,627
North Carolina,Franklin County,18,994,315,679
North Carolina,Gaston County,0,211127,102265,108862
North Carolina,Gaston County,1,12932,6679,6253
North Carolina,Gaston County,2,13455,6890,6565
North Carolina,Gaston County,3,13901,7122,6779
North Carolina,Gaston County,4,13341,6949,6392
North Carolina,Gaston County,5,13483,7016,6467
North Carolina,Gaston County,6,12877,6194,6683
North Carolina,Gaston County,7,12376,5938,6438
North Carolina,Gaston County,8,12914,6176,6738
North Carolina,Gaston County,9,15726,7603,8123
North Carolina,Gaston County,10,15304,7527,7777
North Carolina,Gaston County,11,15578,7660,7918
North Carolina,Gaston County,12,14519,6914,7605
North Carolina,Gaston County,13,12869,6134,6735
North Carolina,Gaston County,14,11083,5130,5953
North Carolina,Gaston County,15,7818,3429,4389
North Carolina,Gaston County,16,5569,2340,3229
North Carolina,Gaston County,17,3916,1492,2424
North Carolina,Gaston County,18,3466,1072,2394
North Carolina,Gates County,0,11567,5647,5920
North Carolina,Gates County,1,577,278,299
North Carolina,Gates County,2,700,357,343
North Carolina,Gates County,3,731,369,362
North Carolina,Gates County,4,739,398,341
North Carolina,Gates County,5,679,349,330
North Carolina,Gates County,6,586,281,305
North Carolina,Gates County,7,561,266,295
North Carolina,Gates County,8,546,272,274
North Carolina,Gates County,9,710,320,390
North Carolina,Gates County,10,851,434,417
North Carolina,Gates County,11,1073,530,543
North Carolina,Gates County,12,986,481,505
North Carolina,Gates County,13,770,370,400
North Carolina,Gates County,14,698,320,378
North Carolina,Gates County,15,529,263,266
North Carolina,Gates County,16,368,172,196
North Carolina,Gates County,17,219,93,126
North Carolina,Gates County,18,244,94,150
North Carolina,Graham County,0,8644,4273,4371
North Carolina,Graham County,1,466,228,238
North Carolina,Graham County,2,515,298,217
North Carolina,Graham County,3,547,275,272
North Carolina,Graham County,4,480,262,218
North Carolina,Graham County,5,461,215,246
North Carolina,Graham County,6,447,218,229
North Carolina,Graham County,7,436,231,205
North Carolina,Graham County,8,452,227,225
North Carolina,Graham County,9,503,255,248
North Carolina,Graham County,10,573,289,284
North Carolina,Graham County,11,606,283,323
North Carolina,Graham County,12,619,310,309
North Carolina,Graham County,13,614,286,328
North Carolina,Graham County,14,609,294,315
North Carolina,Graham County,15,505,257,248
North Carolina,Graham County,16,365,158,207
North Carolina,Graham County,17,239,111,128
North Carolina,Graham County,18,207,76,131
North Carolina,Granville County,0,58500,29812,28688
North Carolina,Granville County,1,2867,1428,1439
North Carolina,Granville County,2,3490,1804,1686
North Carolina,Granville County,3,3739,1985,1754
North Carolina,Granville County,4,3874,2141,1733
North Carolina,Granville County,5,3970,2293,1677
North Carolina,Granville County,6,3120,1616,1504
North Carolina,Granville County,7,3265,1742,1523
North Carolina,Granville County,8,3554,1824,1730
North Carolina,Granville County,9,4244,2138,2106
North Carolina,Granville County,10,4618,2412,2206
North Carolina,Granville County,11,4735,2474,2261
North Carolina,Granville County,12,4383,2191,2192
North Carolina,Granville County,13,3704,1825,1879
North Carolina,Granville County,14,3195,1555,1640
North Carolina,Granville County,15,2243,1055,1188
North Carolina,Granville County,16,1514,656,858
North Carolina,Granville County,17,1046,401,645
North Carolina,Granville County,18,939,272,667
North Carolina,Greene County,0,21093,11435,9658
North Carolina,Greene County,1,1215,645,570
North Carolina,Greene County,2,1291,667,624
North Carolina,Greene County,3,1252,654,598
North Carolina,Greene County,4,1198,607,591
North Carolina,Greene County,5,1386,850,536
North Carolina,Greene County,6,1368,879,489
North Carolina,Greene County,7,1470,921,549
North Carolina,Greene County,8,1458,894,564
North Carolina,Greene County,9,1430,846,584
North Carolina,Greene County,10,1394,808,586
North Carolina,Greene County,11,1593,850,743
North Carolina,Greene County,12,1580,789,791
North Carolina,Greene County,13,1343,675,668
North Carolina,Greene County,14,1086,549,537
North Carolina,Greene County,15,731,352,379
North Carolina,Greene County,16,552,219,333
North Carolina,Greene County,17,362,129,233
North Carolina,Greene County,18,384,101,283
North Carolina,Guilford County,0,512119,243484,268635
North Carolina,Guilford County,1,31158,15953,15205
North Carolina,Guilford County,2,32536,16508,16028
North Carolina,Guilford County,3,33350,16915,16435
North Carolina,Guilford County,4,36652,17852,18800
North Carolina,Guilford County,5,39186,19075,20111
North Carolina,Guilford County,6,36742,17200,19542
North Carolina,Guilford County,7,32891,15600,17291
North Carolina,Guilford County,8,31727,14952,16775
North Carolina,Guilford County,9,34705,16595,18110
North Carolina,Guilford County,10,34513,16548,17965
North Carolina,Guilford County,11,35671,17077,18594
North Carolina,Guilford County,12,33376,15879,17497
North Carolina,Guilford County,13,28969,13376,15593
North Carolina,Guilford County,14,23949,10991,12958
North Carolina,Guilford County,15,16577,7350,9227
North Carolina,Guilford County,16,11878,5063,6815
North Carolina,Guilford County,17,8759,3448,5311
North Carolina,Guilford County,18,9480,3102,6378
North Carolina,Halifax County,0,52970,25300,27670
North Carolina,Halifax County,1,2889,1454,1435
North Carolina,Halifax County,2,3278,1694,1584
North Carolina,Halifax County,3,3402,1683,1719
North Carolina,Halifax County,4,3112,1610,1502
North Carolina,Halifax County,5,3589,1834,1755
North Carolina,Halifax County,6,2982,1474,1508
North Carolina,Halifax County,7,2919,1434,1485
North Carolina,Halifax County,8,2703,1385,1318
North Carolina,Halifax County,9,3067,1469,1598
North Carolina,Halifax County,10,3445,1672,1773
North Carolina,Halifax County,11,4070,1950,2120
North Carolina,Halifax County,12,3983,1855,2128
North Carolina,Halifax County,13,3822,1775,2047
North Carolina,Halifax County,14,3116,1426,1690
North Carolina,Halifax County,15,2346,1035,1311
North Carolina,Halifax County,16,1783,743,1040
North Carolina,Halifax County,17,1217,454,763
North Carolina,Halifax County,18,1247,353,894
North Carolina,Harnett County,0,126666,62708,63958
North Carolina,Harnett County,1,9489,4852,4637
North Carolina,Harnett County,2,10164,5194,4970
North Carolina,Harnett County,3,9498,4857,4641
North Carolina,Harnett County,4,8824,4478,4346
North Carolina,Harnett County,5,8573,4419,4154
North Carolina,Harnett County,6,9465,4775,4690
North Carolina,Harnett County,7,10050,5092,4958
North Carolina,Harnett County,8,8834,4449,4385
North Carolina,Harnett County,9,8536,4259,4277
North Carolina,Harnett County,10,8048,4044,4004
North Carolina,Harnett County,11,7943,3932,4011
North Carolina,Harnett County,12,7113,3488,3625
North Carolina,Harnett County,13,5980,2840,3140
North Carolina,Harnett County,14,4975,2278,2697
North Carolina,Harnett County,15,3642,1660,1982
North Carolina,Harnett County,16,2541,1072,1469
North Carolina,Harnett County,17,1639,606,1033
North Carolina,Harnett County,18,1352,413,939
North Carolina,Haywood County,0,59471,28633,30838
North Carolina,Haywood County,1,2640,1314,1326
North Carolina,Haywood County,2,2972,1508,1464
North Carolina,Haywood County,3,3270,1714,1556
North Carolina,Haywood County,4,3138,1599,1539
North Carolina,Haywood County,5,3209,1709,1500
North Carolina,Haywood County,6,3083,1508,1575
North Carolina,Haywood County,7,2947,1454,1493
North Carolina,Haywood County,8,3107,1522,1585
North Carolina,Haywood County,9,3704,1822,1882
North Carolina,Haywood County,10,3985,1925,2060
North Carolina,Haywood County,11,4443,2121,2322
North Carolina,Haywood County,12,4416,2052,2364
North Carolina,Haywood County,13,4449,2129,2320
North Carolina,Haywood County,14,4498,2104,2394
North Carolina,Haywood County,15,3567,1669,1898
North Carolina,Haywood County,16,2574,1170,1404
North Carolina,Haywood County,17,1797,734,1063
North Carolina,Haywood County,18,1672,579,1093
North Carolina,Henderson County,0,111149,53686,57463
North Carolina,Henderson County,1,5461,2845,2616
North Carolina,Henderson County,2,6280,3191,3089
North Carolina,Henderson County,3,6345,3246,3099
North Carolina,Henderson County,4,5798,2982,2816
North Carolina,Henderson County,5,5375,2781,2594
North Carolina,Henderson County,6,5234,2607,2627
North Carolina,Henderson County,7,5872,2917,2955
North Carolina,Henderson County,8,6094,3065,3029
North Carolina,Henderson County,9,6745,3328,3417
North Carolina,Henderson County,10,7001,3521,3480
North Carolina,Henderson County,11,7697,3673,4024
North Carolina,Henderson County,12,7942,3758,4184
North Carolina,Henderson County,13,8092,3666,4426
North Carolina,Henderson County,14,8232,3822,4410
North Carolina,Henderson County,15,6765,3069,3696
North Carolina,Henderson County,16,4955,2241,2714
North Carolina,Henderson County,17,3622,1632,1990
North Carolina,Henderson County,18,3639,1342,2297
North Carolina,Hertford County,0,24308,12004,12304
North Carolina,Hertford County,1,1289,646,643
North Carolina,Hertford County,2,1359,719,640
North Carolina,Hertford County,3,1380,711,669
North Carolina,Hertford County,4,1744,918,826
North Carolina,Hertford County,5,1779,903,876
North Carolina,Hertford County,6,1451,812,639
North Carolina,Hertford County,7,1413,754,659
North Carolina,Hertford County,8,1363,715,648
North Carolina,Hertford County,9,1372,751,621
North Carolina,Hertford County,10,1479,743,736
North Carolina,Hertford County,11,1796,870,926
North Carolina,Hertford County,12,1948,946,1002
North Carolina,Hertford County,13,1687,786,901
North Carolina,Hertford County,14,1344,615,729
North Carolina,Hertford County,15,1047,473,574
North Carolina,Hertford County,16,758,287,471
North Carolina,Hertford County,17,540,191,349
North Carolina,Hertford County,18,559,164,395
North Carolina,Hoke County,0,51611,25480,26131
North Carolina,Hoke County,1,4802,2407,2395
North Carolina,Hoke County,2,4218,2148,2070
North Carolina,Hoke County,3,3802,1953,1849
North Carolina,Hoke County,4,3115,1560,1555
North Carolina,Hoke County,5,3388,1693,1695
North Carolina,Hoke County,6,4733,2419,2314
North Carolina,Hoke County,7,4834,2448,2386
North Carolina,Hoke County,8,3730,1894,1836
North Carolina,Hoke County,9,3358,1660,1698
North Carolina,Hoke County,10,2969,1448,1521
North Carolina,Hoke County,11,3225,1547,1678
North Carolina,Hoke County,12,2828,1327,1501
North Carolina,Hoke County,13,2274,1094,1180
North Carolina,Hoke County,14,1715,790,925
North Carolina,Hoke County,15,1069,512,557
North Carolina,Hoke County,16,732,292,440
North Carolina,Hoke County,17,417,169,248
North Carolina,Hoke County,18,402,119,283
North Carolina,Hyde County,0,5676,3153,2523
North Carolina,Hyde County,1,250,140,110
North Carolina,Hyde County,2,309,158,151
North Carolina,Hyde County,3,297,149,148
North Carolina,Hyde County,4,262,146,116
North Carolina,Hyde County,5,320,186,134
North Carolina,Hyde County,6,354,245,109
North Carolina,Hyde County,7,417,285,132
North Carolina,Hyde County,8,397,268,129
North Carolina,Hyde County,9,378,217,161
North Carolina,Hyde County,10,375,227,148
North Carolina,Hyde County,11,383,204,179
North Carolina,Hyde County,12,463,239,224
North Carolina,Hyde County,13,466,246,220
North Carolina,Hyde County,14,330,158,172
North Carolina,Hyde County,15,239,130,109
North Carolina,Hyde County,16,182,72,110
North Carolina,Hyde County,17,136,58,78
North Carolina,Hyde County,18,118,25,93
North Carolina,Iredell County,0,166675,81981,84694
North Carolina,Iredell County,1,9303,4729,4574
North Carolina,Iredell County,2,10910,5640,5270
North Carolina,Iredell County,3,12239,6176,6063
North Carolina,Iredell County,4,11312,5877,5435
North Carolina,Iredell County,5,10454,5576,4878
North Carolina,Iredell County,6,9010,4542,4468
North Carolina,Iredell County,7,9524,4635,4889
North Carolina,Iredell County,8,10035,4862,5173
North Carolina,Iredell County,9,12496,6170,6326
North Carolina,Iredell County,10,12756,6239,6517
North Carolina,Iredell County,11,13332,6611,6721
North Carolina,Iredell County,12,11487,5617,5870
North Carolina,Iredell County,13,9482,4637,4845
North Carolina,Iredell County,14,8515,4024,4491
North Carolina,Iredell County,15,6182,2854,3328
North Carolina,Iredell County,16,4350,1865,2485
North Carolina,Iredell County,17,2806,1162,1644
North Carolina,Iredell County,18,2482,765,1717
North Carolina,Jackson County,0,40981,20124,20857
North Carolina,Jackson County,1,1946,999,947
North Carolina,Jackson County,2,1939,974,965
North Carolina,Jackson County,3,1978,1080,898
North Carolina,Jackson County,4,3745,1848,1897
North Carolina,Jackson County,5,5163,2520,2643
North Carolina,Jackson County,6,2418,1262,1156
North Carolina,Jackson County,7,2249,1194,1055
North Carolina,Jackson County,8,2046,963,1083
North Carolina,Jackson County,9,2182,1137,1045
North Carolina,Jackson County,10,2174,1089,1085
North Carolina,Jackson County,11,2521,1188,1333
North Carolina,Jackson County,12,2613,1251,1362
North Carolina,Jackson County,13,2745,1274,1471
North Carolina,Jackson County,14,2649,1283,1366
North Carolina,Jackson County,15,1945,943,1002
North Carolina,Jackson County,16,1238,543,695
North Carolina,Jackson County,17,791,336,455
North Carolina,Jackson County,18,639,240,399
North Carolina,Johnston County,0,181423,89146,92277
North Carolina,Johnston County,1,11756,5838,5918
North Carolina,Johnston County,2,13810,7070,6740
North Carolina,Johnston County,3,14318,7418,6900
North Carolina,Johnston County,4,12161,6317,5844
North Carolina,Johnston County,5,10500,5525,4975
North Carolina,Johnston County,6,9866,4885,4981
North Carolina,Johnston County,7,11393,5609,5784
North Carolina,Johnston County,8,12680,6233,6447
North Carolina,Johnston County,9,14616,7109,7507
North Carolina,Johnston County,10,13873,6896,6977
North Carolina,Johnston County,11,13186,6565,6621
North Carolina,Johnston County,12,11147,5386,5761
North Carolina,Johnston County,13,9865,4624,5241
North Carolina,Johnston County,14,8442,3901,4541
North Carolina,Johnston County,15,5731,2647,3084
North Carolina,Johnston County,16,3770,1616,2154
North Carolina,Johnston County,17,2297,890,1407
North Carolina,Johnston County,18,2012,617,1395
North Carolina,Jones County,0,10076,4912,5164
North Carolina,Jones County,1,457,224,233
North Carolina,Jones County,2,555,288,267
North Carolina,Jones County,3,561,286,275
North Carolina,Jones County,4,529,278,251
North Carolina,Jones County,5,633,374,259
North Carolina,Jones County,6,579,275,304
North Carolina,Jones County,7,516,275,241
North Carolina,Jones County,8,476,221,255
North Carolina,Jones County,9,536,277,259
North Carolina,Jones County,10,638,301,337
North Carolina,Jones County,11,777,354,423
North Carolina,Jones County,12,881,436,445
North Carolina,Jones County,13,752,351,401
North Carolina,Jones County,14,722,346,376
North Carolina,Jones County,15,541,242,299
North Carolina,Jones County,16,401,196,205
North Carolina,Jones County,17,253,108,145
North Carolina,Jones County,18,269,80,189
North Carolina,Lee County,0,59662,29332,30330
North Carolina,Lee County,1,4176,2130,2046
North Carolina,Lee County,2,4304,2239,2065
North Carolina,Lee County,3,4196,2136,2060
North Carolina,Lee County,4,3826,1964,1862
North Carolina,Lee County,5,3851,2001,1850
North Carolina,Lee County,6,3707,1850,1857
North Carolina,Lee County,7,3718,1890,1828
North Carolina,Lee County,8,3751,1900,1851
North Carolina,Lee County,9,3867,1885,1982
North Carolina,Lee County,10,3864,1945,1919
North Carolina,Lee County,11,4059,1985,2074
North Carolina,Lee County,12,3954,1928,2026
North Carolina,Lee County,13,3454,1647,1807
North Carolina,Lee County,14,2996,1421,1575
North Carolina,Lee County,15,2245,1011,1234
North Carolina,Lee County,16,1482,593,889
North Carolina,Lee County,17,1107,449,658
North Carolina,Lee County,18,1105,358,747
North Carolina,Lenoir County,0,58485,27941,30544
North Carolina,Lenoir County,1,3426,1702,1724
North Carolina,Lenoir County,2,3807,1915,1892
North Carolina,Lenoir County,3,3677,1954,1723
North Carolina,Lenoir County,4,3856,2048,1808
North Carolina,Lenoir County,5,3769,1976,1793
North Carolina,Lenoir County,6,3218,1577,1641
North Carolina,Lenoir County,7,3212,1565,1647
North Carolina,Lenoir County,8,3094,1485,1609
North Carolina,Lenoir County,9,3403,1654,1749
North Carolina,Lenoir County,10,3611,1701,1910
North Carolina,Lenoir County,11,4393,2123,2270
North Carolina,Lenoir County,12,4584,2147,2437
North Carolina,Lenoir County,13,3982,1815,2167
North Carolina,Lenoir County,14,3451,1544,1907
North Carolina,Lenoir County,15,2481,1059,1422
North Carolina,Lenoir County,16,1919,782,1137
North Carolina,Lenoir County,17,1393,507,886
North Carolina,Lenoir County,18,1209,387,822
North Carolina,Lincoln County,0,79829,39778,40051
North Carolina,Lincoln County,1,4024,2068,1956
North Carolina,Lincoln County,2,4814,2489,2325
North Carolina,Lincoln County,3,5426,2833,2593
North Carolina,Lincoln County,4,4966,2611,2355
North Carolina,Lincoln County,5,4644,2473,2171
North Carolina,Lincoln County,6,4215,2170,2045
North Carolina,Lincoln County,7,4084,2037,2047
North Carolina,Lincoln County,8,4887,2359,2528
North Carolina,Lincoln County,9,6063,2988,3075
North Carolina,Lincoln County,10,6284,3189,3095
North Carolina,Lincoln County,11,6516,3264,3252
North Carolina,Lincoln County,12,6051,2971,3080
North Carolina,Lincoln County,13,5147,2538,2609
North Carolina,Lincoln County,14,4699,2263,2436
North Carolina,Lincoln County,15,3421,1670,1751
North Carolina,Lincoln County,16,2120,952,1168
North Carolina,Lincoln County,17,1385,563,822
North Carolina,Lincoln County,18,1083,340,743
North Carolina,McDowell County,0,44965,22567,22398
North Carolina,McDowell County,1,2342,1263,1079
North Carolina,McDowell County,2,2597,1370,1227
North Carolina,McDowell County,3,2707,1395,1312
North Carolina,McDowell County,4,2582,1315,1267
North Carolina,McDowell County,5,2623,1389,1234
North Carolina,McDowell County,6,2515,1355,1160
North Carolina,McDowell County,7,2481,1343,1138
North Carolina,McDowell County,8,2633,1362,1271
North Carolina,McDowell County,9,3115,1600,1515
North Carolina,McDowell County,10,3172,1609,1563
North Carolina,McDowell County,11,3343,1649,1694
North Carolina,McDowell County,12,3382,1669,1713
North Carolina,McDowell County,13,3140,1536,1604
North Carolina,McDowell County,14,2814,1347,1467
North Carolina,McDowell County,15,2072,1006,1066
North Carolina,McDowell County,16,1535,687,848
North Carolina,McDowell County,17,972,371,601
North Carolina,McDowell County,18,940,301,639
North Carolina,Macon County,0,33875,16471,17404
North Carolina,Macon County,1,1650,869,781
North Carolina,Macon County,2,1781,886,895
North Carolina,Macon County,3,1792,946,846
North Carolina,Macon County,4,1827,957,870
North Carolina,Macon County,5,1731,915,816
North Carolina,Macon County,6,1599,809,790
North Carolina,Macon County,7,1658,814,844
North Carolina,Macon County,8,1590,838,752
North Carolina,Macon County,9,1731,861,870
North Carolina,Macon County,10,1924,955,969
North Carolina,Macon County,11,2343,1107,1236
North Carolina,Macon County,12,2493,1192,1301
North Carolina,Macon County,13,2809,1293,1516
North Carolina,Macon County,14,2798,1275,1523
North Carolina,Macon County,15,2305,1088,1217
North Carolina,Macon County,16,1678,781,897
North Carolina,Macon County,17,1156,531,625
North Carolina,Macon County,18,1010,354,656
North Carolina,Madison County,0,21157,10525,10632
North Carolina,Madison County,1,1030,588,442
North Carolina,Madison County,2,1000,535,465
North Carolina,Madison County,3,1232,639,593
North Carolina,Madison County,4,1613,859,754
North Carolina,Madison County,5,1493,799,694
North Carolina,Madison County,6,1055,539,516
North Carolina,Madison County,7,1045,478,567
North Carolina,Madison County,8,1204,608,596
North Carolina,Madison County,9,1300,642,658
North Carolina,Madison County,10,1327,670,657
North Carolina,Madison County,11,1543,780,763
North Carolina,Madison County,12,1544,745,799
North Carolina,Madison County,13,1581,766,815
North Carolina,Madison County,14,1465,700,765
North Carolina,Madison County,15,1053,500,553
North Carolina,Madison County,16,725,319,406
North Carolina,Madison County,17,478,213,265
North Carolina,Madison County,18,469,145,324
North Carolina,Martin County,0,23454,11016,12438
North Carolina,Martin County,1,1213,653,560
North Carolina,Martin County,2,1334,682,652
North Carolina,Martin County,3,1403,668,735
North Carolina,Martin County,4,1356,684,672
North Carolina,Martin County,5,1426,720,706
North Carolina,Martin County,6,1183,552,631
North Carolina,Martin County,7,1094,515,579
North Carolina,Martin County,8,1106,501,605
North Carolina,Martin County,9,1396,645,751
North Carolina,Martin County,10,1548,739,809
North Carolina,Martin County,11,1709,824,885
North Carolina,Martin County,12,1973,930,1043
North Carolina,Martin County,13,1870,875,995
North Carolina,Martin County,14,1645,758,887
North Carolina,Martin County,15,1171,516,655
North Carolina,Martin County,16,941,382,559
North Carolina,Martin County,17,606,210,396
North Carolina,Martin County,18,480,162,318
North Carolina,Mecklenburg County,0,1012539,487068,525471
North Carolina,Mecklenburg County,1,70673,36137,34536
North Carolina,Mecklenburg County,2,70905,35878,35027
North Carolina,Mecklenburg County,3,68578,34506,34072
North Carolina,Mecklenburg County,4,64050,32326,31724
North Carolina,Mecklenburg County,5,70129,34782,35347
North Carolina,Mecklenburg County,6,83244,40270,42974
North Carolina,Mecklenburg County,7,83937,40689,43248
North Carolina,Mecklenburg County,8,77260,37031,40229
North Carolina,Mecklenburg County,9,77062,36930,40132
North Carolina,Mecklenburg County,10,70207,33893,36314
North Carolina,Mecklenburg County,11,67815,32493,35322
North Carolina,Mecklenburg County,12,59018,27974,31044
North Carolina,Mecklenburg County,13,47995,21830,26165
North Carolina,Mecklenburg County,14,37216,16914,20302
North Carolina,Mecklenburg County,15,24094,10611,13483
North Carolina,Mecklenburg County,16,15829,6524,9305
North Carolina,Mecklenburg County,17,11626,4340,7286
North Carolina,Mecklenburg County,18,12901,3940,8961
North Carolina,Mitchell County,0,15311,7579,7732
North Carolina,Mitchell County,1,702,369,333
North Carolina,Mitchell County,2,799,402,397
North Carolina,Mitchell County,3,835,441,394
North Carolina,Mitchell County,4,820,456,364
North Carolina,Mitchell County,5,801,427,374
North Carolina,Mitchell County,6,780,382,398
North Carolina,Mitchell County,7,778,386,392
North Carolina,Mitchell County,8,789,399,390
North Carolina,Mitchell County,9,894,481,413
North Carolina,Mitchell County,10,1038,514,524
North Carolina,Mitchell County,11,1115,553,562
North Carolina,Mitchell County,12,1209,567,642
North Carolina,Mitchell County,13,1161,562,599
North Carolina,Mitchell County,14,1125,545,580
North Carolina,Mitchell County,15,917,466,451
North Carolina,Mitchell County,16,682,323,359
North Carolina,Mitchell County,17,436,157,279
North Carolina,Mitchell County,18,430,149,281
North Carolina,Montgomery County,0,27395,13319,14076
North Carolina,Montgomery County,1,1663,845,818
North Carolina,Montgomery County,2,1678,816,862
North Carolina,Montgomery County,3,1884,954,930
North Carolina,Montgomery County,4,1743,909,834
North Carolina,Montgomery County,5,1660,883,777
North Carolina,Montgomery County,6,1424,710,714
North Carolina,Montgomery County,7,1487,694,793
North Carolina,Montgomery County,8,1556,786,770
North Carolina,Montgomery County,9,1718,802,916
North Carolina,Montgomery County,10,1733,849,884
North Carolina,Montgomery County,11,1866,943,923
North Carolina,Montgomery County,12,2025,983,1042
North Carolina,Montgomery County,13,1889,910,979
North Carolina,Montgomery County,14,1747,843,904
North Carolina,Montgomery County,15,1299,611,688
North Carolina,Montgomery County,16,843,373,470
North Carolina,Montgomery County,17,579,233,346
North Carolina,Montgomery County,18,601,175,426
North Carolina,Moore County,0,93077,44658,48419
North Carolina,Moore County,1,4999,2473,2526
North Carolina,Moore County,2,5596,2821,2775
North Carolina,Moore County,3,5723,2951,2772
North Carolina,Moore County,4,5138,2642,2496
North Carolina,Moore County,5,4690,2427,2263
North Carolina,Moore County,6,4613,2261,2352
North Carolina,Moore County,7,5428,2670,2758
North Carolina,Moore County,8,5141,2500,2641
North Carolina,Moore County,9,5485,2639,2846
North Carolina,Moore County,10,5531,2658,2873
North Carolina,Moore County,11,6251,2943,3308
North Carolina,Moore County,12,6178,2924,3254
North Carolina,Moore County,13,6112,2751,3361
North Carolina,Moore County,14,6459,2978,3481
North Carolina,Moore County,15,5328,2528,2800
North Carolina,Moore County,16,3984,1844,2140
North Carolina,Moore County,17,3044,1383,1661
North Carolina,Moore County,18,3377,1265,2112
North Carolina,Nash County,0,94357,45407,48950
North Carolina,Nash County,1,5461,2721,2740
North Carolina,Nash County,2,5942,3052,2890
North Carolina,Nash County,3,6335,3299,3036
North Carolina,Nash County,4,6226,3153,3073
North Carolina,Nash County,5,6170,3262,2908
North Carolina,Nash County,6,5135,2516,2619
North Carolina,Nash County,7,5254,2567,2687
North Carolina,Nash County,8,5443,2555,2888
North Carolina,Nash County,9,6142,2995,3147
North Carolina,Nash County,10,6375,3031,3344
North Carolina,Nash County,11,7195,3518,3677
North Carolina,Nash County,12,6873,3274,3599
North Carolina,Nash County,13,6330,2895,3435
North Carolina,Nash County,14,5359,2530,2829
North Carolina,Nash County,15,3774,1723,2051
North Carolina,Nash County,16,2665,1090,1575
North Carolina,Nash County,17,1855,682,1173
North Carolina,Nash County,18,1823,544,1279
North Carolina,New Hanover County,0,216298,103884,112414
North Carolina,New Hanover County,1,11437,5667,5770
North Carolina,New Hanover County,2,12054,6188,5866
North Carolina,New Hanover County,3,11695,5992,5703
North Carolina,New Hanover County,4,13742,6561,7181
North Carolina,New Hanover County,5,21283,10440,10843
North Carolina,New Hanover County,6,14534,7249,7285
North Carolina,New Hanover County,7,14885,7444,7441
North Carolina,New Hanover County,8,13488,6723,6765
North Carolina,New Hanover County,9,14207,7044,7163
North Carolina,New Hanover County,10,13277,6563,6714
North Carolina,New Hanover County,11,14198,6757,7441
North Carolina,New Hanover County,12,13980,6394,7586
North Carolina,New Hanover County,13,13343,6071,7272
North Carolina,New Hanover County,14,11919,5437,6482
North Carolina,New Hanover County,15,8305,3781,4524
North Carolina,New Hanover County,16,5633,2534,3099
North Carolina,New Hanover County,17,3998,1650,2348
North Carolina,New Hanover County,18,4320,1389,2931
North Carolina,Northampton County,0,20463,9854,10609
North Carolina,Northampton County,1,1051,536,515
North Carolina,Northampton County,2,1095,596,499
North Carolina,Northampton County,3,1071,545,526
North Carolina,Northampton County,4,1078,539,539
North Carolina,Northampton County,5,1224,666,558
North Carolina,Northampton County,6,1022,559,463
North Carolina,Northampton County,7,966,479,487
North Carolina,Northampton County,8,880,443,437
North Carolina,Northampton County,9,1081,553,528
North Carolina,Northampton County,10,1256,620,636
North Carolina,Northampton County,11,1605,729,876
North Carolina,Northampton County,12,1804,850,954
North Carolina,Northampton County,13,1615,780,835
North Carolina,Northampton County,14,1493,697,796
North Carolina,Northampton County,15,1177,536,641
North Carolina,Northampton County,16,791,319,472
North Carolina,Northampton County,17,637,218,419
North Carolina,Northampton County,18,617,189,428
North Carolina,Onslow County,0,187589,102464,85125
North Carolina,Onslow County,1,18461,9467,8994
North Carolina,Onslow County,2,13110,6658,6452
North Carolina,Onslow County,3,10379,5330,5049
North Carolina,Onslow County,4,12746,7950,4796
North Carolina,Onslow County,5,33307,23242,10065
North Carolina,Onslow County,6,21209,11886,9323
North Carolina,Onslow County,7,14183,7423,6760
North Carolina,Onslow County,8,10190,5318,4872
North Carolina,Onslow County,9,8526,4191,4335
North Carolina,Onslow County,10,7543,3612,3931
North Carolina,Onslow County,11,8269,3864,4405
North Carolina,Onslow County,12,7726,3685,4041
North Carolina,Onslow County,13,6157,2904,3253
North Carolina,Onslow County,14,5272,2434,2838
North Carolina,Onslow County,15,4017,1829,2188
North Carolina,Onslow County,16,3005,1309,1696
North Carolina,Onslow County,17,1904,813,1091
North Carolina,Onslow County,18,1585,549,1036
North Carolina,Orange County,0,140420,67103,73317
North Carolina,Orange County,1,6657,3459,3198
North Carolina,Orange County,2,8062,4131,3931
North Carolina,Orange County,3,8736,4510,4226
North Carolina,Orange County,4,13505,6291,7214
North Carolina,Orange County,5,17826,8185,9641
North Carolina,Orange County,6,9500,4606,4894
North Carolina,Orange County,7,7905,3886,4019
North Carolina,Orange County,8,7874,3898,3976
North Carolina,Orange County,9,8803,4169,4634
North Carolina,Orange County,10,9195,4477,4718
North Carolina,Orange County,11,9457,4428,5029
North Carolina,Orange County,12,8992,4227,4765
North Carolina,Orange County,13,8148,3903,4245
North Carolina,Orange County,14,5925,2810,3115
North Carolina,Orange County,15,3899,1813,2086
North Carolina,Orange County,16,2434,1044,1390
North Carolina,Orange County,17,1678,671,1007
North Carolina,Orange County,18,1824,595,1229
North Carolina,Pamlico County,0,12948,6641,6307
North Carolina,Pamlico County,1,489,259,230
North Carolina,Pamlico County,2,596,288,308
North Carolina,Pamlico County,3,629,325,304
North Carolina,Pamlico County,4,649,344,305
North Carolina,Pamlico County,5,658,359,299
North Carolina,Pamlico County,6,636,377,259
North Carolina,Pamlico County,7,668,368,300
North Carolina,Pamlico County,8,608,347,261
North Carolina,Pamlico County,9,679,359,320
North Carolina,Pamlico County,10,747,422,325
North Carolina,Pamlico County,11,980,483,497
North Carolina,Pamlico County,12,1104,546,558
North Carolina,Pamlico County,13,1135,530,605
North Carolina,Pamlico County,14,1153,575,578
North Carolina,Pamlico County,15,876,457,419
North Carolina,Pamlico County,16,580,278,302
North Carolina,Pamlico County,17,434,210,224
North Carolina,Pamlico County,18,327,114,213
North Carolina,Pasquotank County,0,39787,19556,20231
North Carolina,Pasquotank County,1,2419,1262,1157
North Carolina,Pasquotank County,2,2501,1313,1188
North Carolina,Pasquotank County,3,2342,1181,1161
North Carolina,Pasquotank County,4,2645,1309,1336
North Carolina,Pasquotank County,5,3235,1654,1581
North Carolina,Pasquotank County,6,2887,1537,1350
North Carolina,Pasquotank County,7,2664,1363,1301
North Carolina,Pasquotank County,8,2259,1136,1123
North Carolina,Pasquotank County,9,2334,1204,1130
North Carolina,Pasquotank County,10,2423,1212,1211
North Carolina,Pasquotank County,11,2836,1385,1451
North Carolina,Pasquotank County,12,2777,1299,1478
North Carolina,Pasquotank County,13,2308,1063,1245
North Carolina,Pasquotank County,14,2037,944,1093
North Carolina,Pasquotank County,15,1517,669,848
North Carolina,Pasquotank County,16,1052,473,579
North Carolina,Pasquotank County,17,754,288,466
North Carolina,Pasquotank County,18,797,264,533
North Carolina,Pender County,0,56250,28135,28115
North Carolina,Pender County,1,3112,1629,1483
North Carolina,Pender County,2,3541,1790,1751
North Carolina,Pender County,3,3678,1864,1814
North Carolina,Pender County,4,3481,1758,1723
North Carolina,Pender County,5,3250,1791,1459
North Carolina,Pender County,6,2846,1480,1366
North Carolina,Pender County,7,3291,1639,1652
North Carolina,Pender County,8,3380,1755,1625
North Carolina,Pender County,9,3870,1910,1960
North Carolina,Pender County,10,3852,1958,1894
North Carolina,Pender County,11,4316,2175,2141
North Carolina,Pender County,12,4262,2103,2159
North Carolina,Pender County,13,3764,1818,1946
North Carolina,Pender County,14,3473,1710,1763
North Carolina,Pender County,15,2490,1201,1289
North Carolina,Pender County,16,1614,756,858
North Carolina,Pender County,17,1099,457,642
North Carolina,Pender County,18,931,341,590
North Carolina,Perquimans County,0,13466,6475,6991
North Carolina,Perquimans County,1,637,327,310
North Carolina,Perquimans County,2,815,387,428
North Carolina,Perquimans County,3,787,401,386
North Carolina,Perquimans County,4,710,362,348
North Carolina,Perquimans County,5,628,328,300
North Carolina,Perquimans County,6,679,330,349
North Carolina,Perquimans County,7,713,352,361
North Carolina,Perquimans County,8,662,315,347
North Carolina,Perquimans County,9,694,340,354
North Carolina,Perquimans County,10,783,373,410
North Carolina,Perquimans County,11,995,460,535
North Carolina,Perquimans County,12,1081,530,551
North Carolina,Perquimans County,13,1007,470,537
North Carolina,Perquimans County,14,1052,482,570
North Carolina,Perquimans County,15,923,437,486
North Carolina,Perquimans County,16,617,300,317
North Carolina,Perquimans County,17,347,156,191
North Carolina,Perquimans County,18,336,125,211
North Carolina,Person County,0,39132,19016,20116
North Carolina,Person County,1,2108,1079,1029
North Carolina,Person County,2,2324,1177,1147
North Carolina,Person County,3,2573,1362,1211
North Carolina,Person County,4,2350,1219,1131
North Carolina,Person County,5,2367,1213,1154
North Carolina,Person County,6,2068,1020,1048
North Carolina,Person County,7,2018,1015,1003
North Carolina,Person County,8,2201,1089,1112
North Carolina,Person County,9,2673,1275,1398
North Carolina,Person County,10,2625,1305,1320
North Carolina,Person County,11,3074,1516,1558
North Carolina,Person County,12,3175,1550,1625
North Carolina,Person County,13,2741,1278,1463
North Carolina,Person County,14,2350,1109,1241
North Carolina,Person County,15,1634,738,896
North Carolina,Person County,16,1197,509,688
North Carolina,Person County,17,838,315,523
North Carolina,Person County,18,816,247,569
North Carolina,Pitt County,0,175354,82833,92521
North Carolina,Pitt County,1,10676,5484,5192
North Carolina,Pitt County,2,11071,5662,5409
North Carolina,Pitt County,3,10599,5445,5154
North Carolina,Pitt County,4,14410,6821,7589
North Carolina,Pitt County,5,24038,11259,12779
North Carolina,Pitt County,6,12732,6089,6643
North Carolina,Pitt County,7,11380,5307,6073
North Carolina,Pitt County,8,10580,5065,5515
North Carolina,Pitt County,9,10462,4967,5495
North Carolina,Pitt County,10,9884,4675,5209
North Carolina,Pitt County,11,10389,4752,5637
North Carolina,Pitt County,12,10192,4676,5516
North Carolina,Pitt County,13,9043,4177,4866
North Carolina,Pitt County,14,7092,3300,3792
North Carolina,Pitt County,15,4723,2227,2496
North Carolina,Pitt County,16,3269,1359,1910
North Carolina,Pitt County,17,2402,861,1541
North Carolina,Pitt County,18,2412,707,1705
North Carolina,Polk County,0,20357,9739,10618
North Carolina,Polk County,1,725,346,379
North Carolina,Polk County,2,984,498,486
North Carolina,Polk County,3,1109,588,521
North Carolina,Polk County,4,1090,560,530
North Carolina,Polk County,5,990,547,443
North Carolina,Polk County,6,796,390,406
North Carolina,Polk County,7,791,414,377
North Carolina,Polk County,8,832,416,416
North Carolina,Polk County,9,1134,543,591
North Carolina,Polk County,10,1312,654,658
North Carolina,Polk County,11,1522,745,777
North Carolina,Polk County,12,1670,740,930
North Carolina,Polk County,13,1806,812,994
North Carolina,Polk County,14,1623,754,869
North Carolina,Polk County,15,1391,672,719
North Carolina,Polk County,16,962,459,503
North Carolina,Polk County,17,705,300,405
North Carolina,Polk County,18,915,301,614
North Carolina,Randolph County,0,142778,70548,72230
North Carolina,Randolph County,1,8228,4264,3964
North Carolina,Randolph County,2,9261,4760,4501
North Carolina,Randolph County,3,10094,5173,4921
North Carolina,Randolph County,4,9197,4787,4410
North Carolina,Randolph County,5,8692,4579,4113
North Carolina,Randolph County,6,7922,3883,4039
North Carolina,Randolph County,7,7806,3863,3943
North Carolina,Randolph County,8,8363,4021,4342
North Carolina,Randolph County,9,10120,5117,5003
North Carolina,Randolph County,10,10465,5229,5236
North Carolina,Randolph County,11,10781,5365,5416
North Carolina,Randolph County,12,10164,5084,5080
North Carolina,Randolph County,13,8703,4205,4498
North Carolina,Randolph County,14,7994,3824,4170
North Carolina,Randolph County,15,5862,2740,3122
North Carolina,Randolph County,16,3985,1761,2224
North Carolina,Randolph County,17,2769,1125,1644
North Carolina,Randolph County,18,2372,768,1604
North Carolina,Richmond County,0,45733,22361,23372
North Carolina,Richmond County,1,2827,1415,1412
North Carolina,Richmond County,2,3012,1521,1491
North Carolina,Richmond County,3,3041,1566,1475
North Carolina,Richmond County,4,3000,1568,1432
North Carolina,Richmond County,5,3358,1813,1545
North Carolina,Richmond County,6,2670,1312,1358
North Carolina,Richmond County,7,2508,1223,1285
North Carolina,Richmond County,8,2684,1315,1369
North Carolina,Richmond County,9,3059,1528,1531
North Carolina,Richmond County,10,2926,1391,1535
North Carolina,Richmond County,11,3246,1617,1629
North Carolina,Richmond County,12,3116,1523,1593
North Carolina,Richmond County,13,2941,1383,1558
North Carolina,Richmond County,14,2565,1185,1380
North Carolina,Richmond County,15,1800,809,991
North Carolina,Richmond County,16,1302,562,740
North Carolina,Richmond County,17,862,345,517
North Carolina,Richmond County,18,816,285,531
North Carolina,Robeson County,0,134760,65159,69601
North Carolina,Robeson County,1,9679,4942,4737
North Carolina,Robeson County,2,9913,5081,4832
North Carolina,Robeson County,3,9503,4858,4645
North Carolina,Robeson County,4,10178,5153,5025
North Carolina,Robeson County,5,10427,5305,5122
North Carolina,Robeson County,6,8490,4105,4385
North Carolina,Robeson County,7,8145,3852,4293
North Carolina,Robeson County,8,8256,4007,4249
North Carolina,Robeson County,9,8708,4197,4511
North Carolina,Robeson County,10,8414,4109,4305
North Carolina,Robeson County,11,8880,4285,4595
North Carolina,Robeson County,12,8816,4094,4722
North Carolina,Robeson County,13,7780,3620,4160
North Carolina,Robeson County,14,6599,3186,3413
North Carolina,Robeson County,15,4230,1888,2342
North Carolina,Robeson County,16,3058,1256,1802
North Carolina,Robeson County,17,1903,724,1179
North Carolina,Robeson County,18,1781,497,1284
North Carolina,Rockingham County,0,91696,44282,47414
North Carolina,Rockingham County,1,4687,2377,2310
North Carolina,Rockingham County,2,5294,2703,2591
North Carolina,Rockingham County,3,5701,2935,2766
North Carolina,Rockingham County,4,5452,2820,2632
North Carolina,Rockingham County,5,5367,2798,2569
North Carolina,Rockingham County,6,4785,2324,2461
North Carolina,Rockingham County,7,4706,2260,2446
North Carolina,Rockingham County,8,4994,2438,2556
North Carolina,Rockingham County,9,6123,2947,3176
North Carolina,Rockingham County,10,6676,3255,3421
North Carolina,Rockingham County,11,7257,3565,3692
North Carolina,Rockingham County,12,7309,3492,3817
North Carolina,Rockingham County,13,6475,3154,3321
North Carolina,Rockingham County,14,5547,2645,2902
North Carolina,Rockingham County,15,4127,1869,2258
North Carolina,Rockingham County,16,3083,1322,1761
North Carolina,Rockingham County,17,2065,798,1267
North Carolina,Rockingham County,18,2048,580,1468
North Carolina,Rowan County,0,138630,68351,70279
North Carolina,Rowan County,1,7715,3903,3812
North Carolina,Rowan County,2,9085,4638,4447
North Carolina,Rowan County,3,9163,4736,4427
North Carolina,Rowan County,4,8964,4637,4327
North Carolina,Rowan County,5,9373,4894,4479
North Carolina,Rowan County,6,8199,4066,4133
North Carolina,Rowan County,7,8170,4076,4094
North Carolina,Rowan County,8,8001,3988,4013
North Carolina,Rowan County,9,9080,4577,4503
North Carolina,Rowan County,10,9402,4690,4712
North Carolina,Rowan County,11,10383,5139,5244
North Carolina,Rowan County,12,9813,4882,4931
North Carolina,Rowan County,13,8641,4275,4366
North Carolina,Rowan County,14,7526,3567,3959
North Carolina,Rowan County,15,5692,2621,3071
North Carolina,Rowan County,16,3907,1693,2214
North Carolina,Rowan County,17,2773,1083,1690
North Carolina,Rowan County,18,2743,886,1857
North Carolina,Rutherford County,0,66600,32212,34388
North Carolina,Rutherford County,1,3505,1762,1743
North Carolina,Rutherford County,2,3915,1965,1950
North Carolina,Rutherford County,3,4251,2125,2126
North Carolina,Rutherford County,4,3934,2034,1900
North Carolina,Rutherford County,5,3949,2026,1923
North Carolina,Rutherford County,6,3337,1633,1704
North Carolina,Rutherford County,7,3300,1627,1673
North Carolina,Rutherford County,8,3734,1838,1896
North Carolina,Rutherford County,9,4320,2115,2205
North Carolina,Rutherford County,10,4708,2325,2383
North Carolina,Rutherford County,11,4931,2435,2496
North Carolina,Rutherford County,12,5028,2367,2661
North Carolina,Rutherford County,13,4692,2272,2420
North Carolina,Rutherford County,14,4435,2158,2277
North Carolina,Rutherford County,15,3295,1503,1792
North Carolina,Rutherford County,16,2308,1016,1292
North Carolina,Rutherford County,17,1531,587,944
North Carolina,Rutherford County,18,1427,424,1003
North Carolina,Sampson County,0,64050,31496,32554
North Carolina,Sampson County,1,4143,2138,2005
North Carolina,Sampson County,2,4368,2216,2152
North Carolina,Sampson County,3,4661,2383,2278
North Carolina,Sampson County,4,4181,2184,1997
North Carolina,Sampson County,5,4045,2059,1986
North Carolina,Sampson County,6,3446,1725,1721
North Carolina,Sampson County,7,3753,1862,1891
North Carolina,Sampson County,8,3929,1925,2004
North Carolina,Sampson County,9,4246,2202,2044
North Carolina,Sampson County,10,4322,2166,2156
North Carolina,Sampson County,11,4375,2242,2133
North Carolina,Sampson County,12,4369,2126,2243
North Carolina,Sampson County,13,3937,1927,2010
North Carolina,Sampson County,14,3348,1549,1799
North Carolina,Sampson County,15,2555,1129,1426
North Carolina,Sampson County,16,1924,787,1137
North Carolina,Sampson County,17,1283,481,802
North Carolina,Sampson County,18,1165,395,770
North Carolina,Scotland County,0,35576,17509,18067
North Carolina,Scotland County,1,2300,1115,1185
North Carolina,Scotland County,2,2399,1258,1141
North Carolina,Scotland County,3,2209,1186,1023
North Carolina,Scotland County,4,2474,1257,1217
North Carolina,Scotland County,5,2615,1341,1274
North Carolina,Scotland County,6,2064,1063,1001
North Carolina,Scotland County,7,2005,1040,965
North Carolina,Scotland County,8,2104,1090,1014
North Carolina,Scotland County,9,2224,1112,1112
North Carolina,Scotland County,10,2307,1192,1115
North Carolina,Scotland County,11,2409,1158,1251
North Carolina,Scotland County,12,2471,1221,1250
North Carolina,Scotland County,13,2279,1040,1239
North Carolina,Scotland County,14,1971,933,1038
North Carolina,Scotland County,15,1437,673,764
North Carolina,Scotland County,16,959,391,568
North Carolina,Scotland County,17,641,259,382
North Carolina,Scotland County,18,708,180,528
North Carolina,Stanly County,0,60600,30187,30413
North Carolina,Stanly County,1,3333,1688,1645
North Carolina,Stanly County,2,3713,1867,1846
North Carolina,Stanly County,3,3824,1969,1855
North Carolina,Stanly County,4,3752,1964,1788
North Carolina,Stanly County,5,4095,2228,1867
North Carolina,Stanly County,6,3687,1905,1782
North Carolina,Stanly County,7,3279,1643,1636
North Carolina,Stanly County,8,3308,1714,1594
North Carolina,Stanly County,9,3993,2041,1952
North Carolina,Stanly County,10,4202,2120,2082
North Carolina,Stanly County,11,4549,2277,2272
North Carolina,Stanly County,12,4215,2082,2133
North Carolina,Stanly County,13,3969,1978,1991
North Carolina,Stanly County,14,3553,1718,1835
North Carolina,Stanly County,15,2755,1237,1518
North Carolina,Stanly County,16,1903,865,1038
North Carolina,Stanly County,17,1308,512,796
North Carolina,Stanly County,18,1162,379,783
North Carolina,Stokes County,0,46419,22789,23630
North Carolina,Stokes County,1,2112,1106,1006
North Carolina,Stokes County,2,2472,1282,1190
North Carolina,Stokes County,3,2830,1430,1400
North Carolina,Stokes County,4,2916,1496,1420
North Carolina,Stokes County,5,2695,1411,1284
North Carolina,Stokes County,6,2235,1145,1090
North Carolina,Stokes County,7,2245,1104,1141
North Carolina,Stokes County,8,2480,1212,1268
North Carolina,Stokes County,9,3217,1563,1654
North Carolina,Stokes County,10,3544,1759,1785
North Carolina,Stokes County,11,3900,1960,1940
North Carolina,Stokes County,12,3693,1801,1892
North Carolina,Stokes County,13,3199,1576,1623
North Carolina,Stokes County,14,2944,1409,1535
North Carolina,Stokes County,15,2311,1035,1276
North Carolina,Stokes County,16,1619,778,841
North Carolina,Stokes County,17,1015,401,614
North Carolina,Stokes County,18,992,321,671
North Carolina,Surry County,0,72968,35693,37275
North Carolina,Surry County,1,3903,2056,1847
North Carolina,Surry County,2,4419,2241,2178
North Carolina,Surry County,3,4763,2439,2324
North Carolina,Surry County,4,4697,2417,2280
North Carolina,Surry County,5,4356,2394,1962
North Carolina,Surry County,6,3615,1747,1868
North Carolina,Surry County,7,3730,1870,1860
North Carolina,Surry County,8,4106,2013,2093
North Carolina,Surry County,9,5027,2451,2576
North Carolina,Surry County,10,5222,2586,2636
North Carolina,Surry County,11,5409,2697,2712
North Carolina,Surry County,12,5106,2487,2619
North Carolina,Surry County,13,4801,2320,2481
North Carolina,Surry County,14,4446,2121,2325
North Carolina,Surry County,15,3403,1552,1851
North Carolina,Surry County,16,2508,1071,1437
North Carolina,Surry County,17,1740,682,1058
North Carolina,Surry County,18,1717,549,1168
North Carolina,Swain County,0,14274,6890,7384
North Carolina,Swain County,1,896,442,454
North Carolina,Swain County,2,901,443,458
North Carolina,Swain County,3,877,460,417
North Carolina,Swain County,4,905,453,452
North Carolina,Swain County,5,987,529,458
North Carolina,Swain County,6,833,379,454
North Carolina,Swain County,7,790,374,416
North Carolina,Swain County,8,787,391,396
North Carolina,Swain County,9,903,448,455
North Carolina,Swain County,10,854,409,445
North Carolina,Swain County,11,999,504,495
North Carolina,Swain County,12,998,455,543
North Carolina,Swain County,13,901,422,479
North Carolina,Swain County,14,905,432,473
North Carolina,Swain County,15,711,339,372
North Carolina,Swain County,16,458,207,251
North Carolina,Swain County,17,310,119,191
North Carolina,Swain County,18,259,84,175
North Carolina,Transylvania County,0,33045,15987,17058
North Carolina,Transylvania County,1,1294,690,604
North Carolina,Transylvania County,2,1516,755,761
North Carolina,Transylvania County,3,1587,819,768
North Carolina,Transylvania County,4,1846,981,865
North Carolina,Transylvania County,5,1930,1083,847
North Carolina,Transylvania County,6,1490,721,769
North Carolina,Transylvania County,7,1469,710,759
North Carolina,Transylvania County,8,1655,809,846
North Carolina,Transylvania County,9,1661,819,842
North Carolina,Transylvania County,10,1838,898,940
North Carolina,Transylvania County,11,2302,1064,1238
North Carolina,Transylvania County,12,2473,1165,1308
North Carolina,Transylvania County,13,2574,1210,1364
North Carolina,Transylvania County,14,2754,1296,1458
North Carolina,Transylvania County,15,2419,1062,1357
North Carolina,Transylvania County,16,1823,882,941
North Carolina,Transylvania County,17,1203,548,655
North Carolina,Transylvania County,18,1211,475,736
North Carolina,Tyrrell County,0,4115,2208,1907
North Carolina,Tyrrell County,1,221,93,128
North Carolina,Tyrrell County,2,209,101,108
North Carolina,Tyrrell County,3,204,114,90
North Carolina,Tyrrell County,4,174,90,84
North Carolina,Tyrrell County,5,271,167,104
North Carolina,Tyrrell County,6,284,200,84
North Carolina,Tyrrell County,7,299,198,101
North Carolina,Tyrrell County,8,248,167,81
North Carolina,Tyrrell County,9,254,139,115
North Carolina,Tyrrell County,10,263,144,119
North Carolina,Tyrrell County,11,320,168,152
North Carolina,Tyrrell County,12,313,150,163
North Carolina,Tyrrell County,13,258,138,120
North Carolina,Tyrrell County,14,248,116,132
North Carolina,Tyrrell County,15,201,91,110
North Carolina,Tyrrell County,16,170,60,110
North Carolina,Tyrrell County,17,97,48,49
North Carolina,Tyrrell County,18,81,24,57
North Carolina,Union County,0,218568,107920,110648
North Carolina,Union County,1,13169,6810,6359
North Carolina,Union County,2,17536,8964,8572
North Carolina,Union County,3,20315,10457,9858
North Carolina,Union County,4,17890,9106,8784
North Carolina,Union County,5,12517,6501,6016
North Carolina,Union County,6,9715,4905,4810
North Carolina,Union County,7,11621,5463,6158
North Carolina,Union County,8,14228,6753,7475
North Carolina,Union County,9,18355,8901,9454
North Carolina,Union County,10,18411,9175,9236
North Carolina,Union County,11,16472,8350,8122
North Carolina,Union County,12,13190,6567,6623
North Carolina,Union County,13,10414,5028,5386
North Carolina,Union County,14,9145,4216,4929
North Carolina,Union County,15,6681,3129,3552
North Carolina,Union County,16,4208,1876,2332
North Carolina,Union County,17,2478,1011,1467
North Carolina,Union County,18,2223,708,1515
North Carolina,Vance County,0,44614,20860,23754
North Carolina,Vance County,1,2967,1475,1492
North Carolina,Vance County,2,3012,1525,1487
North Carolina,Vance County,3,2988,1499,1489
North Carolina,Vance County,4,2884,1478,1406
North Carolina,Vance County,5,3154,1571,1583
North Carolina,Vance County,6,2476,1171,1305
North Carolina,Vance County,7,2411,1078,1333
North Carolina,Vance County,8,2398,1115,1283
North Carolina,Vance County,9,2829,1340,1489
North Carolina,Vance County,10,2909,1355,1554
North Carolina,Vance County,11,3055,1368,1687
North Carolina,Vance County,12,3216,1471,1745
North Carolina,Vance County,13,2992,1370,1622
North Carolina,Vance County,14,2513,1158,1355
North Carolina,Vance County,15,1803,821,982
North Carolina,Vance County,16,1261,531,730
North Carolina,Vance County,17,859,306,553
North Carolina,Vance County,18,887,228,659
North Carolina,Wake County,0,998691,485991,512700
North Carolina,Wake County,1,65003,33238,31765
North Carolina,Wake County,2,71496,36150,35346
North Carolina,Wake County,3,72267,36544,35723
North Carolina,Wake County,4,69293,35253,34040
North Carolina,Wake County,5,65949,33552,32397
North Carolina,Wake County,6,72952,35846,37106
North Carolina,Wake County,7,74205,35658,38547
North Carolina,Wake County,8,75946,36518,39428
North Carolina,Wake County,9,79470,38909,40561
North Carolina,Wake County,10,73720,35996,37724
North Carolina,Wake County,11,71116,34644,36472
North Carolina,Wake County,12,59898,28764,31134
North Carolina,Wake County,13,47423,21895,25528
North Carolina,Wake County,14,37376,17206,20170
North Carolina,Wake County,15,24032,10988,13044
North Carolina,Wake County,16,15866,6779,9087
North Carolina,Wake County,17,10930,4356,6574
North Carolina,Wake County,18,11749,3695,8054
North Carolina,Warren County,0,20231,10215,10016
North Carolina,Warren County,1,943,507,436
North Carolina,Warren County,2,1114,556,558
North Carolina,Warren County,3,1107,561,546
North Carolina,Warren County,4,1061,558,503
North Carolina,Warren County,5,1274,715,559
North Carolina,Warren County,6,1105,634,471
North Carolina,Warren County,7,1064,600,464
North Carolina,Warren County,8,1034,568,466
North Carolina,Warren County,9,1070,549,521
North Carolina,Warren County,10,1215,629,586
North Carolina,Warren County,11,1537,778,759
North Carolina,Warren County,12,1678,828,850
North Carolina,Warren County,13,1672,800,872
North Carolina,Warren County,14,1446,669,777
North Carolina,Warren County,15,1080,522,558
North Carolina,Warren County,16,761,349,412
North Carolina,Warren County,17,540,210,330
North Carolina,Warren County,18,530,182,348
North Carolina,Washington County,0,12570,5903,6667
North Carolina,Washington County,1,698,343,355
North Carolina,Washington County,2,761,382,379
North Carolina,Washington County,3,746,367,379
North Carolina,Washington County,4,751,392,359
North Carolina,Washington County,5,784,416,368
North Carolina,Washington County,6,568,269,299
North Carolina,Washington County,7,563,278,285
North Carolina,Washington County,8,600,272,328
North Carolina,Washington County,9,686,281,405
North Carolina,Washington County,10,786,349,437
North Carolina,Washington County,11,902,414,488
North Carolina,Washington County,12,1026,485,541
North Carolina,Washington County,13,1049,524,525
North Carolina,Washington County,14,856,402,454
North Carolina,Washington County,15,641,277,364
North Carolina,Washington County,16,489,222,267
North Carolina,Washington County,17,337,122,215
North Carolina,Washington County,18,327,108,219
North Carolina,Watauga County,0,52560,26273,26287
North Carolina,Watauga County,1,1769,911,858
North Carolina,Watauga County,2,2029,1058,971
North Carolina,Watauga County,3,1966,996,970
North Carolina,Watauga County,4,5958,2798,3160
North Carolina,Watauga County,5,10924,5798,5126
North Carolina,Watauga County,6,3277,1787,1490
North Carolina,Watauga County,7,2482,1299,1183
North Carolina,Watauga County,8,2327,1192,1135
North Carolina,Watauga County,9,2519,1268,1251
North Carolina,Watauga County,10,2579,1278,1301
North Carolina,Watauga County,11,3042,1456,1586
North Carolina,Watauga County,12,3113,1504,1609
North Carolina,Watauga County,13,3124,1485,1639
North Carolina,Watauga County,14,2627,1302,1325
North Carolina,Watauga County,15,1879,895,984
North Carolina,Watauga County,16,1265,615,650
North Carolina,Watauga County,17,841,352,489
North Carolina,Watauga County,18,839,279,560
North Carolina,Wayne County,0,124456,61224,63232
North Carolina,Wayne County,1,8519,4324,4195
North Carolina,Wayne County,2,8533,4361,4172
North Carolina,Wayne County,3,8159,4219,3940
North Carolina,Wayne County,4,7885,4092,3793
North Carolina,Wayne County,5,9873,5424,4449
North Carolina,Wayne County,6,8771,4558,4213
North Carolina,Wayne County,7,7718,3821,3897
North Carolina,Wayne County,8,7245,3612,3633
North Carolina,Wayne County,9,7568,3665,3903
North Carolina,Wayne County,10,7755,3848,3907
North Carolina,Wayne County,11,8603,4183,4420
North Carolina,Wayne County,12,8524,4048,4476
North Carolina,Wayne County,13,7263,3437,3826
North Carolina,Wayne County,14,5899,2721,3178
North Carolina,Wayne County,15,4384,1920,2464
North Carolina,Wayne County,16,3451,1451,2000
North Carolina,Wayne County,17,2307,908,1399
North Carolina,Wayne County,18,1999,632,1367
North Carolina,Wilkes County,0,68838,33947,34891
North Carolina,Wilkes County,1,3349,1730,1619
North Carolina,Wilkes County,2,4084,2068,2016
North Carolina,Wilkes County,3,4427,2264,2163
North Carolina,Wilkes County,4,4127,2145,1982
North Carolina,Wilkes County,5,3846,2049,1797
North Carolina,Wilkes County,6,3480,1718,1762
North Carolina,Wilkes County,7,3496,1747,1749
North Carolina,Wilkes County,8,3820,1968,1852
North Carolina,Wilkes County,9,4570,2303,2267
North Carolina,Wilkes County,10,4682,2400,2282
North Carolina,Wilkes County,11,5286,2594,2692
North Carolina,Wilkes County,12,5201,2617,2584
North Carolina,Wilkes County,13,4794,2300,2494
North Carolina,Wilkes County,14,4470,2111,2359
North Carolina,Wilkes County,15,3440,1621,1819
North Carolina,Wilkes County,16,2585,1118,1467
North Carolina,Wilkes County,17,1647,661,986
North Carolina,Wilkes County,18,1534,533,1001
North Carolina,Wilson County,0,81401,38624,42777
North Carolina,Wilson County,1,5032,2590,2442
North Carolina,Wilson County,2,5428,2802,2626
North Carolina,Wilson County,3,5474,2754,2720
North Carolina,Wilson County,4,5297,2651,2646
North Carolina,Wilson County,5,5279,2655,2624
North Carolina,Wilson County,6,4732,2280,2452
North Carolina,Wilson County,7,4751,2303,2448
North Carolina,Wilson County,8,4731,2160,2571
North Carolina,Wilson County,9,5137,2434,2703
North Carolina,Wilson County,10,5310,2484,2826
North Carolina,Wilson County,11,5774,2756,3018
North Carolina,Wilson County,12,5750,2684,3066
North Carolina,Wilson County,13,5397,2521,2876
North Carolina,Wilson County,14,4463,2025,2438
North Carolina,Wilson County,15,3228,1459,1769
North Carolina,Wilson County,16,2364,1012,1352
North Carolina,Wilson County,17,1603,555,1048
North Carolina,Wilson County,18,1651,499,1152
North Carolina,Yadkin County,0,37792,18728,19064
North Carolina,Yadkin County,1,2022,1028,994
North Carolina,Yadkin County,2,2270,1181,1089
North Carolina,Yadkin County,3,2393,1246,1147
North Carolina,Yadkin County,4,2428,1276,1152
North Carolina,Yadkin County,5,2242,1220,1022
North Carolina,Yadkin County,6,1940,963,977
North Carolina,Yadkin County,7,1889,924,965
North Carolina,Yadkin County,8,2031,1018,1013
North Carolina,Yadkin County,9,2608,1324,1284
North Carolina,Yadkin County,10,2867,1424,1443
North Carolina,Yadkin County,11,3000,1504,1496
North Carolina,Yadkin County,12,2716,1348,1368
North Carolina,Yadkin County,13,2458,1201,1257
North Carolina,Yadkin County,14,2222,1063,1159
North Carolina,Yadkin County,15,1793,828,965
North Carolina,Yadkin County,16,1262,579,683
North Carolina,Yadkin County,17,886,357,529
North Carolina,Yadkin County,18,765,244,521
North Carolina,Yancey County,0,17614,8672,8942
North Carolina,Yancey County,1,860,444,416
North Carolina,Yancey County,2,883,468,415
North Carolina,Yancey County,3,1032,550,482
North Carolina,Yancey County,4,974,485,489
North Carolina,Yancey County,5,943,505,438
North Carolina,Yancey County,6,819,450,369
North Carolina,Yancey County,7,816,398,418
North Carolina,Yancey County,8,964,485,479
North Carolina,Yancey County,9,1121,567,554
North Carolina,Yancey County,10,1199,623,576
North Carolina,Yancey County,11,1224,575,649
North Carolina,Yancey County,12,1264,612,652
North Carolina,Yancey County,13,1378,661,717
North Carolina,Yancey County,14,1348,619,729
North Carolina,Yancey County,15,1053,523,530
North Carolina,Yancey County,16,774,339,435
North Carolina,Yancey County,17,523,222,301
North Carolina,Yancey County,18,439,146,293
North Dakota,Adams County,0,2384,1160,1224
North Dakota,Adams County,1,131,55,76
North Dakota,Adams County,2,129,63,66
North Dakota,Adams County,3,123,62,61
North Dakota,Adams County,4,119,66,53
North Dakota,Adams County,5,111,58,53
North Dakota,Adams County,6,119,67,52
North Dakota,Adams County,7,108,52,56
North Dakota,Adams County,8,112,58,54
North Dakota,Adams County,9,106,47,59
North Dakota,Adams County,10,138,73,65
North Dakota,Adams County,11,182,85,97
North Dakota,Adams County,12,217,110,107
North Dakota,Adams County,13,188,95,93
North Dakota,Adams County,14,161,81,80
North Dakota,Adams County,15,116,59,57
North Dakota,Adams County,16,98,53,45
North Dakota,Adams County,17,95,41,54
North Dakota,Adams County,18,131,35,96
North Dakota,Barnes County,0,11144,5571,5573
North Dakota,Barnes County,1,607,306,301
North Dakota,Barnes County,2,620,304,316
North Dakota,Barnes County,3,621,299,322
North Dakota,Barnes County,4,808,419,389
North Dakota,Barnes County,5,776,435,341
North Dakota,Barnes County,6,619,321,298
North Dakota,Barnes County,7,637,334,303
North Dakota,Barnes County,8,555,298,257
North Dakota,Barnes County,9,540,270,270
North Dakota,Barnes County,10,636,321,315
North Dakota,Barnes County,11,814,415,399
North Dakota,Barnes County,12,842,434,408
North Dakota,Barnes County,13,823,427,396
North Dakota,Barnes County,14,630,321,309
North Dakota,Barnes County,15,481,229,252
North Dakota,Barnes County,16,414,189,225
North Dakota,Barnes County,17,297,122,175
North Dakota,Barnes County,18,424,127,297
North Dakota,Benson County,0,6833,3516,3317
North Dakota,Benson County,1,694,393,301
North Dakota,Benson County,2,713,355,358
North Dakota,Benson County,3,593,315,278
North Dakota,Benson County,4,521,257,264
North Dakota,Benson County,5,447,230,217
North Dakota,Benson County,6,394,204,190
North Dakota,Benson County,7,399,208,191
North Dakota,Benson County,8,301,156,145
North Dakota,Benson County,9,316,158,158
North Dakota,Benson County,10,381,186,195
North Dakota,Benson County,11,423,217,206
North Dakota,Benson County,12,455,234,221
North Dakota,Benson County,13,364,180,184
North Dakota,Benson County,14,275,129,146
North Dakota,Benson County,15,197,107,90
North Dakota,Benson County,16,159,83,76
North Dakota,Benson County,17,112,57,55
North Dakota,Benson County,18,89,47,42
North Dakota,Billings County,0,901,499,402
North Dakota,Billings County,1,52,35,17
North Dakota,Billings County,2,54,26,28
North Dakota,Billings County,3,42,16,26
North Dakota,Billings County,4,35,21,14
North Dakota,Billings County,5,58,38,20
North Dakota,Billings County,6,53,35,18
North Dakota,Billings County,7,75,41,34
North Dakota,Billings County,8,57,38,19
North Dakota,Billings County,9,47,28,19
North Dakota,Billings County,10,54,24,30
North Dakota,Billings County,11,67,32,35
North Dakota,Billings County,12,79,41,38
North Dakota,Billings County,13,68,40,28
North Dakota,Billings County,14,48,26,22
North Dakota,Billings County,15,37,20,17
North Dakota,Billings County,16,26,17,9
North Dakota,Billings County,17,24,10,14
North Dakota,Billings County,18,25,11,14
North Dakota,Bottineau County,0,6650,3469,3181
North Dakota,Bottineau County,1,422,234,188
North Dakota,Bottineau County,2,431,226,205
North Dakota,Bottineau County,3,355,189,166
North Dakota,Bottineau County,4,384,206,178
North Dakota,Bottineau County,5,408,253,155
North Dakota,Bottineau County,6,339,190,149
North Dakota,Bottineau County,7,335,175,160
North Dakota,Bottineau County,8,326,171,155
North Dakota,Bottineau County,9,328,163,165
North Dakota,Bottineau County,10,364,190,174
North Dakota,Bottineau County,11,501,259,242
North Dakota,Bottineau County,12,514,281,233
North Dakota,Bottineau County,13,528,261,267
North Dakota,Bottineau County,14,466,240,226
North Dakota,Bottineau County,15,332,164,168
North Dakota,Bottineau County,16,234,110,124
North Dakota,Bottineau County,17,190,75,115
North Dakota,Bottineau County,18,193,82,111
North Dakota,Bowman County,0,3247,1679,1568
North Dakota,Bowman County,1,210,116,94
North Dakota,Bowman County,2,234,127,107
North Dakota,Bowman County,3,208,117,91
North Dakota,Bowman County,4,200,100,100
North Dakota,Bowman County,5,182,96,86
North Dakota,Bowman County,6,172,99,73
North Dakota,Bowman County,7,200,103,97
North Dakota,Bowman County,8,162,88,74
North Dakota,Bowman County,9,164,92,72
North Dakota,Bowman County,10,156,91,65
North Dakota,Bowman County,11,207,97,110
North Dakota,Bowman County,12,286,142,144
North Dakota,Bowman County,13,233,121,112
North Dakota,Bowman County,14,174,80,94
North Dakota,Bowman County,15,150,79,71
North Dakota,Bowman County,16,116,55,61
North Dakota,Bowman County,17,97,43,54
North Dakota,Bowman County,18,96,33,63
North Dakota,Burke County,0,2245,1196,1049
North Dakota,Burke County,1,180,101,79
North Dakota,Burke County,2,149,86,63
North Dakota,Burke County,3,125,67,58
North Dakota,Burke County,4,112,67,45
North Dakota,Burke County,5,119,65,54
North Dakota,Burke County,6,137,64,73
North Dakota,Burke County,7,164,92,72
North Dakota,Burke County,8,101,56,45
North Dakota,Burke County,9,106,56,50
North Dakota,Burke County,10,129,73,56
North Dakota,Burke County,11,181,109,72
North Dakota,Burke County,12,176,88,88
North Dakota,Burke County,13,162,88,74
North Dakota,Burke County,14,134,68,66
North Dakota,Burke County,15,88,42,46
North Dakota,Burke County,16,69,32,37
North Dakota,Burke County,17,60,26,34
North Dakota,Burke County,18,53,16,37
North Dakota,Burleigh County,0,90503,45060,45443
North Dakota,Burleigh County,1,6014,3044,2970
North Dakota,Burleigh County,2,5982,3063,2919
North Dakota,Burleigh County,3,5369,2794,2575
North Dakota,Burleigh County,4,5740,2864,2876
North Dakota,Burleigh County,5,6596,3345,3251
North Dakota,Burleigh County,6,6616,3520,3096
North Dakota,Burleigh County,7,6800,3550,3250
North Dakota,Burleigh County,8,5726,2977,2749
North Dakota,Burleigh County,9,5275,2739,2536
North Dakota,Burleigh County,10,5293,2725,2568
North Dakota,Burleigh County,11,6244,3043,3201
North Dakota,Burleigh County,12,6337,3033,3304
North Dakota,Burleigh County,13,5417,2646,2771
North Dakota,Burleigh County,14,4062,1981,2081
North Dakota,Burleigh County,15,2896,1396,1500
North Dakota,Burleigh County,16,2210,918,1292
North Dakota,Burleigh County,17,1850,744,1106
North Dakota,Burleigh County,18,2076,678,1398
North Dakota,Cass County,0,167005,84599,82406
North Dakota,Cass County,1,11572,5875,5697
North Dakota,Cass County,2,10734,5576,5158
North Dakota,Cass County,3,9222,4689,4533
North Dakota,Cass County,4,11391,5861,5530
North Dakota,Cass County,5,20596,10645,9951
North Dakota,Cass County,6,14776,7861,6915
North Dakota,Cass County,7,13514,7080,6434
North Dakota,Cass County,8,10961,5851,5110
North Dakota,Cass County,9,9423,4887,4536
North Dakota,Cass County,10,9120,4656,4464
North Dakota,Cass County,11,9722,4888,4834
North Dakota,Cass County,12,9505,4653,4852
North Dakota,Cass County,13,8421,4172,4249
North Dakota,Cass County,14,5938,2962,2976
North Dakota,Cass County,15,3700,1756,1944
North Dakota,Cass County,16,2977,1278,1699
North Dakota,Cass County,17,2326,931,1395
North Dakota,Cass County,18,3107,978,2129
North Dakota,Cavalier County,0,3855,1954,1901
North Dakota,Cavalier County,1,202,104,98
North Dakota,Cavalier County,2,209,107,102
North Dakota,Cavalier County,3,207,106,101
North Dakota,Cavalier County,4,222,110,112
North Dakota,Cavalier County,5,189,99,90
North Dakota,Cavalier County,6,172,102,70
North Dakota,Cavalier County,7,150,81,69
North Dakota,Cavalier County,8,159,81,78
North Dakota,Cavalier County,9,168,89,79
North Dakota,Cavalier County,10,219,103,116
North Dakota,Cavalier County,11,298,158,140
North Dakota,Cavalier County,12,329,180,149
North Dakota,Cavalier County,13,304,160,144
North Dakota,Cavalier County,14,267,149,118
North Dakota,Cavalier County,15,223,106,117
North Dakota,Cavalier County,16,199,85,114
North Dakota,Cavalier County,17,157,74,83
North Dakota,Cavalier County,18,181,60,121
North Dakota,Dickey County,0,5150,2559,2591
North Dakota,Dickey County,1,298,150,148
North Dakota,Dickey County,2,362,195,167
North Dakota,Dickey County,3,318,158,160
North Dakota,Dickey County,4,361,183,178
North Dakota,Dickey County,5,336,174,162
North Dakota,Dickey County,6,241,125,116
North Dakota,Dickey County,7,282,155,127
North Dakota,Dickey County,8,252,128,124
North Dakota,Dickey County,9,267,134,133
North Dakota,Dickey County,10,284,154,130
North Dakota,Dickey County,11,330,161,169
North Dakota,Dickey County,12,375,191,184
North Dakota,Dickey County,13,318,165,153
North Dakota,Dickey County,14,292,152,140
North Dakota,Dickey County,15,251,115,136
North Dakota,Dickey County,16,186,81,105
North Dakota,Dickey County,17,157,53,104
North Dakota,Dickey County,18,240,85,155
North Dakota,Divide County,0,2432,1257,1175
North Dakota,Divide County,1,141,79,62
North Dakota,Divide County,2,160,79,81
North Dakota,Divide County,3,135,61,74
North Dakota,Divide County,4,112,53,59
North Dakota,Divide County,5,147,81,66
North Dakota,Divide County,6,140,81,59
North Dakota,Divide County,7,133,71,62
North Dakota,Divide County,8,118,62,56
North Dakota,Divide County,9,95,53,42
North Dakota,Divide County,10,126,60,66
North Dakota,Divide County,11,190,101,89
North Dakota,Divide County,12,206,111,95
North Dakota,Divide County,13,167,96,71
North Dakota,Divide County,14,166,91,75
North Dakota,Divide County,15,104,53,51
North Dakota,Divide County,16,88,47,41
North Dakota,Divide County,17,79,37,42
North Dakota,Divide County,18,125,41,84
North Dakota,Dunn County,0,4399,2354,2045
North Dakota,Dunn County,1,295,127,168
North Dakota,Dunn County,2,301,158,143
North Dakota,Dunn County,3,250,113,137
North Dakota,Dunn County,4,240,123,117
North Dakota,Dunn County,5,288,167,121
North Dakota,Dunn County,6,374,237,137
North Dakota,Dunn County,7,286,159,127
North Dakota,Dunn County,8,256,152,104
North Dakota,Dunn County,9,205,113,92
North Dakota,Dunn County,10,257,134,123
North Dakota,Dunn County,11,358,193,165
North Dakota,Dunn County,12,363,208,155
North Dakota,Dunn County,13,299,170,129
North Dakota,Dunn County,14,190,97,93
North Dakota,Dunn County,15,126,61,65
North Dakota,Dunn County,16,132,67,65
North Dakota,Dunn County,17,86,38,48
North Dakota,Dunn County,18,93,37,56
North Dakota,Eddy County,0,2377,1197,1180
North Dakota,Eddy County,1,130,75,55
North Dakota,Eddy County,2,147,84,63
North Dakota,Eddy County,3,163,88,75
North Dakota,Eddy County,4,136,61,75
North Dakota,Eddy County,5,103,57,46
North Dakota,Eddy County,6,108,61,47
North Dakota,Eddy County,7,120,61,59
North Dakota,Eddy County,8,106,54,52
North Dakota,Eddy County,9,102,50,52
North Dakota,Eddy County,10,129,61,68
North Dakota,Eddy County,11,181,97,84
North Dakota,Eddy County,12,193,94,99
North Dakota,Eddy County,13,194,109,85
North Dakota,Eddy County,14,160,85,75
North Dakota,Eddy County,15,115,56,59
North Dakota,Eddy County,16,84,36,48
North Dakota,Eddy County,17,89,33,56
North Dakota,Eddy County,18,117,35,82
North Dakota,Emmons County,0,3422,1756,1666
North Dakota,Emmons County,1,151,79,72
North Dakota,Emmons County,2,193,100,93
North Dakota,Emmons County,3,199,103,96
North Dakota,Emmons County,4,232,119,113
North Dakota,Emmons County,5,162,85,77
North Dakota,Emmons County,6,109,63,46
North Dakota,Emmons County,7,97,51,46
North Dakota,Emmons County,8,138,74,64
North Dakota,Emmons County,9,169,82,87
North Dakota,Emmons County,10,195,90,105
North Dakota,Emmons County,11,287,161,126
North Dakota,Emmons County,12,273,149,124
North Dakota,Emmons County,13,271,150,121
North Dakota,Emmons County,14,235,111,124
North Dakota,Emmons County,15,200,93,107
North Dakota,Emmons County,16,187,97,90
North Dakota,Emmons County,17,158,74,84
North Dakota,Emmons County,18,166,75,91
North Dakota,Foster County,0,3362,1676,1686
North Dakota,Foster County,1,179,89,90
North Dakota,Foster County,2,205,110,95
North Dakota,Foster County,3,201,90,111
North Dakota,Foster County,4,204,100,104
North Dakota,Foster County,5,173,96,77
North Dakota,Foster County,6,160,99,61
North Dakota,Foster County,7,186,98,88
North Dakota,Foster County,8,157,82,75
North Dakota,Foster County,9,185,90,95
North Dakota,Foster County,10,188,84,104
North Dakota,Foster County,11,277,149,128
North Dakota,Foster County,12,288,160,128
North Dakota,Foster County,13,218,110,108
North Dakota,Foster County,14,189,89,100
North Dakota,Foster County,15,116,56,60
North Dakota,Foster County,16,146,56,90
North Dakota,Foster County,17,136,66,70
North Dakota,Foster County,18,154,52,102
North Dakota,Golden Valley County,0,1825,922,903
North Dakota,Golden Valley County,1,108,58,50
North Dakota,Golden Valley County,2,102,52,50
North Dakota,Golden Valley County,3,125,59,66
North Dakota,Golden Valley County,4,137,72,65
North Dakota,Golden Valley County,5,93,48,45
North Dakota,Golden Valley County,6,83,48,35
North Dakota,Golden Valley County,7,109,54,55
North Dakota,Golden Valley County,8,120,62,58
North Dakota,Golden Valley County,9,85,40,45
North Dakota,Golden Valley County,10,102,52,50
North Dakota,Golden Valley County,11,126,63,63
North Dakota,Golden Valley County,12,145,74,71
North Dakota,Golden Valley County,13,152,84,68
North Dakota,Golden Valley County,14,96,48,48
North Dakota,Golden Valley County,15,71,36,35
North Dakota,Golden Valley County,16,49,23,26
North Dakota,Golden Valley County,17,40,15,25
North Dakota,Golden Valley County,18,82,34,48
North Dakota,Grand Forks County,0,70138,36156,33982
North Dakota,Grand Forks County,1,4674,2393,2281
North Dakota,Grand Forks County,2,4120,2198,1922
North Dakota,Grand Forks County,3,3380,1708,1672
North Dakota,Grand Forks County,4,5809,2999,2810
North Dakota,Grand Forks County,5,12280,6627,5653
North Dakota,Grand Forks County,6,5897,3426,2471
North Dakota,Grand Forks County,7,4653,2480,2173
North Dakota,Grand Forks County,8,3630,1942,1688
North Dakota,Grand Forks County,9,3188,1644,1544
North Dakota,Grand Forks County,10,3167,1605,1562
North Dakota,Grand Forks County,11,3982,1975,2007
North Dakota,Grand Forks County,12,3982,1948,2034
North Dakota,Grand Forks County,13,3506,1782,1724
North Dakota,Grand Forks County,14,2551,1258,1293
North Dakota,Grand Forks County,15,1802,847,955
North Dakota,Grand Forks County,16,1246,519,727
North Dakota,Grand Forks County,17,1041,416,625
North Dakota,Grand Forks County,18,1230,389,841
North Dakota,Grant County,0,2361,1202,1159
North Dakota,Grant County,1,136,71,65
North Dakota,Grant County,2,119,49,70
North Dakota,Grant County,3,107,53,54
North Dakota,Grant County,4,121,58,63
North Dakota,Grant County,5,103,60,43
North Dakota,Grant County,6,87,48,39
North Dakota,Grant County,7,92,48,44
North Dakota,Grant County,8,96,52,44
North Dakota,Grant County,9,111,58,53
North Dakota,Grant County,10,125,64,61
North Dakota,Grant County,11,191,100,91
North Dakota,Grant County,12,201,105,96
North Dakota,Grant County,13,218,119,99
North Dakota,Grant County,14,194,96,98
North Dakota,Grant County,15,143,70,73
North Dakota,Grant County,16,133,71,62
North Dakota,Grant County,17,90,42,48
North Dakota,Grant County,18,94,38,56
North Dakota,Griggs County,0,2319,1183,1136
North Dakota,Griggs County,1,107,49,58
North Dakota,Griggs County,2,116,65,51
North Dakota,Griggs County,3,115,69,46
North Dakota,Griggs County,4,138,77,61
North Dakota,Griggs County,5,92,46,46
North Dakota,Griggs County,6,76,38,38
North Dakota,Griggs County,7,109,54,55
North Dakota,Griggs County,8,89,52,37
North Dakota,Griggs County,9,102,50,52
North Dakota,Griggs County,10,122,64,58
North Dakota,Griggs County,11,169,88,81
North Dakota,Griggs County,12,198,106,92
North Dakota,Griggs County,13,220,120,100
North Dakota,Griggs County,14,194,106,88
North Dakota,Griggs County,15,141,76,65
North Dakota,Griggs County,16,92,44,48
North Dakota,Griggs County,17,93,32,61
North Dakota,Griggs County,18,146,47,99
North Dakota,Hettinger County,0,2660,1291,1369
North Dakota,Hettinger County,1,169,92,77
North Dakota,Hettinger County,2,172,76,96
North Dakota,Hettinger County,3,166,79,87
North Dakota,Hettinger County,4,149,70,79
North Dakota,Hettinger County,5,134,73,61
North Dakota,Hettinger County,6,153,61,92
North Dakota,Hettinger County,7,154,78,76
North Dakota,Hettinger County,8,116,47,69
North Dakota,Hettinger County,9,138,68,70
North Dakota,Hettinger County,10,159,70,89
North Dakota,Hettinger County,11,189,93,96
North Dakota,Hettinger County,12,182,96,86
North Dakota,Hettinger County,13,169,90,79
North Dakota,Hettinger County,14,139,66,73
North Dakota,Hettinger County,15,136,70,66
North Dakota,Hettinger County,16,123,64,59
North Dakota,Hettinger County,17,115,53,62
North Dakota,Hettinger County,18,97,45,52
North Dakota,Kidder County,0,2424,1244,1180
North Dakota,Kidder County,1,128,61,67
North Dakota,Kidder County,2,144,64,80
North Dakota,Kidder County,3,145,77,68
North Dakota,Kidder County,4,148,80,68
North Dakota,Kidder County,5,114,57,57
North Dakota,Kidder County,6,117,66,51
North Dakota,Kidder County,7,133,70,63
North Dakota,Kidder County,8,107,51,56
North Dakota,Kidder County,9,125,67,58
North Dakota,Kidder County,10,140,72,68
North Dakota,Kidder County,11,180,88,92
North Dakota,Kidder County,12,232,123,109
North Dakota,Kidder County,13,203,111,92
North Dakota,Kidder County,14,129,75,54
North Dakota,Kidder County,15,114,62,52
North Dakota,Kidder County,16,99,47,52
North Dakota,Kidder County,17,84,45,39
North Dakota,Kidder County,18,82,28,54
North Dakota,LaMoure County,0,4149,2128,2021
North Dakota,LaMoure County,1,218,114,104
North Dakota,LaMoure County,2,256,134,122
North Dakota,LaMoure County,3,251,145,106
North Dakota,LaMoure County,4,224,123,101
North Dakota,LaMoure County,5,188,100,88
North Dakota,LaMoure County,6,167,97,70
North Dakota,LaMoure County,7,184,90,94
North Dakota,LaMoure County,8,185,103,82
North Dakota,LaMoure County,9,208,101,107
North Dakota,LaMoure County,10,211,115,96
North Dakota,LaMoure County,11,316,172,144
North Dakota,LaMoure County,12,358,174,184
North Dakota,LaMoure County,13,326,187,139
North Dakota,LaMoure County,14,259,141,118
North Dakota,LaMoure County,15,203,94,109
North Dakota,LaMoure County,16,200,84,116
North Dakota,LaMoure County,17,185,77,108
North Dakota,LaMoure County,18,210,77,133
North Dakota,Logan County,0,1944,988,956
North Dakota,Logan County,1,105,55,50
North Dakota,Logan County,2,112,59,53
North Dakota,Logan County,3,113,47,66
North Dakota,Logan County,4,130,62,68
North Dakota,Logan County,5,85,42,43
North Dakota,Logan County,6,87,45,42
North Dakota,Logan County,7,72,45,27
North Dakota,Logan County,8,79,42,37
North Dakota,Logan County,9,107,56,51
North Dakota,Logan County,10,103,57,46
North Dakota,Logan County,11,152,79,73
North Dakota,Logan County,12,150,88,62
North Dakota,Logan County,13,125,61,64
North Dakota,Logan County,14,116,59,57
North Dakota,Logan County,15,113,59,54
North Dakota,Logan County,16,114,51,63
North Dakota,Logan County,17,93,44,49
North Dakota,Logan County,18,88,37,51
North Dakota,McHenry County,0,5988,3143,2845
North Dakota,McHenry County,1,375,215,160
North Dakota,McHenry County,2,421,206,215
North Dakota,McHenry County,3,374,214,160
North Dakota,McHenry County,4,339,189,150
North Dakota,McHenry County,5,335,188,147
North Dakota,McHenry County,6,279,161,118
North Dakota,McHenry County,7,400,198,202
North Dakota,McHenry County,8,351,193,158
North Dakota,McHenry County,9,329,165,164
North Dakota,McHenry County,10,374,209,165
North Dakota,McHenry County,11,441,229,212
North Dakota,McHenry County,12,450,240,210
North Dakota,McHenry County,13,381,193,188
North Dakota,McHenry County,14,342,192,150
North Dakota,McHenry County,15,240,128,112
North Dakota,McHenry County,16,194,98,96
North Dakota,McHenry County,17,176,68,108
North Dakota,McHenry County,18,187,57,130
North Dakota,McIntosh County,0,2801,1367,1434
North Dakota,McIntosh County,1,155,85,70
North Dakota,McIntosh County,2,161,87,74
North Dakota,McIntosh County,3,130,64,66
North Dakota,McIntosh County,4,153,83,70
North Dakota,McIntosh County,5,105,58,47
North Dakota,McIntosh County,6,106,49,57
North Dakota,McIntosh County,7,139,72,67
North Dakota,McIntosh County,8,97,49,48
North Dakota,McIntosh County,9,114,67,47
North Dakota,McIntosh County,10,145,70,75
North Dakota,McIntosh County,11,218,111,107
North Dakota,McIntosh County,12,221,121,100
North Dakota,McIntosh County,13,181,101,80
North Dakota,McIntosh County,14,147,64,83
North Dakota,McIntosh County,15,168,71,97
North Dakota,McIntosh County,16,188,83,105
North Dakota,McIntosh County,17,156,61,95
North Dakota,McIntosh County,18,217,71,146
North Dakota,McKenzie County,0,10996,5877,5119
North Dakota,McKenzie County,1,881,449,432
North Dakota,McKenzie County,2,958,492,466
North Dakota,McKenzie County,3,867,431,436
North Dakota,McKenzie County,4,775,396,379
North Dakota,McKenzie County,5,811,455,356
North Dakota,McKenzie County,6,922,529,393
North Dakota,McKenzie County,7,839,476,363
North Dakota,McKenzie County,8,708,383,325
North Dakota,McKenzie County,9,634,368,266
North Dakota,McKenzie County,10,623,344,279
North Dakota,McKenzie County,11,789,416,373
North Dakota,McKenzie County,12,715,399,316
North Dakota,McKenzie County,13,559,312,247
North Dakota,McKenzie County,14,320,160,160
North Dakota,McKenzie County,15,216,99,117
North Dakota,McKenzie County,16,150,76,74
North Dakota,McKenzie County,17,115,56,59
North Dakota,McKenzie County,18,114,36,78
North Dakota,McLean County,0,9578,4892,4686
North Dakota,McLean County,1,561,268,293
North Dakota,McLean County,2,592,296,296
North Dakota,McLean County,3,573,289,284
North Dakota,McLean County,4,558,288,270
North Dakota,McLean County,5,410,219,191
North Dakota,McLean County,6,454,234,220
North Dakota,McLean County,7,520,280,240
North Dakota,McLean County,8,500,263,237
North Dakota,McLean County,9,520,269,251
North Dakota,McLean County,10,503,285,218
North Dakota,McLean County,11,691,357,334
North Dakota,McLean County,12,866,424,442
North Dakota,McLean County,13,770,404,366
North Dakota,McLean County,14,696,351,345
North Dakota,McLean County,15,516,272,244
North Dakota,McLean County,16,335,169,166
North Dakota,McLean County,17,233,108,125
North Dakota,McLean County,18,280,116,164
North Dakota,Mercer County,0,8746,4543,4203
North Dakota,Mercer County,1,559,277,282
North Dakota,Mercer County,2,558,287,271
North Dakota,Mercer County,3,515,289,226
North Dakota,Mercer County,4,511,286,225
North Dakota,Mercer County,5,409,226,183
North Dakota,Mercer County,6,468,257,211
North Dakota,Mercer County,7,524,281,243
North Dakota,Mercer County,8,473,257,216
North Dakota,Mercer County,9,404,220,184
North Dakota,Mercer County,10,528,250,278
North Dakota,Mercer County,11,798,412,386
North Dakota,Mercer County,12,857,461,396
North Dakota,Mercer County,13,652,367,285
North Dakota,Mercer County,14,471,234,237
North Dakota,Mercer County,15,350,173,177
North Dakota,Mercer County,16,249,113,136
North Dakota,Mercer County,17,203,86,117
North Dakota,Mercer County,18,217,67,150
North Dakota,Morton County,0,29822,15087,14735
North Dakota,Morton County,1,2035,1058,977
North Dakota,Morton County,2,1978,1028,950
North Dakota,Morton County,3,1782,906,876
North Dakota,Morton County,4,1767,908,859
North Dakota,Morton County,5,1863,997,866
North Dakota,Morton County,6,2230,1172,1058
North Dakota,Morton County,7,2268,1188,1080
North Dakota,Morton County,8,1815,936,879
North Dakota,Morton County,9,1732,862,870
North Dakota,Morton County,10,1783,914,869
North Dakota,Morton County,11,2146,1077,1069
North Dakota,Morton County,12,2178,1117,1061
North Dakota,Morton County,13,1798,916,882
North Dakota,Morton County,14,1426,712,714
North Dakota,Morton County,15,1006,494,512
North Dakota,Morton County,16,743,340,403
North Dakota,Morton County,17,606,235,371
North Dakota,Morton County,18,666,227,439
North Dakota,Mountrail County,0,9782,5400,4382
North Dakota,Mountrail County,1,809,434,375
North Dakota,Mountrail County,2,635,314,321
North Dakota,Mountrail County,3,626,332,294
North Dakota,Mountrail County,4,601,321,280
North Dakota,Mountrail County,5,812,505,307
North Dakota,Mountrail County,6,840,513,327
North Dakota,Mountrail County,7,677,393,284
North Dakota,Mountrail County,8,640,391,249
North Dakota,Mountrail County,9,554,298,256
North Dakota,Mountrail County,10,592,316,276
North Dakota,Mountrail County,11,677,379,298
North Dakota,Mountrail County,12,694,394,300
North Dakota,Mountrail County,13,565,291,274
North Dakota,Mountrail County,14,367,198,169
North Dakota,Mountrail County,15,256,131,125
North Dakota,Mountrail County,16,159,79,80
North Dakota,Mountrail County,17,135,56,79
North Dakota,Mountrail County,18,143,55,88
North Dakota,Nelson County,0,3045,1547,1498
North Dakota,Nelson County,1,148,80,68
North Dakota,Nelson County,2,150,80,70
North Dakota,Nelson County,3,167,80,87
North Dakota,Nelson County,4,169,92,77
North Dakota,Nelson County,5,116,66,50
North Dakota,Nelson County,6,142,86,56
North Dakota,Nelson County,7,138,75,63
North Dakota,Nelson County,8,131,69,62
North Dakota,Nelson County,9,122,61,61
North Dakota,Nelson County,10,155,78,77
North Dakota,Nelson County,11,245,115,130
North Dakota,Nelson County,12,268,147,121
North Dakota,Nelson County,13,244,128,116
North Dakota,Nelson County,14,235,128,107
North Dakota,Nelson County,15,187,97,90
North Dakota,Nelson County,16,164,70,94
North Dakota,Nelson County,17,118,52,66
North Dakota,Nelson County,18,146,43,103
North Dakota,Oliver County,0,1850,946,904
North Dakota,Oliver County,1,120,47,73
North Dakota,Oliver County,2,114,53,61
North Dakota,Oliver County,3,109,63,46
North Dakota,Oliver County,4,110,58,52
North Dakota,Oliver County,5,97,44,53
North Dakota,Oliver County,6,78,50,28
North Dakota,Oliver County,7,96,52,44
North Dakota,Oliver County,8,87,44,43
North Dakota,Oliver County,9,78,40,38
North Dakota,Oliver County,10,115,61,54
North Dakota,Oliver County,11,156,72,84
North Dakota,Oliver County,12,177,90,87
North Dakota,Oliver County,13,167,93,74
North Dakota,Oliver County,14,130,64,66
North Dakota,Oliver County,15,83,44,39
North Dakota,Oliver County,16,48,28,20
North Dakota,Oliver County,17,43,26,17
North Dakota,Oliver County,18,42,17,25
North Dakota,Pembina County,0,7128,3661,3467
North Dakota,Pembina County,1,373,203,170
North Dakota,Pembina County,2,424,225,199
North Dakota,Pembina County,3,426,218,208
North Dakota,Pembina County,4,398,215,183
North Dakota,Pembina County,5,355,178,177
North Dakota,Pembina County,6,324,176,148
North Dakota,Pembina County,7,401,221,180
North Dakota,Pembina County,8,361,200,161
North Dakota,Pembina County,9,348,182,166
North Dakota,Pembina County,10,375,173,202
North Dakota,Pembina County,11,538,275,263
North Dakota,Pembina County,12,671,342,329
North Dakota,Pembina County,13,596,335,261
North Dakota,Pembina County,14,430,231,199
North Dakota,Pembina County,15,318,164,154
North Dakota,Pembina County,16,244,108,136
North Dakota,Pembina County,17,244,109,135
North Dakota,Pembina County,18,302,106,196
North Dakota,Pierce County,0,4404,2232,2172
North Dakota,Pierce County,1,277,154,123
North Dakota,Pierce County,2,281,130,151
North Dakota,Pierce County,3,254,124,130
North Dakota,Pierce County,4,251,139,112
North Dakota,Pierce County,5,237,142,95
North Dakota,Pierce County,6,204,115,89
North Dakota,Pierce County,7,237,141,96
North Dakota,Pierce County,8,217,97,120
North Dakota,Pierce County,9,220,118,102
North Dakota,Pierce County,10,267,138,129
North Dakota,Pierce County,11,323,178,145
North Dakota,Pierce County,12,334,181,153
North Dakota,Pierce County,13,300,157,143
North Dakota,Pierce County,14,255,136,119
North Dakota,Pierce County,15,194,88,106
North Dakota,Pierce County,16,165,72,93
North Dakota,Pierce County,17,179,70,109
North Dakota,Pierce County,18,209,52,157
North Dakota,Ramsey County,0,11564,5851,5713
North Dakota,Ramsey County,1,746,403,343
North Dakota,Ramsey County,2,738,387,351
North Dakota,Ramsey County,3,689,344,345
North Dakota,Ramsey County,4,717,378,339
North Dakota,Ramsey County,5,781,421,360
North Dakota,Ramsey County,6,700,354,346
North Dakota,Ramsey County,7,686,365,321
North Dakota,Ramsey County,8,601,311,290
North Dakota,Ramsey County,9,571,303,268
North Dakota,Ramsey County,10,658,319,339
North Dakota,Ramsey County,11,892,443,449
North Dakota,Ramsey County,12,889,449,440
North Dakota,Ramsey County,13,766,388,378
North Dakota,Ramsey County,14,627,332,295
North Dakota,Ramsey County,15,460,217,243
North Dakota,Ramsey County,16,355,177,178
North Dakota,Ramsey County,17,318,134,184
North Dakota,Ramsey County,18,370,126,244
North Dakota,Ransom County,0,5446,2781,2665
North Dakota,Ransom County,1,303,162,141
North Dakota,Ransom County,2,326,168,158
North Dakota,Ransom County,3,364,196,168
North Dakota,Ransom County,4,378,200,178
North Dakota,Ransom County,5,266,145,121
North Dakota,Ransom County,6,233,122,111
North Dakota,Ransom County,7,279,146,133
North Dakota,Ransom County,8,283,137,146
North Dakota,Ransom County,9,319,162,157
North Dakota,Ransom County,10,344,186,158
North Dakota,Ransom County,11,416,221,195
North Dakota,Ransom County,12,423,192,231
North Dakota,Ransom County,13,387,225,162
North Dakota,Ransom County,14,295,162,133
North Dakota,Ransom County,15,214,114,100
North Dakota,Ransom County,16,172,75,97
North Dakota,Ransom County,17,165,66,99
North Dakota,Ransom County,18,279,102,177
North Dakota,Renville County,0,2587,1360,1227
North Dakota,Renville County,1,172,93,79
North Dakota,Renville County,2,148,75,73
North Dakota,Renville County,3,158,73,85
North Dakota,Renville County,4,154,71,83
North Dakota,Renville County,5,147,86,61
North Dakota,Renville County,6,138,79,59
North Dakota,Renville County,7,155,92,63
North Dakota,Renville County,8,137,70,67
North Dakota,Renville County,9,135,78,57
North Dakota,Renville County,10,161,78,83
North Dakota,Renville County,11,217,122,95
North Dakota,Renville County,12,201,97,104
North Dakota,Renville County,13,176,98,78
North Dakota,Renville County,14,130,69,61
North Dakota,Renville County,15,99,57,42
North Dakota,Renville County,16,98,45,53
North Dakota,Renville County,17,81,46,35
North Dakota,Renville County,18,80,31,49
North Dakota,Richland County,0,16432,8471,7961
North Dakota,Richland County,1,885,432,453
North Dakota,Richland County,2,1012,516,496
North Dakota,Richland County,3,993,524,469
North Dakota,Richland County,4,1463,791,672
North Dakota,Richland County,5,1642,950,692
North Dakota,Richland County,6,859,458,401
North Dakota,Richland County,7,880,435,445
North Dakota,Richland County,8,816,430,386
North Dakota,Richland County,9,802,419,383
North Dakota,Richland County,10,899,446,453
North Dakota,Richland County,11,1204,626,578
North Dakota,Richland County,12,1323,679,644
North Dakota,Richland County,13,1052,573,479
North Dakota,Richland County,14,722,378,344
North Dakota,Richland County,15,543,262,281
North Dakota,Richland County,16,443,207,236
North Dakota,Richland County,17,363,154,209
North Dakota,Richland County,18,531,191,340
North Dakota,Rolette County,0,14616,7183,7433
North Dakota,Rolette County,1,1506,744,762
North Dakota,Rolette County,2,1518,741,777
North Dakota,Rolette County,3,1239,673,566
North Dakota,Rolette County,4,1082,560,522
North Dakota,Rolette County,5,1019,525,494
North Dakota,Rolette County,6,884,405,479
North Dakota,Rolette County,7,881,423,458
North Dakota,Rolette County,8,806,394,412
North Dakota,Rolette County,9,770,397,373
North Dakota,Rolette County,10,821,376,445
North Dakota,Rolette County,11,986,483,503
North Dakota,Rolette County,12,879,443,436
North Dakota,Rolette County,13,732,345,387
North Dakota,Rolette County,14,533,254,279
North Dakota,Rolette County,15,361,172,189
North Dakota,Rolette County,16,258,124,134
North Dakota,Rolette County,17,191,77,114
North Dakota,Rolette County,18,150,47,103
North Dakota,Sargent County,0,3931,2066,1865
North Dakota,Sargent County,1,211,113,98
North Dakota,Sargent County,2,229,128,101
North Dakota,Sargent County,3,242,124,118
North Dakota,Sargent County,4,232,123,109
North Dakota,Sargent County,5,230,128,102
North Dakota,Sargent County,6,192,109,83
North Dakota,Sargent County,7,195,102,93
North Dakota,Sargent County,8,204,118,86
North Dakota,Sargent County,9,215,104,111
North Dakota,Sargent County,10,240,115,125
North Dakota,Sargent County,11,315,173,142
North Dakota,Sargent County,12,332,181,151
North Dakota,Sargent County,13,317,171,146
North Dakota,Sargent County,14,240,134,106
North Dakota,Sargent County,15,202,100,102
North Dakota,Sargent County,16,138,74,64
North Dakota,Sargent County,17,82,30,52
North Dakota,Sargent County,18,115,39,76
North Dakota,Sheridan County,0,1326,661,665
North Dakota,Sheridan County,1,53,30,23
North Dakota,Sheridan County,2,57,30,27
North Dakota,Sheridan County,3,74,38,36
North Dakota,Sheridan County,4,65,32,33
North Dakota,Sheridan County,5,51,26,25
North Dakota,Sheridan County,6,68,28,40
North Dakota,Sheridan County,7,52,32,20
North Dakota,Sheridan County,8,41,20,21
North Dakota,Sheridan County,9,61,30,31
North Dakota,Sheridan County,10,81,39,42
North Dakota,Sheridan County,11,99,53,46
North Dakota,Sheridan County,12,130,64,66
North Dakota,Sheridan County,13,110,57,53
North Dakota,Sheridan County,14,91,44,47
North Dakota,Sheridan County,15,87,44,43
North Dakota,Sheridan County,16,88,40,48
North Dakota,Sheridan County,17,57,26,31
North Dakota,Sheridan County,18,61,28,33
North Dakota,Sioux County,0,4422,2213,2209
North Dakota,Sioux County,1,539,261,278
North Dakota,Sioux County,2,469,241,228
North Dakota,Sioux County,3,447,239,208
North Dakota,Sioux County,4,317,149,168
North Dakota,Sioux County,5,357,183,174
North Dakota,Sioux County,6,317,157,160
North Dakota,Sioux County,7,263,136,127
North Dakota,Sioux County,8,251,126,125
North Dakota,Sioux County,9,241,120,121
North Dakota,Sioux County,10,283,130,153
North Dakota,Sioux County,11,263,140,123
North Dakota,Sioux County,12,201,100,101
North Dakota,Sioux County,13,153,79,74
North Dakota,Sioux County,14,103,49,54
North Dakota,Sioux County,15,96,47,49
North Dakota,Sioux County,16,60,28,32
North Dakota,Sioux County,17,38,13,25
North Dakota,Sioux County,18,24,15,9
North Dakota,Slope County,0,765,413,352
North Dakota,Slope County,1,55,28,27
North Dakota,Slope County,2,43,22,21
North Dakota,Slope County,3,39,27,12
North Dakota,Slope County,4,48,29,19
North Dakota,Slope County,5,32,20,12
North Dakota,Slope County,6,30,16,14
North Dakota,Slope County,7,52,28,24
North Dakota,Slope County,8,30,20,10
North Dakota,Slope County,9,34,17,17
North Dakota,Slope County,10,40,25,15
North Dakota,Slope County,11,65,30,35
North Dakota,Slope County,12,77,43,34
North Dakota,Slope County,13,64,32,32
North Dakota,Slope County,14,50,30,20
North Dakota,Slope County,15,29,16,13
North Dakota,Slope County,16,30,10,20
North Dakota,Slope County,17,27,12,15
North Dakota,Slope County,18,20,8,12
North Dakota,Stark County,0,30372,15963,14409
North Dakota,Stark County,1,2303,1207,1096
North Dakota,Stark County,2,2165,1124,1041
North Dakota,Stark County,3,1851,925,926
North Dakota,Stark County,4,1739,926,813
North Dakota,Stark County,5,2642,1451,1191
North Dakota,Stark County,6,2796,1616,1180
North Dakota,Stark County,7,2446,1362,1084
North Dakota,Stark County,8,1716,986,730
North Dakota,Stark County,9,1608,862,746
North Dakota,Stark County,10,1641,859,782
North Dakota,Stark County,11,2091,1102,989
North Dakota,Stark County,12,2045,1087,958
North Dakota,Stark County,13,1454,772,682
North Dakota,Stark County,14,1039,517,522
North Dakota,Stark County,15,741,348,393
North Dakota,Stark County,16,691,324,367
North Dakota,Stark County,17,587,219,368
North Dakota,Stark County,18,817,276,541
North Dakota,Steele County,0,1955,995,960
North Dakota,Steele County,1,112,47,65
North Dakota,Steele County,2,101,48,53
North Dakota,Steele County,3,98,42,56
North Dakota,Steele County,4,131,61,70
North Dakota,Steele County,5,89,46,43
North Dakota,Steele County,6,90,45,45
North Dakota,Steele County,7,95,57,38
North Dakota,Steele County,8,92,48,44
North Dakota,Steele County,9,94,49,45
North Dakota,Steele County,10,103,57,46
North Dakota,Steele County,11,166,81,85
North Dakota,Steele County,12,158,89,69
North Dakota,Steele County,13,163,90,73
North Dakota,Steele County,14,126,70,56
North Dakota,Steele County,15,108,61,47
North Dakota,Steele County,16,97,44,53
North Dakota,Steele County,17,78,39,39
North Dakota,Steele County,18,54,21,33
North Dakota,Stutsman County,0,21129,10797,10332
North Dakota,Stutsman County,1,1176,575,601
North Dakota,Stutsman County,2,1186,597,589
North Dakota,Stutsman County,3,1169,628,541
North Dakota,Stutsman County,4,1438,739,699
North Dakota,Stutsman County,5,1594,843,751
North Dakota,Stutsman County,6,1323,795,528
North Dakota,Stutsman County,7,1262,675,587
North Dakota,Stutsman County,8,1187,640,547
North Dakota,Stutsman County,9,1112,598,514
North Dakota,Stutsman County,10,1209,639,570
North Dakota,Stutsman County,11,1575,807,768
North Dakota,Stutsman County,12,1686,855,831
North Dakota,Stutsman County,13,1493,764,729
North Dakota,Stutsman County,14,1087,540,547
North Dakota,Stutsman County,15,769,354,415
North Dakota,Stutsman County,16,636,290,346
North Dakota,Stutsman County,17,554,217,337
North Dakota,Stutsman County,18,673,241,432
North Dakota,Towner County,0,2310,1175,1135
North Dakota,Towner County,1,154,74,80
North Dakota,Towner County,2,134,66,68
North Dakota,Towner County,3,123,64,59
North Dakota,Towner County,4,130,73,57
North Dakota,Towner County,5,103,60,43
North Dakota,Towner County,6,113,57,56
North Dakota,Towner County,7,98,55,43
North Dakota,Towner County,8,74,35,39
North Dakota,Towner County,9,83,41,42
North Dakota,Towner County,10,153,77,76
North Dakota,Towner County,11,198,112,86
North Dakota,Towner County,12,212,113,99
North Dakota,Towner County,13,192,103,89
North Dakota,Towner County,14,134,62,72
North Dakota,Towner County,15,125,69,56
North Dakota,Towner County,16,110,51,59
North Dakota,Towner County,17,87,34,53
North Dakota,Towner County,18,87,29,58
North Dakota,Traill County,0,8082,4110,3972
North Dakota,Traill County,1,518,283,235
North Dakota,Traill County,2,499,259,240
North Dakota,Traill County,3,487,243,244
North Dakota,Traill County,4,568,311,257
North Dakota,Traill County,5,530,280,250
North Dakota,Traill County,6,472,251,221
North Dakota,Traill County,7,402,216,186
North Dakota,Traill County,8,403,216,187
North Dakota,Traill County,9,428,209,219
North Dakota,Traill County,10,481,240,241
North Dakota,Traill County,11,600,333,267
North Dakota,Traill County,12,607,303,304
North Dakota,Traill County,13,550,294,256
North Dakota,Traill County,14,407,204,203
North Dakota,Traill County,15,336,153,183
North Dakota,Traill County,16,242,106,136
North Dakota,Traill County,17,222,95,127
North Dakota,Traill County,18,330,114,216
North Dakota,Walsh County,0,10970,5559,5411
North Dakota,Walsh County,1,703,382,321
North Dakota,Walsh County,2,648,339,309
North Dakota,Walsh County,3,680,359,321
North Dakota,Walsh County,4,683,350,333
North Dakota,Walsh County,5,593,319,274
North Dakota,Walsh County,6,550,290,260
North Dakota,Walsh County,7,611,322,289
North Dakota,Walsh County,8,521,264,257
North Dakota,Walsh County,9,547,275,272
North Dakota,Walsh County,10,602,329,273
North Dakota,Walsh County,11,881,446,435
North Dakota,Walsh County,12,880,461,419
North Dakota,Walsh County,13,769,409,360
North Dakota,Walsh County,14,629,309,320
North Dakota,Walsh County,15,503,246,257
North Dakota,Walsh County,16,407,181,226
North Dakota,Walsh County,17,317,127,190
North Dakota,Walsh County,18,446,151,295
North Dakota,Ward County,0,69384,36549,32835
North Dakota,Ward County,1,5480,2708,2772
North Dakota,Ward County,2,4519,2326,2193
North Dakota,Ward County,3,3837,1975,1862
North Dakota,Ward County,4,4551,2481,2070
North Dakota,Ward County,5,8488,5204,3284
North Dakota,Ward County,6,6801,3872,2929
North Dakota,Ward County,7,5412,2945,2467
North Dakota,Ward County,8,4145,2199,1946
North Dakota,Ward County,9,3697,1964,1733
North Dakota,Ward County,10,3435,1742,1693
North Dakota,Ward County,11,4077,2111,1966
North Dakota,Ward County,12,3831,1907,1924
North Dakota,Ward County,13,3162,1637,1525
North Dakota,Ward County,14,2296,1128,1168
North Dakota,Ward County,15,1724,810,914
North Dakota,Ward County,16,1455,624,831
North Dakota,Ward County,17,1127,464,663
North Dakota,Ward County,18,1347,452,895
North Dakota,Wells County,0,4192,2103,2089
North Dakota,Wells County,1,225,125,100
North Dakota,Wells County,2,227,121,106
North Dakota,Wells County,3,231,111,120
North Dakota,Wells County,4,194,108,86
North Dakota,Wells County,5,202,108,94
North Dakota,Wells County,6,178,103,75
North Dakota,Wells County,7,165,89,76
North Dakota,Wells County,8,175,82,93
North Dakota,Wells County,9,180,103,77
North Dakota,Wells County,10,260,129,131
North Dakota,Wells County,11,345,157,188
North Dakota,Wells County,12,356,196,160
North Dakota,Wells County,13,319,166,153
North Dakota,Wells County,14,279,127,152
North Dakota,Wells County,15,235,121,114
North Dakota,Wells County,16,210,102,108
North Dakota,Wells County,17,191,83,108
North Dakota,Wells County,18,220,72,148
North Dakota,Williams County,0,32130,17458,14672
North Dakota,Williams County,1,2659,1398,1261
North Dakota,Williams County,2,2338,1164,1174
North Dakota,Williams County,3,1958,955,1003
North Dakota,Williams County,4,1932,1015,917
North Dakota,Williams County,5,2812,1585,1227
North Dakota,Williams County,6,3215,1946,1269
North Dakota,Williams County,7,2601,1519,1082
North Dakota,Williams County,8,2038,1225,813
North Dakota,Williams County,9,1755,986,769
North Dakota,Williams County,10,1838,1005,833
North Dakota,Williams County,11,2243,1258,985
North Dakota,Williams County,12,2221,1234,987
North Dakota,Williams County,13,1498,843,655
North Dakota,Williams County,14,910,472,438
North Dakota,Williams County,15,606,282,324
North Dakota,Williams County,16,524,226,298
North Dakota,Williams County,17,449,174,275
North Dakota,Williams County,18,533,171,362
Ohio,Adams County,0,28129,13866,14263
Ohio,Adams County,1,1708,832,876
Ohio,Adams County,2,1937,1008,929
Ohio,Adams County,3,2069,1045,1024
Ohio,Adams County,4,1762,868,894
Ohio,Adams County,5,1559,754,805
Ohio,Adams County,6,1473,724,749
Ohio,Adams County,7,1551,747,804
Ohio,Adams County,8,1655,818,837
Ohio,Adams County,9,1868,940,928
Ohio,Adams County,10,1895,963,932
Ohio,Adams County,11,2057,999,1058
Ohio,Adams County,12,2087,1032,1055
Ohio,Adams County,13,1833,930,903
Ohio,Adams County,14,1561,793,768
Ohio,Adams County,15,1210,573,637
Ohio,Adams County,16,832,399,433
Ohio,Adams County,17,585,238,347
Ohio,Adams County,18,487,203,284
Ohio,Allen County,0,105040,52921,52119
Ohio,Allen County,1,6422,3247,3175
Ohio,Allen County,2,6753,3468,3285
Ohio,Allen County,3,7102,3635,3467
Ohio,Allen County,4,7364,4034,3330
Ohio,Allen County,5,8020,4484,3536
Ohio,Allen County,6,6328,3375,2953
Ohio,Allen County,7,6178,3189,2989
Ohio,Allen County,8,6146,3069,3077
Ohio,Allen County,9,6050,3089,2961
Ohio,Allen County,10,6232,3201,3031
Ohio,Allen County,11,7402,3693,3709
Ohio,Allen County,12,7720,3910,3810
Ohio,Allen County,13,6608,3264,3344
Ohio,Allen County,14,5293,2579,2714
Ohio,Allen County,15,3777,1718,2059
Ohio,Allen County,16,2815,1241,1574
Ohio,Allen County,17,2238,918,1320
Ohio,Allen County,18,2592,807,1785
Ohio,Ashland County,0,53035,25998,27037
Ohio,Ashland County,1,3160,1591,1569
Ohio,Ashland County,2,3363,1713,1650
Ohio,Ashland County,3,3596,1809,1787
Ohio,Ashland County,4,3943,2008,1935
Ohio,Ashland County,5,3673,1794,1879
Ohio,Ashland County,6,2939,1497,1442
Ohio,Ashland County,7,2942,1494,1448
Ohio,Ashland County,8,2859,1433,1426
Ohio,Ashland County,9,3064,1531,1533
Ohio,Ashland County,10,3324,1661,1663
Ohio,Ashland County,11,3666,1781,1885
Ohio,Ashland County,12,3869,1867,2002
Ohio,Ashland County,13,3450,1686,1764
Ohio,Ashland County,14,2832,1397,1435
Ohio,Ashland County,15,2239,1028,1211
Ohio,Ashland County,16,1654,768,886
Ohio,Ashland County,17,1161,496,665
Ohio,Ashland County,18,1301,444,857
Ohio,Ashtabula County,0,99175,49878,49297
Ohio,Ashtabula County,1,5604,2866,2738
Ohio,Ashtabula County,2,6237,3205,3032
Ohio,Ashtabula County,3,6507,3342,3165
Ohio,Ashtabula County,4,6130,3159,2971
Ohio,Ashtabula County,5,5779,3058,2721
Ohio,Ashtabula County,6,5504,2925,2579
Ohio,Ashtabula County,7,5578,2979,2599
Ohio,Ashtabula County,8,5448,2821,2627
Ohio,Ashtabula County,9,6220,3224,2996
Ohio,Ashtabula County,10,6908,3521,3387
Ohio,Ashtabula County,11,7573,3831,3742
Ohio,Ashtabula County,12,7684,3817,3867
Ohio,Ashtabula County,13,6772,3376,3396
Ohio,Ashtabula County,14,5622,2683,2939
Ohio,Ashtabula County,15,4214,2019,2195
Ohio,Ashtabula County,16,2940,1341,1599
Ohio,Ashtabula County,17,2123,898,1225
Ohio,Ashtabula County,18,2332,813,1519
Ohio,Athens County,0,64713,32313,32400
Ohio,Athens County,1,2788,1437,1351
Ohio,Athens County,2,2622,1317,1305
Ohio,Athens County,3,2834,1438,1396
Ohio,Athens County,4,8317,3917,4400
Ohio,Athens County,5,12838,6639,6199
Ohio,Athens County,6,4570,2545,2025
Ohio,Athens County,7,3477,1774,1703
Ohio,Athens County,8,3152,1638,1514
Ohio,Athens County,9,3105,1599,1506
Ohio,Athens County,10,3180,1597,1583
Ohio,Athens County,11,3535,1745,1790
Ohio,Athens County,12,3614,1803,1811
Ohio,Athens County,13,3331,1603,1728
Ohio,Athens County,14,2630,1304,1326
Ohio,Athens County,15,1746,804,942
Ohio,Athens County,16,1288,580,708
Ohio,Athens County,17,842,325,517
Ohio,Athens County,18,844,248,596
Ohio,Auglaize County,0,45841,22751,23090
Ohio,Auglaize County,1,2789,1412,1377
Ohio,Auglaize County,2,3168,1633,1535
Ohio,Auglaize County,3,3192,1624,1568
Ohio,Auglaize County,4,2988,1568,1420
Ohio,Auglaize County,5,2679,1388,1291
Ohio,Auglaize County,6,2447,1207,1240
Ohio,Auglaize County,7,2542,1278,1264
Ohio,Auglaize County,8,2500,1282,1218
Ohio,Auglaize County,9,2822,1438,1384
Ohio,Auglaize County,10,3022,1487,1535
Ohio,Auglaize County,11,3430,1738,1692
Ohio,Auglaize County,12,3405,1745,1660
Ohio,Auglaize County,13,3085,1569,1516
Ohio,Auglaize County,14,2335,1074,1261
Ohio,Auglaize County,15,1713,795,918
Ohio,Auglaize County,16,1418,641,777
Ohio,Auglaize County,17,1042,427,615
Ohio,Auglaize County,18,1264,445,819
Ohio,Belmont County,0,69461,35446,34015
Ohio,Belmont County,1,3435,1808,1627
Ohio,Belmont County,2,3595,1808,1787
Ohio,Belmont County,3,3841,2032,1809
Ohio,Belmont County,4,3711,1983,1728
Ohio,Belmont County,5,4370,2579,1791
Ohio,Belmont County,6,4356,2567,1789
Ohio,Belmont County,7,4231,2315,1916
Ohio,Belmont County,8,3932,2109,1823
Ohio,Belmont County,9,4348,2341,2007
Ohio,Belmont County,10,4389,2251,2138
Ohio,Belmont County,11,5249,2623,2626
Ohio,Belmont County,12,5703,2827,2876
Ohio,Belmont County,13,5164,2561,2603
Ohio,Belmont County,14,4218,2065,2153
Ohio,Belmont County,15,2857,1327,1530
Ohio,Belmont County,16,2373,970,1403
Ohio,Belmont County,17,1680,667,1013
Ohio,Belmont County,18,2009,613,1396
Ohio,Brown County,0,44116,21889,22227
Ohio,Brown County,1,2563,1299,1264
Ohio,Brown County,2,2846,1447,1399
Ohio,Brown County,3,3067,1545,1522
Ohio,Brown County,4,2835,1405,1430
Ohio,Brown County,5,2492,1263,1229
Ohio,Brown County,6,2366,1205,1161
Ohio,Brown County,7,2514,1226,1288
Ohio,Brown County,8,2630,1360,1270
Ohio,Brown County,9,2921,1483,1438
Ohio,Brown County,10,2889,1479,1410
Ohio,Brown County,11,3461,1695,1766
Ohio,Brown County,12,3395,1674,1721
Ohio,Brown County,13,2755,1339,1416
Ohio,Brown County,14,2437,1204,1233
Ohio,Brown County,15,1855,866,989
Ohio,Brown County,16,1343,635,708
Ohio,Brown County,17,944,450,494
Ohio,Brown County,18,803,314,489
Ohio,Butler County,0,374158,183296,190862
Ohio,Butler County,1,23219,11857,11362
Ohio,Butler County,2,25839,13283,12556
Ohio,Butler County,3,25984,13165,12819
Ohio,Butler County,4,29127,14433,14694
Ohio,Butler County,5,32178,16140,16038
Ohio,Butler County,6,21008,10537,10471
Ohio,Butler County,7,23054,11397,11657
Ohio,Butler County,8,22180,10928,11252
Ohio,Butler County,9,23725,11667,12058
Ohio,Butler County,10,24481,12165,12316
Ohio,Butler County,11,26835,13135,13700
Ohio,Butler County,12,25807,12555,13252
Ohio,Butler County,13,21396,10309,11087
Ohio,Butler County,14,16950,8147,8803
Ohio,Butler County,15,11586,5232,6354
Ohio,Butler County,16,8529,3724,4805
Ohio,Butler County,17,6299,2588,3711
Ohio,Butler County,18,5961,2034,3927
Ohio,Carroll County,0,28187,14162,14025
Ohio,Carroll County,1,1349,684,665
Ohio,Carroll County,2,1688,912,776
Ohio,Carroll County,3,1864,937,927
Ohio,Carroll County,4,1816,917,899
Ohio,Carroll County,5,1482,797,685
Ohio,Carroll County,6,1410,735,675
Ohio,Carroll County,7,1378,702,676
Ohio,Carroll County,8,1516,763,753
Ohio,Carroll County,9,1781,890,891
Ohio,Carroll County,10,1771,904,867
Ohio,Carroll County,11,2315,1146,1169
Ohio,Carroll County,12,2307,1144,1163
Ohio,Carroll County,13,2072,1044,1028
Ohio,Carroll County,14,1824,930,894
Ohio,Carroll County,15,1392,694,698
Ohio,Carroll County,16,963,453,510
Ohio,Carroll County,17,603,280,323
Ohio,Carroll County,18,656,230,426
Ohio,Champaign County,0,39128,19485,19643
Ohio,Champaign County,1,2294,1204,1090
Ohio,Champaign County,2,2482,1254,1228
Ohio,Champaign County,3,2698,1394,1304
Ohio,Champaign County,4,2705,1440,1265
Ohio,Champaign County,5,2366,1250,1116
Ohio,Champaign County,6,2104,1078,1026
Ohio,Champaign County,7,2122,1053,1069
Ohio,Champaign County,8,2158,1063,1095
Ohio,Champaign County,9,2587,1302,1285
Ohio,Champaign County,10,2774,1415,1359
Ohio,Champaign County,11,2989,1490,1499
Ohio,Champaign County,12,2857,1420,1437
Ohio,Champaign County,13,2490,1179,1311
Ohio,Champaign County,14,2214,1063,1151
Ohio,Champaign County,15,1642,787,855
Ohio,Champaign County,16,1184,543,641
Ohio,Champaign County,17,732,310,422
Ohio,Champaign County,18,730,240,490
Ohio,Clark County,0,136554,66229,70325
Ohio,Clark County,1,7991,4109,3882
Ohio,Clark County,2,8701,4531,4170
Ohio,Clark County,3,8930,4545,4385
Ohio,Clark County,4,9006,4541,4465
Ohio,Clark County,5,8591,4246,4345
Ohio,Clark County,6,8054,3974,4080
Ohio,Clark County,7,7539,3591,3948
Ohio,Clark County,8,7413,3648,3765
Ohio,Clark County,9,8165,3999,4166
Ohio,Clark County,10,8843,4371,4472
Ohio,Clark County,11,9742,4782,4960
Ohio,Clark County,12,9841,4797,5044
Ohio,Clark County,13,9286,4386,4900
Ohio,Clark County,14,7842,3686,4156
Ohio,Clark County,15,5869,2728,3141
Ohio,Clark County,16,4298,1876,2422
Ohio,Clark County,17,3038,1226,1812
Ohio,Clark County,18,3405,1193,2212
Ohio,Clermont County,0,201560,99364,102196
Ohio,Clermont County,1,12144,6140,6004
Ohio,Clermont County,2,13757,6983,6774
Ohio,Clermont County,3,14377,7526,6851
Ohio,Clermont County,4,12743,6495,6248
Ohio,Clermont County,5,11833,5990,5843
Ohio,Clermont County,6,12045,6090,5955
Ohio,Clermont County,7,12494,6297,6197
Ohio,Clermont County,8,12456,6159,6297
Ohio,Clermont County,9,13325,6577,6748
Ohio,Clermont County,10,14273,7140,7133
Ohio,Clermont County,11,15589,7628,7961
Ohio,Clermont County,12,15520,7517,8003
Ohio,Clermont County,13,12800,6235,6565
Ohio,Clermont County,14,10115,4861,5254
Ohio,Clermont County,15,7066,3322,3744
Ohio,Clermont County,16,4745,2074,2671
Ohio,Clermont County,17,3163,1303,1860
Ohio,Clermont County,18,3115,1027,2088
Ohio,Clinton County,0,41835,20658,21177
Ohio,Clinton County,1,2665,1443,1222
Ohio,Clinton County,2,2701,1412,1289
Ohio,Clinton County,3,2884,1478,1406
Ohio,Clinton County,4,2980,1512,1468
Ohio,Clinton County,5,2729,1370,1359
Ohio,Clinton County,6,2347,1144,1203
Ohio,Clinton County,7,2501,1261,1240
Ohio,Clinton County,8,2419,1164,1255
Ohio,Clinton County,9,2599,1281,1318
Ohio,Clinton County,10,2693,1350,1343
Ohio,Clinton County,11,3089,1515,1574
Ohio,Clinton County,12,3230,1590,1640
Ohio,Clinton County,13,2622,1274,1348
Ohio,Clinton County,14,2179,1073,1106
Ohio,Clinton County,15,1526,722,804
Ohio,Clinton County,16,1093,471,622
Ohio,Clinton County,17,798,335,463
Ohio,Clinton County,18,780,263,517
Ohio,Columbiana County,0,105686,53258,52428
Ohio,Columbiana County,1,5577,2786,2791
Ohio,Columbiana County,2,6031,3082,2949
Ohio,Columbiana County,3,6407,3292,3115
Ohio,Columbiana County,4,6169,3262,2907
Ohio,Columbiana County,5,5876,2980,2896
Ohio,Columbiana County,6,5911,3129,2782
Ohio,Columbiana County,7,5896,3199,2697
Ohio,Columbiana County,8,6344,3466,2878
Ohio,Columbiana County,9,6707,3575,3132
Ohio,Columbiana County,10,6957,3564,3393
Ohio,Columbiana County,11,8201,4157,4044
Ohio,Columbiana County,12,8606,4285,4321
Ohio,Columbiana County,13,7702,3946,3756
Ohio,Columbiana County,14,6196,2983,3213
Ohio,Columbiana County,15,4627,2147,2480
Ohio,Columbiana County,16,3444,1544,1900
Ohio,Columbiana County,17,2466,1006,1460
Ohio,Columbiana County,18,2569,855,1714
Ohio,Coshocton County,0,36516,18082,18434
Ohio,Coshocton County,1,2181,1138,1043
Ohio,Coshocton County,2,2352,1232,1120
Ohio,Coshocton County,3,2512,1328,1184
Ohio,Coshocton County,4,2259,1179,1080
Ohio,Coshocton County,5,2061,1032,1029
Ohio,Coshocton County,6,2031,983,1048
Ohio,Coshocton County,7,2129,1070,1059
Ohio,Coshocton County,8,1919,933,986
Ohio,Coshocton County,9,2275,1135,1140
Ohio,Coshocton County,10,2317,1191,1126
Ohio,Coshocton County,11,2671,1322,1349
Ohio,Coshocton County,12,2796,1380,1416
Ohio,Coshocton County,13,2488,1254,1234
Ohio,Coshocton County,14,2071,992,1079
Ohio,Coshocton County,15,1589,740,849
Ohio,Coshocton County,16,1261,574,687
Ohio,Coshocton County,17,798,335,463
Ohio,Coshocton County,18,806,264,542
Ohio,Crawford County,0,42480,20672,21808
Ohio,Crawford County,1,2334,1181,1153
Ohio,Crawford County,2,2491,1296,1195
Ohio,Crawford County,3,2751,1397,1354
Ohio,Crawford County,4,2689,1345,1344
Ohio,Crawford County,5,2474,1257,1217
Ohio,Crawford County,6,2174,1091,1083
Ohio,Crawford County,7,2296,1097,1199
Ohio,Crawford County,8,2403,1179,1224
Ohio,Crawford County,9,2674,1336,1338
Ohio,Crawford County,10,2768,1423,1345
Ohio,Crawford County,11,3053,1493,1560
Ohio,Crawford County,12,3189,1563,1626
Ohio,Crawford County,13,2904,1418,1486
Ohio,Crawford County,14,2458,1166,1292
Ohio,Crawford County,15,2005,919,1086
Ohio,Crawford County,16,1558,670,888
Ohio,Crawford County,17,1091,446,645
Ohio,Crawford County,18,1168,395,773
Ohio,Cuyahoga County,0,1259828,599937,659891
Ohio,Cuyahoga County,1,72458,37012,35446
Ohio,Cuyahoga County,2,73274,37078,36196
Ohio,Cuyahoga County,3,76524,38912,37612
Ohio,Cuyahoga County,4,80266,41037,39229
Ohio,Cuyahoga County,5,84799,41770,43029
Ohio,Cuyahoga County,6,84537,41161,43376
Ohio,Cuyahoga County,7,80950,39228,41722
Ohio,Cuyahoga County,8,71455,34524,36931
Ohio,Cuyahoga County,9,75246,36062,39184
Ohio,Cuyahoga County,10,81149,38698,42451
Ohio,Cuyahoga County,11,93920,45012,48908
Ohio,Cuyahoga County,12,96085,45757,50328
Ohio,Cuyahoga County,13,82047,38629,43418
Ohio,Cuyahoga County,14,62813,28668,34145
Ohio,Cuyahoga County,15,45741,19839,25902
Ohio,Cuyahoga County,16,35581,14557,21024
Ohio,Cuyahoga County,17,28487,10844,17643
Ohio,Cuyahoga County,18,34496,11149,23347
Ohio,Darke County,0,52196,25706,26490
Ohio,Darke County,1,3061,1558,1503
Ohio,Darke County,2,3544,1789,1755
Ohio,Darke County,3,3693,1880,1813
Ohio,Darke County,4,3483,1781,1702
Ohio,Darke County,5,2939,1524,1415
Ohio,Darke County,6,2537,1268,1269
Ohio,Darke County,7,2777,1380,1397
Ohio,Darke County,8,2903,1481,1422
Ohio,Darke County,9,3140,1609,1531
Ohio,Darke County,10,3413,1699,1714
Ohio,Darke County,11,3922,1950,1972
Ohio,Darke County,12,3791,1886,1905
Ohio,Darke County,13,3301,1598,1703
Ohio,Darke County,14,2903,1398,1505
Ohio,Darke County,15,2399,1113,1286
Ohio,Darke County,16,1703,815,888
Ohio,Darke County,17,1209,480,729
Ohio,Darke County,18,1478,497,981
Ohio,Defiance County,0,38510,19024,19486
Ohio,Defiance County,1,2218,1113,1105
Ohio,Defiance County,2,2469,1288,1181
Ohio,Defiance County,3,2705,1368,1337
Ohio,Defiance County,4,2698,1407,1291
Ohio,Defiance County,5,2439,1284,1155
Ohio,Defiance County,6,2178,1117,1061
Ohio,Defiance County,7,2291,1134,1157
Ohio,Defiance County,8,2188,1070,1118
Ohio,Defiance County,9,2370,1169,1201
Ohio,Defiance County,10,2271,1152,1119
Ohio,Defiance County,11,2701,1311,1390
Ohio,Defiance County,12,2946,1470,1476
Ohio,Defiance County,13,2551,1265,1286
Ohio,Defiance County,14,2053,1036,1017
Ohio,Defiance County,15,1557,714,843
Ohio,Defiance County,16,1206,534,672
Ohio,Defiance County,17,797,339,458
Ohio,Defiance County,18,872,253,619
Ohio,Delaware County,0,189113,93719,95394
Ohio,Delaware County,1,11580,6085,5495
Ohio,Delaware County,2,15243,7897,7346
Ohio,Delaware County,3,16516,8462,8054
Ohio,Delaware County,4,13528,7041,6487
Ohio,Delaware County,5,9405,4829,4576
Ohio,Delaware County,6,7879,3750,4129
Ohio,Delaware County,7,11532,5461,6071
Ohio,Delaware County,8,13841,6748,7093
Ohio,Delaware County,9,16161,8032,8129
Ohio,Delaware County,10,14828,7427,7401
Ohio,Delaware County,11,14235,7128,7107
Ohio,Delaware County,12,12291,6033,6258
Ohio,Delaware County,13,10277,5069,5208
Ohio,Delaware County,14,8056,3879,4177
Ohio,Delaware County,15,5367,2433,2934
Ohio,Delaware County,16,3582,1616,1966
Ohio,Delaware County,17,2427,1039,1388
Ohio,Delaware County,18,2365,790,1575
Ohio,Erie County,0,75828,37036,38792
Ohio,Erie County,1,3973,2040,1933
Ohio,Erie County,2,4269,2157,2112
Ohio,Erie County,3,4661,2385,2276
Ohio,Erie County,4,4655,2386,2269
Ohio,Erie County,5,4534,2238,2296
Ohio,Erie County,6,4093,2034,2059
Ohio,Erie County,7,4113,2032,2081
Ohio,Erie County,8,3849,1893,1956
Ohio,Erie County,9,4423,2138,2285
Ohio,Erie County,10,4902,2412,2490
Ohio,Erie County,11,5802,2823,2979
Ohio,Erie County,12,6102,2957,3145
Ohio,Erie County,13,5550,2731,2819
Ohio,Erie County,14,4849,2352,2497
Ohio,Erie County,15,3566,1680,1886
Ohio,Erie County,16,2507,1152,1355
Ohio,Erie County,17,1925,842,1083
Ohio,Erie County,18,2055,784,1271
Ohio,Fairfield County,0,150381,74821,75560
Ohio,Fairfield County,1,8463,4338,4125
Ohio,Fairfield County,2,10123,5187,4936
Ohio,Fairfield County,3,11165,5686,5479
Ohio,Fairfield County,4,10720,5612,5108
Ohio,Fairfield County,5,9144,5007,4137
Ohio,Fairfield County,6,8502,4453,4049
Ohio,Fairfield County,7,9049,4483,4566
Ohio,Fairfield County,8,9550,4701,4849
Ohio,Fairfield County,9,10473,5230,5243
Ohio,Fairfield County,10,10824,5412,5412
Ohio,Fairfield County,11,11457,5678,5779
Ohio,Fairfield County,12,10353,5069,5284
Ohio,Fairfield County,13,8865,4278,4587
Ohio,Fairfield County,14,7467,3548,3919
Ohio,Fairfield County,15,5413,2501,2912
Ohio,Fairfield County,16,3826,1712,2114
Ohio,Fairfield County,17,2482,1056,1426
Ohio,Fairfield County,18,2505,870,1635
Ohio,Fayette County,0,28800,14224,14576
Ohio,Fayette County,1,1832,977,855
Ohio,Fayette County,2,1966,1028,938
Ohio,Fayette County,3,1905,989,916
Ohio,Fayette County,4,1849,972,877
Ohio,Fayette County,5,1674,852,822
Ohio,Fayette County,6,1690,844,846
Ohio,Fayette County,7,1664,818,846
Ohio,Fayette County,8,1693,834,859
Ohio,Fayette County,9,1874,924,950
Ohio,Fayette County,10,1876,943,933
Ohio,Fayette County,11,2107,1043,1064
Ohio,Fayette County,12,2045,1014,1031
Ohio,Fayette County,13,1879,855,1024
Ohio,Fayette County,14,1538,752,786
Ohio,Fayette County,15,1203,558,645
Ohio,Fayette County,16,855,386,469
Ohio,Fayette County,17,587,248,339
Ohio,Fayette County,18,563,187,376
Ohio,Franklin County,0,1231393,600017,631376
Ohio,Franklin County,1,88766,45201,43565
Ohio,Franklin County,2,81470,41329,40141
Ohio,Franklin County,3,76848,39177,37671
Ohio,Franklin County,4,78656,40105,38551
Ohio,Franklin County,5,92683,45510,47173
Ohio,Franklin County,6,118462,58581,59881
Ohio,Franklin County,7,99577,49291,50286
Ohio,Franklin County,8,84137,41854,42283
Ohio,Franklin County,9,80239,39873,40366
Ohio,Franklin County,10,76539,37977,38562
Ohio,Franklin County,11,80958,39363,41595
Ohio,Franklin County,12,76731,36589,40142
Ohio,Franklin County,13,62559,29003,33556
Ohio,Franklin County,14,47338,21442,25896
Ohio,Franklin County,15,30984,13489,17495
Ohio,Franklin County,16,22142,9177,12965
Ohio,Franklin County,17,15983,6397,9586
Ohio,Franklin County,18,17321,5659,11662
Ohio,Fulton County,0,42580,21017,21563
Ohio,Fulton County,1,2527,1334,1193
Ohio,Fulton County,2,2843,1463,1380
Ohio,Fulton County,3,3022,1576,1446
Ohio,Fulton County,4,2972,1512,1460
Ohio,Fulton County,5,2460,1246,1214
Ohio,Fulton County,6,2192,1116,1076
Ohio,Fulton County,7,2441,1180,1261
Ohio,Fulton County,8,2346,1170,1176
Ohio,Fulton County,9,2675,1304,1371
Ohio,Fulton County,10,2819,1362,1457
Ohio,Fulton County,11,3184,1583,1601
Ohio,Fulton County,12,3321,1645,1676
Ohio,Fulton County,13,2893,1449,1444
Ohio,Fulton County,14,2211,1096,1115
Ohio,Fulton County,15,1631,759,872
Ohio,Fulton County,16,1167,546,621
Ohio,Fulton County,17,888,355,533
Ohio,Fulton County,18,988,321,667
Ohio,Gallia County,0,30397,14975,15422
Ohio,Gallia County,1,1857,962,895
Ohio,Gallia County,2,1903,998,905
Ohio,Gallia County,3,1974,997,977
Ohio,Gallia County,4,1976,1046,930
Ohio,Gallia County,5,1868,931,937
Ohio,Gallia County,6,1764,891,873
Ohio,Gallia County,7,1780,915,865
Ohio,Gallia County,8,1673,822,851
Ohio,Gallia County,9,1881,942,939
Ohio,Gallia County,10,1839,911,928
Ohio,Gallia County,11,2282,1106,1176
Ohio,Gallia County,12,2326,1151,1175
Ohio,Gallia County,13,1981,962,1019
Ohio,Gallia County,14,1619,779,840
Ohio,Gallia County,15,1400,622,778
Ohio,Gallia County,16,1011,479,532
Ohio,Gallia County,17,656,265,391
Ohio,Gallia County,18,607,196,411
Ohio,Geauga County,0,94295,46563,47732
Ohio,Geauga County,1,4808,2424,2384
Ohio,Geauga County,2,6023,3120,2903
Ohio,Geauga County,3,7337,3698,3639
Ohio,Geauga County,4,7043,3688,3355
Ohio,Geauga County,5,5216,2703,2513
Ohio,Geauga County,6,3692,1922,1770
Ohio,Geauga County,7,3941,1901,2040
Ohio,Geauga County,8,4495,2187,2308
Ohio,Geauga County,9,5536,2715,2821
Ohio,Geauga County,10,6944,3399,3545
Ohio,Geauga County,11,7592,3683,3909
Ohio,Geauga County,12,7894,4002,3892
Ohio,Geauga County,13,6781,3397,3384
Ohio,Geauga County,14,5623,2760,2863
Ohio,Geauga County,15,4154,2011,2143
Ohio,Geauga County,16,2826,1319,1507
Ohio,Geauga County,17,2066,862,1204
Ohio,Geauga County,18,2324,772,1552
Ohio,Greene County,0,163820,80625,83195
Ohio,Greene County,1,9026,4680,4346
Ohio,Greene County,2,9140,4695,4445
Ohio,Greene County,3,9772,5052,4720
Ohio,Greene County,4,12455,6126,6329
Ohio,Greene County,5,14531,7364,7167
Ohio,Greene County,6,11459,5954,5505
Ohio,Greene County,7,10098,5144,4954
Ohio,Greene County,8,8685,4355,4330
Ohio,Greene County,9,9360,4545,4815
Ohio,Greene County,10,10029,4903,5126
Ohio,Greene County,11,11725,5724,6001
Ohio,Greene County,12,11781,5686,6095
Ohio,Greene County,13,10202,4940,5262
Ohio,Greene County,14,8522,4171,4351
Ohio,Greene County,15,5899,2745,3154
Ohio,Greene County,16,4492,1990,2502
Ohio,Greene County,17,3348,1410,1938
Ohio,Greene County,18,3296,1141,2155
Ohio,Guernsey County,0,39590,19522,20068
Ohio,Guernsey County,1,2336,1182,1154
Ohio,Guernsey County,2,2478,1269,1209
Ohio,Guernsey County,3,2588,1308,1280
Ohio,Guernsey County,4,2536,1325,1211
Ohio,Guernsey County,5,2277,1127,1150
Ohio,Guernsey County,6,2262,1170,1092
Ohio,Guernsey County,7,2264,1122,1142
Ohio,Guernsey County,8,2119,1091,1028
Ohio,Guernsey County,9,2478,1198,1280
Ohio,Guernsey County,10,2595,1328,1267
Ohio,Guernsey County,11,2969,1464,1505
Ohio,Guernsey County,12,3041,1470,1571
Ohio,Guernsey County,13,2728,1330,1398
Ohio,Guernsey County,14,2291,1115,1176
Ohio,Guernsey County,15,1677,780,897
Ohio,Guernsey County,16,1323,601,722
Ohio,Guernsey County,17,848,382,466
Ohio,Guernsey County,18,780,260,520
Ohio,Hamilton County,0,806631,388136,418495
Ohio,Hamilton County,1,53615,27357,26258
Ohio,Hamilton County,2,52383,26335,26048
Ohio,Hamilton County,3,51183,25925,25258
Ohio,Hamilton County,4,52504,26999,25505
Ohio,Hamilton County,5,56034,27872,28162
Ohio,Hamilton County,6,62780,30815,31965
Ohio,Hamilton County,7,55046,26747,28299
Ohio,Hamilton County,8,46958,22963,23995
Ohio,Hamilton County,9,47174,22921,24253
Ohio,Hamilton County,10,50724,24529,26195
Ohio,Hamilton County,11,57733,27851,29882
Ohio,Hamilton County,12,57750,27455,30295
Ohio,Hamilton County,13,48468,22834,25634
Ohio,Hamilton County,14,36082,16651,19431
Ohio,Hamilton County,15,25437,11185,14252
Ohio,Hamilton County,16,19429,8016,11413
Ohio,Hamilton County,17,15740,5978,9762
Ohio,Hamilton County,18,17591,5703,11888
Ohio,Hancock County,0,75337,36908,38429
Ohio,Hancock County,1,4621,2424,2197
Ohio,Hancock County,2,4694,2372,2322
Ohio,Hancock County,3,4798,2465,2333
Ohio,Hancock County,4,5059,2445,2614
Ohio,Hancock County,5,5072,2469,2603
Ohio,Hancock County,6,5060,2516,2544
Ohio,Hancock County,7,4650,2375,2275
Ohio,Hancock County,8,4286,2135,2151
Ohio,Hancock County,9,4593,2342,2251
Ohio,Hancock County,10,4808,2447,2361
Ohio,Hancock County,11,5515,2692,2823
Ohio,Hancock County,12,5561,2754,2807
Ohio,Hancock County,13,4559,2235,2324
Ohio,Hancock County,14,3894,1842,2052
Ohio,Hancock County,15,2784,1280,1504
Ohio,Hancock County,16,2136,960,1176
Ohio,Hancock County,17,1527,602,925
Ohio,Hancock County,18,1720,553,1167
Ohio,Hardin County,0,31796,15740,16056
Ohio,Hardin County,1,1878,954,924
Ohio,Hardin County,2,2055,1090,965
Ohio,Hardin County,3,2183,1150,1033
Ohio,Hardin County,4,2750,1355,1395
Ohio,Hardin County,5,3696,1869,1827
Ohio,Hardin County,6,1569,818,751
Ohio,Hardin County,7,1672,822,850
Ohio,Hardin County,8,1707,843,864
Ohio,Hardin County,9,1877,934,943
Ohio,Hardin County,10,1847,922,925
Ohio,Hardin County,11,2045,1040,1005
Ohio,Hardin County,12,2018,999,1019
Ohio,Hardin County,13,1824,889,935
Ohio,Hardin County,14,1478,698,780
Ohio,Hardin County,15,1169,567,602
Ohio,Hardin County,16,858,363,495
Ohio,Hardin County,17,597,254,343
Ohio,Hardin County,18,573,173,400
Ohio,Harrison County,0,15543,7663,7880
Ohio,Harrison County,1,811,385,426
Ohio,Harrison County,2,893,444,449
Ohio,Harrison County,3,984,515,469
Ohio,Harrison County,4,888,459,429
Ohio,Harrison County,5,819,430,389
Ohio,Harrison County,6,728,359,369
Ohio,Harrison County,7,793,369,424
Ohio,Harrison County,8,798,403,395
Ohio,Harrison County,9,938,467,471
Ohio,Harrison County,10,1026,526,500
Ohio,Harrison County,11,1188,573,615
Ohio,Harrison County,12,1382,701,681
Ohio,Harrison County,13,1244,630,614
Ohio,Harrison County,14,912,450,462
Ohio,Harrison County,15,816,393,423
Ohio,Harrison County,16,542,259,283
Ohio,Harrison County,17,392,174,218
Ohio,Harrison County,18,389,126,263
Ohio,Henry County,0,27937,13738,14199
Ohio,Henry County,1,1719,838,881
Ohio,Henry County,2,1825,928,897
Ohio,Henry County,3,1904,957,947
Ohio,Henry County,4,1850,978,872
Ohio,Henry County,5,1575,792,783
Ohio,Henry County,6,1502,737,765
Ohio,Henry County,7,1593,781,812
Ohio,Henry County,8,1600,822,778
Ohio,Henry County,9,1685,850,835
Ohio,Henry County,10,1742,864,878
Ohio,Henry County,11,2080,1045,1035
Ohio,Henry County,12,2160,1107,1053
Ohio,Henry County,13,1792,879,913
Ohio,Henry County,14,1407,700,707
Ohio,Henry County,15,1135,524,611
Ohio,Henry County,16,902,397,505
Ohio,Henry County,17,722,307,415
Ohio,Henry County,18,744,232,512
Ohio,Highland County,0,43045,21044,22001
Ohio,Highland County,1,2589,1247,1342
Ohio,Highland County,2,2864,1472,1392
Ohio,Highland County,3,3086,1597,1489
Ohio,Highland County,4,2810,1427,1383
Ohio,Highland County,5,2446,1192,1254
Ohio,Highland County,6,2353,1178,1175
Ohio,Highland County,7,2500,1254,1246
Ohio,Highland County,8,2512,1250,1262
Ohio,Highland County,9,2818,1391,1427
Ohio,Highland County,10,2874,1457,1417
Ohio,Highland County,11,3039,1489,1550
Ohio,Highland County,12,3132,1511,1621
Ohio,Highland County,13,2681,1281,1400
Ohio,Highland County,14,2388,1147,1241
Ohio,Highland County,15,1836,865,971
Ohio,Highland County,16,1366,625,741
Ohio,Highland County,17,885,362,523
Ohio,Highland County,18,866,299,567
Ohio,Hocking County,0,28725,14286,14439
Ohio,Hocking County,1,1618,834,784
Ohio,Hocking County,2,1764,928,836
Ohio,Hocking County,3,1991,1008,983
Ohio,Hocking County,4,1901,1008,893
Ohio,Hocking County,5,1581,794,787
Ohio,Hocking County,6,1512,786,726
Ohio,Hocking County,7,1589,762,827
Ohio,Hocking County,8,1676,807,869
Ohio,Hocking County,9,1896,983,913
Ohio,Hocking County,10,1911,942,969
Ohio,Hocking County,11,2206,1079,1127
Ohio,Hocking County,12,2242,1120,1122
Ohio,Hocking County,13,1917,950,967
Ohio,Hocking County,14,1708,825,883
Ohio,Hocking County,15,1272,647,625
Ohio,Hocking County,16,907,424,483
Ohio,Hocking County,17,563,241,322
Ohio,Hocking County,18,471,148,323
Ohio,Holmes County,0,43898,21899,21999
Ohio,Holmes County,1,3983,2007,1976
Ohio,Holmes County,2,3925,1995,1930
Ohio,Holmes County,3,4188,2109,2079
Ohio,Holmes County,4,3685,1931,1754
Ohio,Holmes County,5,3105,1607,1498
Ohio,Holmes County,6,2813,1429,1384
Ohio,Holmes County,7,2495,1234,1261
Ohio,Holmes County,8,2455,1216,1239
Ohio,Holmes County,9,2364,1143,1221
Ohio,Holmes County,10,2301,1162,1139
Ohio,Holmes County,11,2589,1321,1268
Ohio,Holmes County,12,2395,1205,1190
Ohio,Holmes County,13,2129,1065,1064
Ohio,Holmes County,14,1737,847,890
Ohio,Holmes County,15,1292,614,678
Ohio,Holmes County,16,971,457,514
Ohio,Holmes County,17,758,312,446
Ohio,Holmes County,18,713,245,468
Ohio,Huron County,0,58714,28911,29803
Ohio,Huron County,1,3608,1799,1809
Ohio,Huron County,2,4064,2075,1989
Ohio,Huron County,3,4164,2102,2062
Ohio,Huron County,4,4089,2116,1973
Ohio,Huron County,5,3470,1838,1632
Ohio,Huron County,6,3341,1642,1699
Ohio,Huron County,7,3362,1676,1686
Ohio,Huron County,8,3434,1699,1735
Ohio,Huron County,9,3773,1914,1859
Ohio,Huron County,10,3879,1926,1953
Ohio,Huron County,11,4354,2119,2235
Ohio,Huron County,12,4321,2094,2227
Ohio,Huron County,13,3741,1805,1936
Ohio,Huron County,14,3095,1525,1570
Ohio,Huron County,15,2202,1036,1166
Ohio,Huron County,16,1562,706,856
Ohio,Huron County,17,1139,439,700
Ohio,Huron County,18,1116,400,716
Ohio,Jackson County,0,32748,16147,16601
Ohio,Jackson County,1,2021,1081,940
Ohio,Jackson County,2,2157,1097,1060
Ohio,Jackson County,3,2256,1207,1049
Ohio,Jackson County,4,2134,1091,1043
Ohio,Jackson County,5,1898,927,971
Ohio,Jackson County,6,2011,1055,956
Ohio,Jackson County,7,1952,927,1025
Ohio,Jackson County,8,2018,1024,994
Ohio,Jackson County,9,2149,1074,1075
Ohio,Jackson County,10,2145,1078,1067
Ohio,Jackson County,11,2262,1134,1128
Ohio,Jackson County,12,2409,1160,1249
Ohio,Jackson County,13,2192,1082,1110
Ohio,Jackson County,14,1802,845,957
Ohio,Jackson County,15,1252,553,699
Ohio,Jackson County,16,922,407,515
Ohio,Jackson County,17,604,233,371
Ohio,Jackson County,18,564,172,392
Ohio,Jefferson County,0,67694,32838,34856
Ohio,Jefferson County,1,3263,1747,1516
Ohio,Jefferson County,2,3578,1805,1773
Ohio,Jefferson County,3,3857,1968,1889
Ohio,Jefferson County,4,4475,2213,2262
Ohio,Jefferson County,5,4643,2213,2430
Ohio,Jefferson County,6,3635,1797,1838
Ohio,Jefferson County,7,3451,1775,1676
Ohio,Jefferson County,8,3417,1678,1739
Ohio,Jefferson County,9,4145,2058,2087
Ohio,Jefferson County,10,4200,2094,2106
Ohio,Jefferson County,11,5068,2452,2616
Ohio,Jefferson County,12,5535,2691,2844
Ohio,Jefferson County,13,5203,2577,2626
Ohio,Jefferson County,14,4163,2015,2148
Ohio,Jefferson County,15,3036,1382,1654
Ohio,Jefferson County,16,2487,1126,1361
Ohio,Jefferson County,17,1773,655,1118
Ohio,Jefferson County,18,1765,592,1173
Ohio,Knox County,0,61167,29982,31185
Ohio,Knox County,1,3789,1948,1841
Ohio,Knox County,2,3920,2001,1919
Ohio,Knox County,3,4115,2101,2014
Ohio,Knox County,4,4645,2350,2295
Ohio,Knox County,5,4914,2416,2498
Ohio,Knox County,6,3339,1624,1715
Ohio,Knox County,7,3283,1620,1663
Ohio,Knox County,8,3266,1654,1612
Ohio,Knox County,9,3518,1746,1772
Ohio,Knox County,10,3778,1897,1881
Ohio,Knox County,11,4276,2114,2162
Ohio,Knox County,12,4413,2167,2246
Ohio,Knox County,13,3914,1848,2066
Ohio,Knox County,14,3282,1553,1729
Ohio,Knox County,15,2452,1170,1282
Ohio,Knox County,16,1737,804,933
Ohio,Knox County,17,1247,542,705
Ohio,Knox County,18,1279,427,852
Ohio,Lake County,0,229230,111896,117334
Ohio,Lake County,1,11451,5966,5485
Ohio,Lake County,2,13158,6683,6475
Ohio,Lake County,3,14396,7364,7032
Ohio,Lake County,4,13999,7181,6818
Ohio,Lake County,5,12997,6705,6292
Ohio,Lake County,6,12789,6480,6309
Ohio,Lake County,7,13419,6749,6670
Ohio,Lake County,8,12712,6375,6337
Ohio,Lake County,9,14380,7174,7206
Ohio,Lake County,10,15927,7868,8059
Ohio,Lake County,11,18189,8905,9284
Ohio,Lake County,12,18869,9179,9690
Ohio,Lake County,13,15740,7635,8105
Ohio,Lake County,14,13043,6103,6940
Ohio,Lake County,15,9960,4535,5425
Ohio,Lake County,16,7065,2981,4084
Ohio,Lake County,17,5272,2142,3130
Ohio,Lake County,18,5864,1871,3993
Ohio,Lawrence County,0,61623,30120,31503
Ohio,Lawrence County,1,3427,1772,1655
Ohio,Lawrence County,2,3854,1946,1908
Ohio,Lawrence County,3,4062,2131,1931
Ohio,Lawrence County,4,3799,1961,1838
Ohio,Lawrence County,5,3589,1842,1747
Ohio,Lawrence County,6,3530,1786,1744
Ohio,Lawrence County,7,3725,1776,1949
Ohio,Lawrence County,8,3755,1877,1878
Ohio,Lawrence County,9,4120,1979,2141
Ohio,Lawrence County,10,4305,2159,2146
Ohio,Lawrence County,11,4399,2139,2260
Ohio,Lawrence County,12,4541,2157,2384
Ohio,Lawrence County,13,3976,1927,2049
Ohio,Lawrence County,14,3460,1609,1851
Ohio,Lawrence County,15,2722,1265,1457
Ohio,Lawrence County,16,2019,901,1118
Ohio,Lawrence County,17,1230,501,729
Ohio,Lawrence County,18,1110,392,718
Ohio,Licking County,0,169390,83020,86370
Ohio,Licking County,1,10222,5190,5032
Ohio,Licking County,2,11017,5680,5337
Ohio,Licking County,3,11603,5994,5609
Ohio,Licking County,4,11865,6029,5836
Ohio,Licking County,5,10704,5344,5360
Ohio,Licking County,6,9228,4460,4768
Ohio,Licking County,7,10036,4956,5080
Ohio,Licking County,8,9838,4844,4994
Ohio,Licking County,9,11379,5633,5746
Ohio,Licking County,10,11703,5787,5916
Ohio,Licking County,11,13108,6493,6615
Ohio,Licking County,12,12605,6135,6470
Ohio,Licking County,13,10268,5015,5253
Ohio,Licking County,14,8907,4239,4668
Ohio,Licking County,15,6552,3046,3506
Ohio,Licking County,16,4520,1965,2555
Ohio,Licking County,17,3035,1265,1770
Ohio,Licking County,18,2800,945,1855
Ohio,Logan County,0,45507,22456,23051
Ohio,Logan County,1,2731,1417,1314
Ohio,Logan County,2,3025,1531,1494
Ohio,Logan County,3,3136,1588,1548
Ohio,Logan County,4,3016,1567,1449
Ohio,Logan County,5,2602,1325,1277
Ohio,Logan County,6,2475,1217,1258
Ohio,Logan County,7,2533,1217,1316
Ohio,Logan County,8,2661,1301,1360
Ohio,Logan County,9,2841,1472,1369
Ohio,Logan County,10,2966,1432,1534
Ohio,Logan County,11,3477,1752,1725
Ohio,Logan County,12,3454,1756,1698
Ohio,Logan County,13,3081,1529,1552
Ohio,Logan County,14,2503,1195,1308
Ohio,Logan County,15,1866,884,982
Ohio,Logan County,16,1334,603,731
Ohio,Logan County,17,906,368,538
Ohio,Logan County,18,900,302,598
Ohio,Lorain County,0,304216,149933,154283
Ohio,Lorain County,1,17178,8924,8254
Ohio,Lorain County,2,19003,9799,9204
Ohio,Lorain County,3,20500,10494,10006
Ohio,Lorain County,4,20632,10586,10046
Ohio,Lorain County,5,18817,9815,9002
Ohio,Lorain County,6,16096,8268,7828
Ohio,Lorain County,7,17236,8533,8703
Ohio,Lorain County,8,18140,9042,9098
Ohio,Lorain County,9,19934,9883,10051
Ohio,Lorain County,10,20937,10581,10356
Ohio,Lorain County,11,23163,11375,11788
Ohio,Lorain County,12,22951,11258,11693
Ohio,Lorain County,13,19971,9707,10264
Ohio,Lorain County,14,16633,7917,8716
Ohio,Lorain County,15,11592,5276,6316
Ohio,Lorain County,16,8495,3754,4741
Ohio,Lorain County,17,6118,2434,3684
Ohio,Lorain County,18,6820,2287,4533
Ohio,Lucas County,0,435286,211007,224279
Ohio,Lucas County,1,27651,14119,13532
Ohio,Lucas County,2,28566,14525,14041
Ohio,Lucas County,3,28098,14466,13632
Ohio,Lucas County,4,28486,14528,13958
Ohio,Lucas County,5,31823,15907,15916
Ohio,Lucas County,6,31592,15609,15983
Ohio,Lucas County,7,27226,13472,13754
Ohio,Lucas County,8,24648,11949,12699
Ohio,Lucas County,9,27175,13248,13927
Ohio,Lucas County,10,26621,12924,13697
Ohio,Lucas County,11,30975,14879,16096
Ohio,Lucas County,12,31769,15394,16375
Ohio,Lucas County,13,27169,13001,14168
Ohio,Lucas County,14,21079,9995,11084
Ohio,Lucas County,15,14423,6421,8002
Ohio,Lucas County,16,10638,4492,6146
Ohio,Lucas County,17,8055,3086,4969
Ohio,Lucas County,18,9292,2992,6300
Ohio,Madison County,0,43918,23948,19970
Ohio,Madison County,1,2303,1206,1097
Ohio,Madison County,2,2632,1283,1349
Ohio,Madison County,3,2754,1376,1378
Ohio,Madison County,4,2660,1469,1191
Ohio,Madison County,5,2687,1600,1087
Ohio,Madison County,6,2803,1702,1101
Ohio,Madison County,7,3024,1880,1144
Ohio,Madison County,8,3085,1897,1188
Ohio,Madison County,9,3400,2051,1349
Ohio,Madison County,10,3373,1900,1473
Ohio,Madison County,11,3417,1905,1512
Ohio,Madison County,12,3151,1664,1487
Ohio,Madison County,13,2530,1235,1295
Ohio,Madison County,14,2043,1031,1012
Ohio,Madison County,15,1525,719,806
Ohio,Madison County,16,1132,496,636
Ohio,Madison County,17,748,315,433
Ohio,Madison County,18,651,219,432
Ohio,Mahoning County,0,233204,113510,119694
Ohio,Mahoning County,1,12006,6195,5811
Ohio,Mahoning County,2,12860,6609,6251
Ohio,Mahoning County,3,13984,7208,6776
Ohio,Mahoning County,4,14374,7327,7047
Ohio,Mahoning County,5,15117,7807,7310
Ohio,Mahoning County,6,13270,6903,6367
Ohio,Mahoning County,7,12779,6454,6325
Ohio,Mahoning County,8,12670,6396,6274
Ohio,Mahoning County,9,13933,6976,6957
Ohio,Mahoning County,10,14435,7273,7162
Ohio,Mahoning County,11,17206,8318,8888
Ohio,Mahoning County,12,18879,9022,9857
Ohio,Mahoning County,13,17078,8280,8798
Ohio,Mahoning County,14,13318,6386,6932
Ohio,Mahoning County,15,9732,4282,5450
Ohio,Mahoning County,16,7608,3173,4435
Ohio,Mahoning County,17,6303,2460,3843
Ohio,Mahoning County,18,7652,2441,5211
Ohio,Marion County,0,65720,34871,30849
Ohio,Marion County,1,3841,1959,1882
Ohio,Marion County,2,3671,1888,1783
Ohio,Marion County,3,3953,2058,1895
Ohio,Marion County,4,3825,2010,1815
Ohio,Marion County,5,4358,2489,1869
Ohio,Marion County,6,4294,2476,1818
Ohio,Marion County,7,4114,2383,1731
Ohio,Marion County,8,4052,2313,1739
Ohio,Marion County,9,4343,2491,1852
Ohio,Marion County,10,4620,2620,2000
Ohio,Marion County,11,5055,2851,2204
Ohio,Marion County,12,4898,2615,2283
Ohio,Marion County,13,4219,2118,2101
Ohio,Marion County,14,3569,1715,1854
Ohio,Marion County,15,2381,1071,1310
Ohio,Marion County,16,1823,824,999
Ohio,Marion County,17,1371,527,844
Ohio,Marion County,18,1333,463,870
Ohio,Medina County,0,176029,86954,89075
Ohio,Medina County,1,9270,4728,4542
Ohio,Medina County,2,11436,5803,5633
Ohio,Medina County,3,12784,6617,6167
Ohio,Medina County,4,11909,6180,5729
Ohio,Medina County,5,9547,4871,4676
Ohio,Medina County,6,8605,4321,4284
Ohio,Medina County,7,9887,4853,5034
Ohio,Medina County,8,10536,5210,5326
Ohio,Medina County,9,12431,6174,6257
Ohio,Medina County,10,13458,6645,6813
Ohio,Medina County,11,14200,6954,7246
Ohio,Medina County,12,13321,6583,6738
Ohio,Medina County,13,11338,5474,5864
Ohio,Medina County,14,9599,4657,4942
Ohio,Medina County,15,6743,3235,3508
Ohio,Medina County,16,4568,2152,2416
Ohio,Medina County,17,3076,1340,1736
Ohio,Medina County,18,3321,1157,2164
Ohio,Meigs County,0,23331,11461,11870
Ohio,Meigs County,1,1265,626,639
Ohio,Meigs County,2,1366,695,671
Ohio,Meigs County,3,1569,772,797
Ohio,Meigs County,4,1302,655,647
Ohio,Meigs County,5,1236,637,599
Ohio,Meigs County,6,1304,662,642
Ohio,Meigs County,7,1340,648,692
Ohio,Meigs County,8,1376,681,695
Ohio,Meigs County,9,1520,756,764
Ohio,Meigs County,10,1564,806,758
Ohio,Meigs County,11,1789,906,883
Ohio,Meigs County,12,1789,878,911
Ohio,Meigs County,13,1716,870,846
Ohio,Meigs County,14,1392,694,698
Ohio,Meigs County,15,1007,484,523
Ohio,Meigs County,16,761,323,438
Ohio,Meigs County,17,540,207,333
Ohio,Meigs County,18,495,161,334
Ohio,Mercer County,0,40831,20505,20326
Ohio,Mercer County,1,2662,1394,1268
Ohio,Mercer County,2,2933,1482,1451
Ohio,Mercer County,3,2909,1522,1387
Ohio,Mercer County,4,2775,1428,1347
Ohio,Mercer County,5,2506,1268,1238
Ohio,Mercer County,6,2176,1146,1030
Ohio,Mercer County,7,2366,1225,1141
Ohio,Mercer County,8,2173,1135,1038
Ohio,Mercer County,9,2253,1158,1095
Ohio,Mercer County,10,2392,1208,1184
Ohio,Mercer County,11,2977,1508,1469
Ohio,Mercer County,12,3132,1585,1547
Ohio,Mercer County,13,2709,1383,1326
Ohio,Mercer County,14,2037,1031,1006
Ohio,Mercer County,15,1541,737,804
Ohio,Mercer County,16,1214,526,688
Ohio,Mercer County,17,999,394,605
Ohio,Mercer County,18,1077,375,702
Ohio,Miami County,0,103900,51303,52597
Ohio,Miami County,1,5880,3050,2830
Ohio,Miami County,2,6724,3502,3222
Ohio,Miami County,3,7188,3605,3583
Ohio,Miami County,4,6497,3419,3078
Ohio,Miami County,5,5767,2959,2808
Ohio,Miami County,6,5921,3042,2879
Ohio,Miami County,7,6072,3040,3032
Ohio,Miami County,8,5951,2973,2978
Ohio,Miami County,9,6854,3389,3465
Ohio,Miami County,10,6851,3491,3360
Ohio,Miami County,11,7708,3744,3964
Ohio,Miami County,12,7771,3803,3968
Ohio,Miami County,13,6749,3267,3482
Ohio,Miami County,14,5945,2837,3108
Ohio,Miami County,15,4412,2081,2331
Ohio,Miami County,16,3284,1476,1808
Ohio,Miami County,17,2153,895,1258
Ohio,Miami County,18,2173,730,1443
Ohio,Monroe County,0,14465,7282,7183
Ohio,Monroe County,1,775,427,348
Ohio,Monroe County,2,828,413,415
Ohio,Monroe County,3,888,453,435
Ohio,Monroe County,4,835,445,390
Ohio,Monroe County,5,714,358,356
Ohio,Monroe County,6,685,343,342
Ohio,Monroe County,7,741,382,359
Ohio,Monroe County,8,768,386,382
Ohio,Monroe County,9,870,423,447
Ohio,Monroe County,10,940,507,433
Ohio,Monroe County,11,1068,543,525
Ohio,Monroe County,12,1100,556,544
Ohio,Monroe County,13,1112,547,565
Ohio,Monroe County,14,987,481,506
Ohio,Monroe County,15,824,416,408
Ohio,Monroe County,16,589,307,282
Ohio,Monroe County,17,384,164,220
Ohio,Monroe County,18,357,131,226
Ohio,Montgomery County,0,533116,256410,276706
Ohio,Montgomery County,1,32870,16695,16175
Ohio,Montgomery County,2,32941,16848,16093
Ohio,Montgomery County,3,33566,17198,16368
Ohio,Montgomery County,4,33847,17310,16537
Ohio,Montgomery County,5,37025,18303,18722
Ohio,Montgomery County,6,35654,17688,17966
Ohio,Montgomery County,7,33936,16574,17362
Ohio,Montgomery County,8,29820,14551,15269
Ohio,Montgomery County,9,31619,15310,16309
Ohio,Montgomery County,10,33512,16239,17273
Ohio,Montgomery County,11,38274,18667,19607
Ohio,Montgomery County,12,38014,18162,19852
Ohio,Montgomery County,13,33432,15647,17785
Ohio,Montgomery County,14,27914,12675,15239
Ohio,Montgomery County,15,20210,8977,11233
Ohio,Montgomery County,16,15561,6544,9017
Ohio,Montgomery County,17,11837,4720,7117
Ohio,Montgomery County,18,13084,4302,8782
Ohio,Morgan County,0,14843,7391,7452
Ohio,Morgan County,1,764,373,391
Ohio,Morgan County,2,902,470,432
Ohio,Morgan County,3,944,501,443
Ohio,Morgan County,4,941,511,430
Ohio,Morgan County,5,826,428,398
Ohio,Morgan County,6,727,372,355
Ohio,Morgan County,7,820,402,418
Ohio,Morgan County,8,792,374,418
Ohio,Morgan County,9,886,457,429
Ohio,Morgan County,10,946,473,473
Ohio,Morgan County,11,1192,579,613
Ohio,Morgan County,12,1130,558,572
Ohio,Morgan County,13,1054,544,510
Ohio,Morgan County,14,945,473,472
Ohio,Morgan County,15,672,340,332
Ohio,Morgan County,16,572,261,311
Ohio,Morgan County,17,399,171,228
Ohio,Morgan County,18,331,104,227
Ohio,Morrow County,0,35152,17665,17487
Ohio,Morrow County,1,2029,1057,972
Ohio,Morrow County,2,2307,1199,1108
Ohio,Morrow County,3,2599,1328,1271
Ohio,Morrow County,4,2338,1263,1075
Ohio,Morrow County,5,1893,1015,878
Ohio,Morrow County,6,1750,869,881
Ohio,Morrow County,7,1989,993,996
Ohio,Morrow County,8,2110,1064,1046
Ohio,Morrow County,9,2432,1226,1206
Ohio,Morrow County,10,2359,1206,1153
Ohio,Morrow County,11,2730,1381,1349
Ohio,Morrow County,12,2812,1389,1423
Ohio,Morrow County,13,2259,1137,1122
Ohio,Morrow County,14,1856,893,963
Ohio,Morrow County,15,1413,673,740
Ohio,Morrow County,16,1062,502,560
Ohio,Morrow County,17,627,268,359
Ohio,Morrow County,18,587,202,385
Ohio,Muskingum County,0,85818,41565,44253
Ohio,Muskingum County,1,5154,2570,2584
Ohio,Muskingum County,2,5405,2717,2688
Ohio,Muskingum County,3,5678,2949,2729
Ohio,Muskingum County,4,5853,2956,2897
Ohio,Muskingum County,5,5818,2914,2904
Ohio,Muskingum County,6,4923,2430,2493
Ohio,Muskingum County,7,5000,2454,2546
Ohio,Muskingum County,8,4831,2408,2423
Ohio,Muskingum County,9,5318,2568,2750
Ohio,Muskingum County,10,5643,2801,2842
Ohio,Muskingum County,11,6151,2967,3184
Ohio,Muskingum County,12,6288,3135,3153
Ohio,Muskingum County,13,5439,2580,2859
Ohio,Muskingum County,14,4549,2131,2418
Ohio,Muskingum County,15,3404,1552,1852
Ohio,Muskingum County,16,2524,1075,1449
Ohio,Muskingum County,17,1867,735,1132
Ohio,Muskingum County,18,1973,623,1350
Ohio,Noble County,0,14363,8377,5986
Ohio,Noble County,1,679,349,330
Ohio,Noble County,2,718,369,349
Ohio,Noble County,3,747,359,388
Ohio,Noble County,4,715,363,352
Ohio,Noble County,5,675,346,329
Ohio,Noble County,6,672,321,351
Ohio,Noble County,7,664,352,312
Ohio,Noble County,8,584,272,312
Ohio,Noble County,9,684,334,350
Ohio,Noble County,10,832,468,364
Ohio,Noble County,11,1076,644,432
Ohio,Noble County,12,1176,747,429
Ohio,Noble County,13,1727,1319,408
Ohio,Noble County,14,1088,755,333
Ohio,Noble County,15,1042,765,277
Ohio,Noble County,16,595,342,253
Ohio,Noble County,17,374,174,200
Ohio,Noble County,18,315,98,217
Ohio,Ottawa County,0,41154,20380,20774
Ohio,Ottawa County,1,1816,902,914
Ohio,Ottawa County,2,2220,1104,1116
Ohio,Ottawa County,3,2463,1258,1205
Ohio,Ottawa County,4,2362,1234,1128
Ohio,Ottawa County,5,2014,1019,995
Ohio,Ottawa County,6,1838,944,894
Ohio,Ottawa County,7,1946,984,962
Ohio,Ottawa County,8,2028,1017,1011
Ohio,Ottawa County,9,2379,1210,1169
Ohio,Ottawa County,10,2581,1267,1314
Ohio,Ottawa County,11,3346,1677,1669
Ohio,Ottawa County,12,3638,1812,1826
Ohio,Ottawa County,13,3424,1641,1783
Ohio,Ottawa County,14,3030,1548,1482
Ohio,Ottawa County,15,2338,1182,1156
Ohio,Ottawa County,16,1552,732,820
Ohio,Ottawa County,17,1048,465,583
Ohio,Ottawa County,18,1131,384,747
Ohio,Paulding County,0,18989,9456,9533
Ohio,Paulding County,1,1078,529,549
Ohio,Paulding County,2,1333,679,654
Ohio,Paulding County,3,1321,685,636
Ohio,Paulding County,4,1241,640,601
Ohio,Paulding County,5,1005,532,473
Ohio,Paulding County,6,989,499,490
Ohio,Paulding County,7,1094,558,536
Ohio,Paulding County,8,1063,532,531
Ohio,Paulding County,9,1168,607,561
Ohio,Paulding County,10,1224,612,612
Ohio,Paulding County,11,1476,736,740
Ohio,Paulding County,12,1428,724,704
Ohio,Paulding County,13,1337,691,646
Ohio,Paulding County,14,1064,518,546
Ohio,Paulding County,15,814,380,434
Ohio,Paulding County,16,547,252,295
Ohio,Paulding County,17,422,162,260
Ohio,Paulding County,18,385,120,265
Ohio,Perry County,0,35812,17903,17909
Ohio,Perry County,1,2103,1085,1018
Ohio,Perry County,2,2398,1206,1192
Ohio,Perry County,3,2538,1315,1223
Ohio,Perry County,4,2453,1299,1154
Ohio,Perry County,5,2121,1076,1045
Ohio,Perry County,6,2051,1056,995
Ohio,Perry County,7,2109,1047,1062
Ohio,Perry County,8,2068,1004,1064
Ohio,Perry County,9,2346,1187,1159
Ohio,Perry County,10,2531,1287,1244
Ohio,Perry County,11,2714,1329,1385
Ohio,Perry County,12,2743,1445,1298
Ohio,Perry County,13,2267,1154,1113
Ohio,Perry County,14,1978,953,1025
Ohio,Perry County,15,1356,660,696
Ohio,Perry County,16,907,415,492
Ohio,Perry County,17,603,226,377
Ohio,Perry County,18,526,159,367
Ohio,Pickaway County,0,56876,30043,26833
Ohio,Pickaway County,1,3100,1589,1511
Ohio,Pickaway County,2,3392,1740,1652
Ohio,Pickaway County,3,3702,1881,1821
Ohio,Pickaway County,4,3853,2078,1775
Ohio,Pickaway County,5,3793,2280,1513
Ohio,Pickaway County,6,3616,2130,1486
Ohio,Pickaway County,7,3702,2101,1601
Ohio,Pickaway County,8,3854,2150,1704
Ohio,Pickaway County,9,4056,2217,1839
Ohio,Pickaway County,10,4155,2293,1862
Ohio,Pickaway County,11,4182,2252,1930
Ohio,Pickaway County,12,3959,1989,1970
Ohio,Pickaway County,13,3247,1613,1634
Ohio,Pickaway County,14,2761,1341,1420
Ohio,Pickaway County,15,2063,962,1101
Ohio,Pickaway County,16,1542,710,832
Ohio,Pickaway County,17,1004,419,585
Ohio,Pickaway County,18,895,298,597
Ohio,Pike County,0,28256,14060,14196
Ohio,Pike County,1,1662,899,763
Ohio,Pike County,2,1892,999,893
Ohio,Pike County,3,2004,1088,916
Ohio,Pike County,4,1805,922,883
Ohio,Pike County,5,1679,859,820
Ohio,Pike County,6,1489,734,755
Ohio,Pike County,7,1617,792,825
Ohio,Pike County,8,1727,846,881
Ohio,Pike County,9,1894,917,977
Ohio,Pike County,10,1906,951,955
Ohio,Pike County,11,2110,1076,1034
Ohio,Pike County,12,2123,1056,1067
Ohio,Pike County,13,1758,909,849
Ohio,Pike County,14,1494,721,773
Ohio,Pike County,15,1093,491,602
Ohio,Pike County,16,776,330,446
Ohio,Pike County,17,606,244,362
Ohio,Pike County,18,621,226,395
Ohio,Portage County,0,161882,79280,82602
Ohio,Portage County,1,7118,3698,3420
Ohio,Portage County,2,8559,4367,4192
Ohio,Portage County,3,9353,4786,4567
Ohio,Portage County,4,13874,6540,7334
Ohio,Portage County,5,19161,9157,10004
Ohio,Portage County,6,9386,4893,4493
Ohio,Portage County,7,8560,4369,4191
Ohio,Portage County,8,8363,4173,4190
Ohio,Portage County,9,9478,4664,4814
Ohio,Portage County,10,10398,5084,5314
Ohio,Portage County,11,12023,5890,6133
Ohio,Portage County,12,11895,5896,5999
Ohio,Portage County,13,9988,4875,5113
Ohio,Portage County,14,8026,3880,4146
Ohio,Portage County,15,6032,2874,3158
Ohio,Portage County,16,4116,1905,2211
Ohio,Portage County,17,2795,1194,1601
Ohio,Portage County,18,2757,1035,1722
Ohio,Preble County,0,41586,20627,20959
Ohio,Preble County,1,2292,1207,1085
Ohio,Preble County,2,2745,1398,1347
Ohio,Preble County,3,2872,1467,1405
Ohio,Preble County,4,2698,1424,1274
Ohio,Preble County,5,2248,1169,1079
Ohio,Preble County,6,2254,1146,1108
Ohio,Preble County,7,2372,1172,1200
Ohio,Preble County,8,2358,1174,1184
Ohio,Preble County,9,2605,1298,1307
Ohio,Preble County,10,2788,1408,1380
Ohio,Preble County,11,3139,1524,1615
Ohio,Preble County,12,3193,1567,1626
Ohio,Preble County,13,2887,1452,1435
Ohio,Preble County,14,2426,1154,1272
Ohio,Preble County,15,1720,808,912
Ohio,Preble County,16,1348,637,711
Ohio,Preble County,17,837,342,495
Ohio,Preble County,18,804,280,524
Ohio,Putnam County,0,34171,17137,17034
Ohio,Putnam County,1,2303,1218,1085
Ohio,Putnam County,2,2516,1302,1214
Ohio,Putnam County,3,2455,1261,1194
Ohio,Putnam County,4,2309,1164,1145
Ohio,Putnam County,5,2091,1064,1027
Ohio,Putnam County,6,1732,875,857
Ohio,Putnam County,7,2004,1004,1000
Ohio,Putnam County,8,1860,937,923
Ohio,Putnam County,9,1996,1026,970
Ohio,Putnam County,10,2187,1130,1057
Ohio,Putnam County,11,2619,1309,1310
Ohio,Putnam County,12,2632,1365,1267
Ohio,Putnam County,13,2180,1110,1070
Ohio,Putnam County,14,1529,774,755
Ohio,Putnam County,15,1232,592,640
Ohio,Putnam County,16,979,412,567
Ohio,Putnam County,17,760,324,436
Ohio,Putnam County,18,787,270,517
Ohio,Richland County,0,121942,61919,60023
Ohio,Richland County,1,6933,3583,3350
Ohio,Richland County,2,7388,3746,3642
Ohio,Richland County,3,7627,3923,3704
Ohio,Richland County,4,7444,3938,3506
Ohio,Richland County,5,7764,4354,3410
Ohio,Richland County,6,7232,4050,3182
Ohio,Richland County,7,7260,4002,3258
Ohio,Richland County,8,7168,3918,3250
Ohio,Richland County,9,7419,3952,3467
Ohio,Richland County,10,7822,4094,3728
Ohio,Richland County,11,8793,4465,4328
Ohio,Richland County,12,9059,4492,4567
Ohio,Richland County,13,7999,3846,4153
Ohio,Richland County,14,6882,3208,3674
Ohio,Richland County,15,5079,2334,2745
Ohio,Richland County,16,4035,1759,2276
Ohio,Richland County,17,2999,1189,1810
Ohio,Richland County,18,3039,1066,1973
Ohio,Ross County,0,77159,40531,36628
Ohio,Ross County,1,4198,2184,2014
Ohio,Ross County,2,4672,2340,2332
Ohio,Ross County,3,4832,2519,2313
Ohio,Ross County,4,4654,2473,2181
Ohio,Ross County,5,4540,2463,2077
Ohio,Ross County,6,4644,2663,1981
Ohio,Ross County,7,4981,2831,2150
Ohio,Ross County,8,5053,2809,2244
Ohio,Ross County,9,5454,3097,2357
Ohio,Ross County,10,5694,3201,2493
Ohio,Ross County,11,6011,3227,2784
Ohio,Ross County,12,5894,3078,2816
Ohio,Ross County,13,4806,2416,2390
Ohio,Ross County,14,3886,1878,2008
Ohio,Ross County,15,3043,1388,1655
Ohio,Ross County,16,2187,994,1193
Ohio,Ross County,17,1384,531,853
Ohio,Ross County,18,1226,439,787
Ohio,Sandusky County,0,60179,29626,30553
Ohio,Sandusky County,1,3552,1820,1732
Ohio,Sandusky County,2,3881,1953,1928
Ohio,Sandusky County,3,4119,2133,1986
Ohio,Sandusky County,4,3811,1961,1850
Ohio,Sandusky County,5,3471,1720,1751
Ohio,Sandusky County,6,3265,1662,1603
Ohio,Sandusky County,7,3533,1764,1769
Ohio,Sandusky County,8,3459,1750,1709
Ohio,Sandusky County,9,3754,1875,1879
Ohio,Sandusky County,10,3903,1970,1933
Ohio,Sandusky County,11,4445,2240,2205
Ohio,Sandusky County,12,4723,2317,2406
Ohio,Sandusky County,13,4067,1994,2073
Ohio,Sandusky County,14,3245,1598,1647
Ohio,Sandusky County,15,2361,1078,1283
Ohio,Sandusky County,16,1812,803,1009
Ohio,Sandusky County,17,1320,509,811
Ohio,Sandusky County,18,1458,479,979
Ohio,Scioto County,0,77258,38045,39213
Ohio,Scioto County,1,4393,2203,2190
Ohio,Scioto County,2,4741,2414,2327
Ohio,Scioto County,3,4840,2518,2322
Ohio,Scioto County,4,5018,2588,2430
Ohio,Scioto County,5,5149,2707,2442
Ohio,Scioto County,6,4950,2645,2305
Ohio,Scioto County,7,4736,2451,2285
Ohio,Scioto County,8,4687,2373,2314
Ohio,Scioto County,9,4997,2495,2502
Ohio,Scioto County,10,4893,2394,2499
Ohio,Scioto County,11,5333,2584,2749
Ohio,Scioto County,12,5636,2696,2940
Ohio,Scioto County,13,4911,2393,2518
Ohio,Scioto County,14,4054,1939,2115
Ohio,Scioto County,15,3058,1376,1682
Ohio,Scioto County,16,2455,1027,1428
Ohio,Scioto County,17,1723,690,1033
Ohio,Scioto County,18,1684,552,1132
Ohio,Seneca County,0,55669,27827,27842
Ohio,Seneca County,1,2837,1462,1375
Ohio,Seneca County,2,3564,1864,1700
Ohio,Seneca County,3,3794,1952,1842
Ohio,Seneca County,4,4190,2178,2012
Ohio,Seneca County,5,4103,2145,1958
Ohio,Seneca County,6,3191,1661,1530
Ohio,Seneca County,7,3163,1666,1497
Ohio,Seneca County,8,3208,1608,1600
Ohio,Seneca County,9,3184,1642,1542
Ohio,Seneca County,10,3349,1691,1658
Ohio,Seneca County,11,4043,2038,2005
Ohio,Seneca County,12,4194,2133,2061
Ohio,Seneca County,13,3770,1880,1890
Ohio,Seneca County,14,2864,1389,1475
Ohio,Seneca County,15,2041,951,1090
Ohio,Seneca County,16,1542,680,862
Ohio,Seneca County,17,1242,477,765
Ohio,Seneca County,18,1390,410,980
Ohio,Shelby County,0,48951,24593,24358
Ohio,Shelby County,1,3135,1633,1502
Ohio,Shelby County,2,3496,1831,1665
Ohio,Shelby County,3,3876,2007,1869
Ohio,Shelby County,4,3362,1758,1604
Ohio,Shelby County,5,2933,1469,1464
Ohio,Shelby County,6,2572,1281,1291
Ohio,Shelby County,7,2748,1412,1336
Ohio,Shelby County,8,2841,1415,1426
Ohio,Shelby County,9,3111,1566,1545
Ohio,Shelby County,10,3376,1751,1625
Ohio,Shelby County,11,3620,1857,1763
Ohio,Shelby County,12,3606,1846,1760
Ohio,Shelby County,13,3046,1537,1509
Ohio,Shelby County,14,2364,1153,1211
Ohio,Shelby County,15,1717,794,923
Ohio,Shelby County,16,1222,551,671
Ohio,Shelby County,17,943,396,547
Ohio,Shelby County,18,983,336,647
Ohio,Stark County,0,375736,182325,193411
Ohio,Stark County,1,20546,10556,9990
Ohio,Stark County,2,22593,11519,11074
Ohio,Stark County,3,24005,12264,11741
Ohio,Stark County,4,24706,12797,11909
Ohio,Stark County,5,24193,12036,12157
Ohio,Stark County,6,21852,10867,10985
Ohio,Stark County,7,21704,10673,11031
Ohio,Stark County,8,20638,10167,10471
Ohio,Stark County,9,22895,11186,11709
Ohio,Stark County,10,24460,12055,12405
Ohio,Stark County,11,27572,13418,14154
Ohio,Stark County,12,28757,13936,14821
Ohio,Stark County,13,25339,12076,13263
Ohio,Stark County,14,20978,9909,11069
Ohio,Stark County,15,15301,6947,8354
Ohio,Stark County,16,11536,5032,6504
Ohio,Stark County,17,8566,3484,5082
Ohio,Stark County,18,10095,3403,6692
Ohio,Summit County,0,541943,262606,279337
Ohio,Summit County,1,30971,15793,15178
Ohio,Summit County,2,31762,16126,15636
Ohio,Summit County,3,33548,17107,16441
Ohio,Summit County,4,34926,18000,16926
Ohio,Summit County,5,35088,17478,17610
Ohio,Summit County,6,35615,17925,17690
Ohio,Summit County,7,33146,16371,16775
Ohio,Summit County,8,30988,15152,15836
Ohio,Summit County,9,33681,16524,17157
Ohio,Summit County,10,36293,17741,18552
Ohio,Summit County,11,40660,19692,20968
Ohio,Summit County,12,42002,20250,21752
Ohio,Summit County,13,35532,17066,18466
Ohio,Summit County,14,28736,13426,15310
Ohio,Summit County,15,19432,8675,10757
Ohio,Summit County,16,14913,6344,8569
Ohio,Summit County,17,11346,4561,6785
Ohio,Summit County,18,13304,4375,8929
Ohio,Trumbull County,0,205175,100212,104963
Ohio,Trumbull County,1,10580,5427,5153
Ohio,Trumbull County,2,11693,5959,5734
Ohio,Trumbull County,3,12648,6518,6130
Ohio,Trumbull County,4,12426,6335,6091
Ohio,Trumbull County,5,12330,6367,5963
Ohio,Trumbull County,6,11417,5899,5518
Ohio,Trumbull County,7,11041,5452,5589
Ohio,Trumbull County,8,11041,5597,5444
Ohio,Trumbull County,9,12347,6126,6221
Ohio,Trumbull County,10,13394,6621,6773
Ohio,Trumbull County,11,15304,7399,7905
Ohio,Trumbull County,12,16230,7924,8306
Ohio,Trumbull County,13,15015,7136,7879
Ohio,Trumbull County,14,12557,5968,6589
Ohio,Trumbull County,15,9278,4291,4987
Ohio,Trumbull County,16,6918,3112,3806
Ohio,Trumbull County,17,5198,2118,3080
Ohio,Trumbull County,18,5758,1963,3795
Ohio,Tuscarawas County,0,92788,45867,46921
Ohio,Tuscarawas County,1,5477,2916,2561
Ohio,Tuscarawas County,2,5799,2966,2833
Ohio,Tuscarawas County,3,6172,3185,2987
Ohio,Tuscarawas County,4,5844,3086,2758
Ohio,Tuscarawas County,5,5231,2660,2571
Ohio,Tuscarawas County,6,5289,2674,2615
Ohio,Tuscarawas County,7,5552,2778,2774
Ohio,Tuscarawas County,8,5327,2741,2586
Ohio,Tuscarawas County,9,5682,2892,2790
Ohio,Tuscarawas County,10,5746,2861,2885
Ohio,Tuscarawas County,11,6814,3394,3420
Ohio,Tuscarawas County,12,7007,3474,3533
Ohio,Tuscarawas County,13,6230,2997,3233
Ohio,Tuscarawas County,14,5161,2498,2663
Ohio,Tuscarawas County,15,3833,1745,2088
Ohio,Tuscarawas County,16,2967,1267,1700
Ohio,Tuscarawas County,17,2171,896,1275
Ohio,Tuscarawas County,18,2486,837,1649
Ohio,Union County,0,53776,25558,28218
Ohio,Union County,1,3113,1595,1518
Ohio,Union County,2,3950,1927,2023
Ohio,Union County,3,4109,2175,1934
Ohio,Union County,4,3747,1916,1831
Ohio,Union County,5,3142,1387,1755
Ohio,Union County,6,3115,1272,1843
Ohio,Union County,7,3603,1586,2017
Ohio,Union County,8,4036,1789,2247
Ohio,Union County,9,4374,2036,2338
Ohio,Union County,10,4151,2018,2133
Ohio,Union County,11,4147,2025,2122
Ohio,Union County,12,3535,1734,1801
Ohio,Union County,13,2702,1364,1338
Ohio,Union County,14,2166,1015,1151
Ohio,Union County,15,1498,682,816
Ohio,Union County,16,968,458,510
Ohio,Union County,17,710,283,427
Ohio,Union County,18,710,296,414
Ohio,Van Wert County,0,28462,13869,14593
Ohio,Van Wert County,1,1670,839,831
Ohio,Van Wert County,2,1890,938,952
Ohio,Van Wert County,3,1905,965,940
Ohio,Van Wert County,4,1861,963,898
Ohio,Van Wert County,5,1680,830,850
Ohio,Van Wert County,6,1454,714,740
Ohio,Van Wert County,7,1654,821,833
Ohio,Van Wert County,8,1642,841,801
Ohio,Van Wert County,9,1702,867,835
Ohio,Van Wert County,10,1739,879,860
Ohio,Van Wert County,11,2109,1016,1093
Ohio,Van Wert County,12,2169,1077,1092
Ohio,Van Wert County,13,1862,944,918
Ohio,Van Wert County,14,1530,703,827
Ohio,Van Wert County,15,1205,561,644
Ohio,Van Wert County,16,881,380,501
Ohio,Van Wert County,17,670,264,406
Ohio,Van Wert County,18,839,267,572
Ohio,Vinton County,0,13234,6563,6671
Ohio,Vinton County,1,745,378,367
Ohio,Vinton County,2,831,425,406
Ohio,Vinton County,3,948,463,485
Ohio,Vinton County,4,844,421,423
Ohio,Vinton County,5,791,420,371
Ohio,Vinton County,6,712,373,339
Ohio,Vinton County,7,707,335,372
Ohio,Vinton County,8,830,436,394
Ohio,Vinton County,9,866,416,450
Ohio,Vinton County,10,884,433,451
Ohio,Vinton County,11,1047,525,522
Ohio,Vinton County,12,1065,533,532
Ohio,Vinton County,13,922,451,471
Ohio,Vinton County,14,712,360,352
Ohio,Vinton County,15,528,269,259
Ohio,Vinton County,16,385,175,210
Ohio,Vinton County,17,230,94,136
Ohio,Vinton County,18,187,56,131
Ohio,Warren County,0,221659,111215,110444
Ohio,Warren County,1,13078,6662,6416
Ohio,Warren County,2,15761,8146,7615
Ohio,Warren County,3,18072,9334,8738
Ohio,Warren County,4,15603,8090,7513
Ohio,Warren County,5,11920,6506,5414
Ohio,Warren County,6,11392,6092,5300
Ohio,Warren County,7,13437,6772,6665
Ohio,Warren County,8,14579,7260,7319
Ohio,Warren County,9,16953,8551,8402
Ohio,Warren County,10,17289,8676,8613
Ohio,Warren County,11,17563,8864,8699
Ohio,Warren County,12,15183,7521,7662
Ohio,Warren County,13,11948,5793,6155
Ohio,Warren County,14,9960,4797,5163
Ohio,Warren County,15,7031,3282,3749
Ohio,Warren County,16,5079,2266,2813
Ohio,Warren County,17,3356,1406,1950
Ohio,Warren County,18,3455,1197,2258
Ohio,Washington County,0,61213,30032,31181
Ohio,Washington County,1,3086,1605,1481
Ohio,Washington County,2,3301,1678,1623
Ohio,Washington County,3,3666,1892,1774
Ohio,Washington County,4,3883,1988,1895
Ohio,Washington County,5,3958,1982,1976
Ohio,Washington County,6,3245,1639,1606
Ohio,Washington County,7,3435,1711,1724
Ohio,Washington County,8,3270,1614,1656
Ohio,Washington County,9,3709,1778,1931
Ohio,Washington County,10,3911,1965,1946
Ohio,Washington County,11,4609,2234,2375
Ohio,Washington County,12,4924,2450,2474
Ohio,Washington County,13,4428,2183,2245
Ohio,Washington County,14,3705,1783,1922
Ohio,Washington County,15,2934,1365,1569
Ohio,Washington County,16,2182,1024,1158
Ohio,Washington County,17,1490,624,866
Ohio,Washington County,18,1477,517,960
Ohio,Wayne County,0,115537,57243,58294
Ohio,Wayne County,1,7518,3893,3625
Ohio,Wayne County,2,7880,4065,3815
Ohio,Wayne County,3,8128,4207,3921
Ohio,Wayne County,4,8339,4288,4051
Ohio,Wayne County,5,8202,4184,4018
Ohio,Wayne County,6,6533,3335,3198
Ohio,Wayne County,7,6521,3307,3214
Ohio,Wayne County,8,6335,3139,3196
Ohio,Wayne County,9,6765,3368,3397
Ohio,Wayne County,10,6855,3342,3513
Ohio,Wayne County,11,8295,4165,4130
Ohio,Wayne County,12,8210,4080,4130
Ohio,Wayne County,13,7245,3542,3703
Ohio,Wayne County,14,5960,2866,3094
Ohio,Wayne County,15,4432,2091,2341
Ohio,Wayne County,16,3387,1516,1871
Ohio,Wayne County,17,2455,1017,1438
Ohio,Wayne County,18,2477,838,1639
Ohio,Williams County,0,37291,18541,18750
Ohio,Williams County,1,2157,1087,1070
Ohio,Williams County,2,2337,1141,1196
Ohio,Williams County,3,2557,1311,1246
Ohio,Williams County,4,2336,1191,1145
Ohio,Williams County,5,2173,1149,1024
Ohio,Williams County,6,2085,1114,971
Ohio,Williams County,7,2174,1109,1065
Ohio,Williams County,8,2205,1130,1075
Ohio,Williams County,9,2250,1167,1083
Ohio,Williams County,10,2349,1202,1147
Ohio,Williams County,11,2819,1399,1420
Ohio,Williams County,12,2918,1469,1449
Ohio,Williams County,13,2426,1190,1236
Ohio,Williams County,14,1971,963,1008
Ohio,Williams County,15,1597,732,865
Ohio,Williams County,16,1154,546,608
Ohio,Williams County,17,825,332,493
Ohio,Williams County,18,958,309,649
Ohio,Wood County,0,129590,63870,65720
Ohio,Wood County,1,6975,3617,3358
Ohio,Wood County,2,7316,3775,3541
Ohio,Wood County,3,7689,3961,3728
Ohio,Wood County,4,11609,5580,6029
Ohio,Wood County,5,15755,7839,7916
Ohio,Wood County,6,8281,4369,3912
Ohio,Wood County,7,7549,3887,3662
Ohio,Wood County,8,6981,3522,3459
Ohio,Wood County,9,7578,3818,3760
Ohio,Wood County,10,7348,3644,3704
Ohio,Wood County,11,8339,4064,4275
Ohio,Wood County,12,8567,4192,4375
Ohio,Wood County,13,7590,3705,3885
Ohio,Wood County,14,5967,2843,3124
Ohio,Wood County,15,4173,1910,2263
Ohio,Wood County,16,3036,1322,1714
Ohio,Wood County,17,2356,979,1377
Ohio,Wood County,18,2481,843,1638
Ohio,Wyandot County,0,22353,11024,11329
Ohio,Wyandot County,1,1339,647,692
Ohio,Wyandot County,2,1448,755,693
Ohio,Wyandot County,3,1504,776,728
Ohio,Wyandot County,4,1449,760,689
Ohio,Wyandot County,5,1221,625,596
Ohio,Wyandot County,6,1170,593,577
Ohio,Wyandot County,7,1332,667,665
Ohio,Wyandot County,8,1293,668,625
Ohio,Wyandot County,9,1425,720,705
Ohio,Wyandot County,10,1449,720,729
Ohio,Wyandot County,11,1575,802,773
Ohio,Wyandot County,12,1676,820,856
Ohio,Wyandot County,13,1466,749,717
Ohio,Wyandot County,14,1183,554,629
Ohio,Wyandot County,15,897,439,458
Ohio,Wyandot County,16,750,323,427
Ohio,Wyandot County,17,558,209,349
Ohio,Wyandot County,18,618,197,421
Oklahoma,Adair County,0,22186,11159,11027
Oklahoma,Adair County,1,1505,822,683
Oklahoma,Adair County,2,1698,861,837
Oklahoma,Adair County,3,1701,898,803
Oklahoma,Adair County,4,1594,844,750
Oklahoma,Adair County,5,1448,705,743
Oklahoma,Adair County,6,1205,599,606
Oklahoma,Adair County,7,1331,653,678
Oklahoma,Adair County,8,1333,681,652
Oklahoma,Adair County,9,1419,707,712
Oklahoma,Adair County,10,1430,725,705
Oklahoma,Adair County,11,1574,799,775
Oklahoma,Adair County,12,1439,712,727
Oklahoma,Adair County,13,1290,635,655
Oklahoma,Adair County,14,1119,563,556
Oklahoma,Adair County,15,869,428,441
Oklahoma,Adair County,16,576,281,295
Oklahoma,Adair County,17,384,158,226
Oklahoma,Adair County,18,271,88,183
Oklahoma,Alfalfa County,0,5790,3482,2308
Oklahoma,Alfalfa County,1,313,176,137
Oklahoma,Alfalfa County,2,308,176,132
Oklahoma,Alfalfa County,3,305,167,138
Oklahoma,Alfalfa County,4,311,162,149
Oklahoma,Alfalfa County,5,262,151,111
Oklahoma,Alfalfa County,6,309,171,138
Oklahoma,Alfalfa County,7,325,195,130
Oklahoma,Alfalfa County,8,426,302,124
Oklahoma,Alfalfa County,9,441,333,108
Oklahoma,Alfalfa County,10,451,319,132
Oklahoma,Alfalfa County,11,509,342,167
Oklahoma,Alfalfa County,12,408,249,159
Oklahoma,Alfalfa County,13,389,232,157
Oklahoma,Alfalfa County,14,290,161,129
Oklahoma,Alfalfa County,15,256,123,133
Oklahoma,Alfalfa County,16,217,106,111
Oklahoma,Alfalfa County,17,141,68,73
Oklahoma,Alfalfa County,18,129,49,80
Oklahoma,Atoka County,0,13796,7210,6586
Oklahoma,Atoka County,1,776,429,347
Oklahoma,Atoka County,2,872,469,403
Oklahoma,Atoka County,3,890,437,453
Oklahoma,Atoka County,4,824,432,392
Oklahoma,Atoka County,5,861,475,386
Oklahoma,Atoka County,6,870,508,362
Oklahoma,Atoka County,7,871,498,373
Oklahoma,Atoka County,8,815,488,327
Oklahoma,Atoka County,9,835,443,392
Oklahoma,Atoka County,10,830,419,411
Oklahoma,Atoka County,11,983,526,457
Oklahoma,Atoka County,12,979,491,488
Oklahoma,Atoka County,13,907,450,457
Oklahoma,Atoka County,14,809,382,427
Oklahoma,Atoka County,15,661,308,353
Oklahoma,Atoka County,16,466,215,251
Oklahoma,Atoka County,17,306,142,164
Oklahoma,Atoka County,18,241,98,143
Oklahoma,Beaver County,0,5486,2742,2744
Oklahoma,Beaver County,1,299,141,158
Oklahoma,Beaver County,2,419,224,195
Oklahoma,Beaver County,3,419,203,216
Oklahoma,Beaver County,4,382,199,183
Oklahoma,Beaver County,5,314,166,148
Oklahoma,Beaver County,6,265,135,130
Oklahoma,Beaver County,7,306,145,161
Oklahoma,Beaver County,8,312,158,154
Oklahoma,Beaver County,9,322,158,164
Oklahoma,Beaver County,10,329,174,155
Oklahoma,Beaver County,11,413,183,230
Oklahoma,Beaver County,12,398,217,181
Oklahoma,Beaver County,13,367,188,179
Oklahoma,Beaver County,14,297,146,151
Oklahoma,Beaver County,15,219,115,104
Oklahoma,Beaver County,16,168,73,95
Oklahoma,Beaver County,17,120,58,62
Oklahoma,Beaver County,18,137,59,78
Oklahoma,Beckham County,0,23691,12669,11022
Oklahoma,Beckham County,1,1892,909,983
Oklahoma,Beckham County,2,1766,928,838
Oklahoma,Beckham County,3,1486,770,716
Oklahoma,Beckham County,4,1395,725,670
Oklahoma,Beckham County,5,1759,1065,694
Oklahoma,Beckham County,6,1955,1165,790
Oklahoma,Beckham County,7,1916,1147,769
Oklahoma,Beckham County,8,1537,896,641
Oklahoma,Beckham County,9,1393,793,600
Oklahoma,Beckham County,10,1362,777,585
Oklahoma,Beckham County,11,1563,830,733
Oklahoma,Beckham County,12,1521,790,731
Oklahoma,Beckham County,13,1242,629,613
Oklahoma,Beckham County,14,845,399,446
Oklahoma,Beckham County,15,716,331,385
Oklahoma,Beckham County,16,538,226,312
Oklahoma,Beckham County,17,401,150,251
Oklahoma,Beckham County,18,404,139,265
Oklahoma,Blaine County,0,9917,4938,4979
Oklahoma,Blaine County,1,810,459,351
Oklahoma,Blaine County,2,760,398,362
Oklahoma,Blaine County,3,661,325,336
Oklahoma,Blaine County,4,616,324,292
Oklahoma,Blaine County,5,588,288,300
Oklahoma,Blaine County,6,493,250,243
Oklahoma,Blaine County,7,544,261,283
Oklahoma,Blaine County,8,503,254,249
Oklahoma,Blaine County,9,511,242,269
Oklahoma,Blaine County,10,549,295,254
Oklahoma,Blaine County,11,713,364,349
Oklahoma,Blaine County,12,750,365,385
Oklahoma,Blaine County,13,657,335,322
Oklahoma,Blaine County,14,508,244,264
Oklahoma,Blaine County,15,440,219,221
Oklahoma,Blaine County,16,325,144,181
Oklahoma,Blaine County,17,239,98,141
Oklahoma,Blaine County,18,250,73,177
Oklahoma,Bryan County,0,44486,21685,22801
Oklahoma,Bryan County,1,3025,1467,1558
Oklahoma,Bryan County,2,2930,1480,1450
Oklahoma,Bryan County,3,2851,1370,1481
Oklahoma,Bryan County,4,2945,1558,1387
Oklahoma,Bryan County,5,3312,1628,1684
Oklahoma,Bryan County,6,3241,1677,1564
Oklahoma,Bryan County,7,2831,1419,1412
Oklahoma,Bryan County,8,2578,1291,1287
Oklahoma,Bryan County,9,2599,1277,1322
Oklahoma,Bryan County,10,2587,1268,1319
Oklahoma,Bryan County,11,2741,1323,1418
Oklahoma,Bryan County,12,2810,1346,1464
Oklahoma,Bryan County,13,2534,1187,1347
Oklahoma,Bryan County,14,2397,1115,1282
Oklahoma,Bryan County,15,1999,975,1024
Oklahoma,Bryan County,16,1348,619,729
Oklahoma,Bryan County,17,919,395,524
Oklahoma,Bryan County,18,839,290,549
Oklahoma,Caddo County,0,29317,15192,14125
Oklahoma,Caddo County,1,1952,954,998
Oklahoma,Caddo County,2,2016,983,1033
Oklahoma,Caddo County,3,2114,1073,1041
Oklahoma,Caddo County,4,1933,991,942
Oklahoma,Caddo County,5,1817,1013,804
Oklahoma,Caddo County,6,1942,1169,773
Oklahoma,Caddo County,7,1934,1133,801
Oklahoma,Caddo County,8,1729,996,733
Oklahoma,Caddo County,9,1756,968,788
Oklahoma,Caddo County,10,1825,999,826
Oklahoma,Caddo County,11,2093,1074,1019
Oklahoma,Caddo County,12,1923,991,932
Oklahoma,Caddo County,13,1705,818,887
Oklahoma,Caddo County,14,1450,701,749
Oklahoma,Caddo County,15,1148,520,628
Oklahoma,Caddo County,16,835,363,472
Oklahoma,Caddo County,17,602,247,355
Oklahoma,Caddo County,18,543,199,344
Oklahoma,Canadian County,0,129582,64100,65482
Oklahoma,Canadian County,1,8825,4426,4399
Oklahoma,Canadian County,2,10001,5035,4966
Oklahoma,Canadian County,3,9763,4924,4839
Oklahoma,Canadian County,4,8593,4343,4250
Oklahoma,Canadian County,5,7266,3677,3589
Oklahoma,Canadian County,6,8841,4416,4425
Oklahoma,Canadian County,7,10183,5119,5064
Oklahoma,Canadian County,8,9416,4739,4677
Oklahoma,Canadian County,9,9180,4697,4483
Oklahoma,Canadian County,10,8109,4102,4007
Oklahoma,Canadian County,11,8909,4415,4494
Oklahoma,Canadian County,12,8156,4023,4133
Oklahoma,Canadian County,13,6736,3230,3506
Oklahoma,Canadian County,14,5646,2687,2959
Oklahoma,Canadian County,15,3927,1862,2065
Oklahoma,Canadian County,16,2714,1167,1547
Oklahoma,Canadian County,17,1740,721,1019
Oklahoma,Canadian County,18,1577,517,1060
Oklahoma,Carter County,0,48821,23781,25040
Oklahoma,Carter County,1,3355,1638,1717
Oklahoma,Carter County,2,3492,1732,1760
Oklahoma,Carter County,3,3494,1791,1703
Oklahoma,Carter County,4,3153,1576,1577
Oklahoma,Carter County,5,2929,1518,1411
Oklahoma,Carter County,6,2970,1528,1442
Oklahoma,Carter County,7,3095,1516,1579
Oklahoma,Carter County,8,3092,1538,1554
Oklahoma,Carter County,9,3036,1524,1512
Oklahoma,Carter County,10,2830,1426,1404
Oklahoma,Carter County,11,3399,1686,1713
Oklahoma,Carter County,12,3355,1628,1727
Oklahoma,Carter County,13,2981,1410,1571
Oklahoma,Carter County,14,2377,1114,1263
Oklahoma,Carter County,15,1865,850,1015
Oklahoma,Carter County,16,1406,609,797
Oklahoma,Carter County,17,1027,417,610
Oklahoma,Carter County,18,965,280,685
Oklahoma,Cherokee County,0,48341,23774,24567
Oklahoma,Cherokee County,1,2949,1508,1441
Oklahoma,Cherokee County,2,3136,1575,1561
Oklahoma,Cherokee County,3,3061,1501,1560
Oklahoma,Cherokee County,4,3979,2023,1956
Oklahoma,Cherokee County,5,5414,2712,2702
Oklahoma,Cherokee County,6,2739,1410,1329
Oklahoma,Cherokee County,7,3017,1504,1513
Oklahoma,Cherokee County,8,2617,1315,1302
Oklahoma,Cherokee County,9,2707,1322,1385
Oklahoma,Cherokee County,10,2640,1275,1365
Oklahoma,Cherokee County,11,3036,1459,1577
Oklahoma,Cherokee County,12,2974,1432,1542
Oklahoma,Cherokee County,13,2751,1367,1384
Oklahoma,Cherokee County,14,2580,1268,1312
Oklahoma,Cherokee County,15,1798,851,947
Oklahoma,Cherokee County,16,1338,600,738
Oklahoma,Cherokee County,17,880,366,514
Oklahoma,Cherokee County,18,725,286,439
Oklahoma,Choctaw County,0,15161,7374,7787
Oklahoma,Choctaw County,1,945,512,433
Oklahoma,Choctaw County,2,1088,550,538
Oklahoma,Choctaw County,3,1058,523,535
Oklahoma,Choctaw County,4,935,447,488
Oklahoma,Choctaw County,5,851,437,414
Oklahoma,Choctaw County,6,822,420,402
Oklahoma,Choctaw County,7,805,366,439
Oklahoma,Choctaw County,8,827,395,432
Oklahoma,Choctaw County,9,852,416,436
Oklahoma,Choctaw County,10,852,407,445
Oklahoma,Choctaw County,11,1098,528,570
Oklahoma,Choctaw County,12,1086,533,553
Oklahoma,Choctaw County,13,1004,473,531
Oklahoma,Choctaw County,14,961,474,487
Oklahoma,Choctaw County,15,768,352,416
Oklahoma,Choctaw County,16,576,273,303
Oklahoma,Choctaw County,17,371,180,191
Oklahoma,Choctaw County,18,262,88,174
Oklahoma,Cimarron County,0,2294,1148,1146
Oklahoma,Cimarron County,1,136,69,67
Oklahoma,Cimarron County,2,168,94,74
Oklahoma,Cimarron County,3,159,79,80
Oklahoma,Cimarron County,4,127,67,60
Oklahoma,Cimarron County,5,117,59,58
Oklahoma,Cimarron County,6,127,58,69
Oklahoma,Cimarron County,7,112,59,53
Oklahoma,Cimarron County,8,96,42,54
Oklahoma,Cimarron County,9,138,75,63
Oklahoma,Cimarron County,10,117,60,57
Oklahoma,Cimarron County,11,154,82,72
Oklahoma,Cimarron County,12,147,78,69
Oklahoma,Cimarron County,13,182,87,95
Oklahoma,Cimarron County,14,139,66,73
Oklahoma,Cimarron County,15,126,61,65
Oklahoma,Cimarron County,16,102,48,54
Oklahoma,Cimarron County,17,70,35,35
Oklahoma,Cimarron County,18,77,29,48
Oklahoma,Cleveland County,0,269908,134607,135301
Oklahoma,Cleveland County,1,15955,8161,7794
Oklahoma,Cleveland County,2,17118,8809,8309
Oklahoma,Cleveland County,3,17207,8750,8457
Oklahoma,Cleveland County,4,19724,10115,9609
Oklahoma,Cleveland County,5,30700,15693,15007
Oklahoma,Cleveland County,6,19973,10493,9480
Oklahoma,Cleveland County,7,20623,10627,9996
Oklahoma,Cleveland County,8,17207,8868,8339
Oklahoma,Cleveland County,9,16540,8356,8184
Oklahoma,Cleveland County,10,15397,7696,7701
Oklahoma,Cleveland County,11,17268,8508,8760
Oklahoma,Cleveland County,12,16229,7816,8413
Oklahoma,Cleveland County,13,13766,6549,7217
Oklahoma,Cleveland County,14,11333,5353,5980
Oklahoma,Cleveland County,15,7934,3507,4427
Oklahoma,Cleveland County,16,5476,2480,2996
Oklahoma,Cleveland County,17,3770,1543,2227
Oklahoma,Cleveland County,18,3688,1283,2405
Oklahoma,Coal County,0,5807,2842,2965
Oklahoma,Coal County,1,330,167,163
Oklahoma,Coal County,2,413,214,199
Oklahoma,Coal County,3,391,212,179
Oklahoma,Coal County,4,402,210,192
Oklahoma,Coal County,5,359,187,172
Oklahoma,Coal County,6,289,138,151
Oklahoma,Coal County,7,282,140,142
Oklahoma,Coal County,8,330,169,161
Oklahoma,Coal County,9,314,141,173
Oklahoma,Coal County,10,317,162,155
Oklahoma,Coal County,11,386,207,179
Oklahoma,Coal County,12,442,232,210
Oklahoma,Coal County,13,370,167,203
Oklahoma,Coal County,14,357,165,192
Oklahoma,Coal County,15,289,122,167
Oklahoma,Coal County,16,237,104,133
Oklahoma,Coal County,17,152,64,88
Oklahoma,Coal County,18,147,41,106
Oklahoma,Comanche County,0,125033,64962,60071
Oklahoma,Comanche County,1,9272,4789,4483
Oklahoma,Comanche County,2,8516,4413,4103
Oklahoma,Comanche County,3,7887,3958,3929
Oklahoma,Comanche County,4,8938,4943,3995
Oklahoma,Comanche County,5,12370,7386,4984
Oklahoma,Comanche County,6,10978,6041,4937
Oklahoma,Comanche County,7,10172,5495,4677
Oklahoma,Comanche County,8,7920,4181,3739
Oklahoma,Comanche County,9,7347,3795,3552
Oklahoma,Comanche County,10,6921,3577,3344
Oklahoma,Comanche County,11,7872,3935,3937
Oklahoma,Comanche County,12,7286,3513,3773
Oklahoma,Comanche County,13,5767,2789,2978
Oklahoma,Comanche County,14,4468,2130,2338
Oklahoma,Comanche County,15,3343,1511,1832
Oklahoma,Comanche County,16,2580,1172,1408
Oklahoma,Comanche County,17,1842,761,1081
Oklahoma,Comanche County,18,1554,573,981
Oklahoma,Cotton County,0,6150,3080,3070
Oklahoma,Cotton County,1,363,201,162
Oklahoma,Cotton County,2,419,223,196
Oklahoma,Cotton County,3,393,194,199
Oklahoma,Cotton County,4,427,222,205
Oklahoma,Cotton County,5,361,186,175
Oklahoma,Cotton County,6,305,154,151
Oklahoma,Cotton County,7,362,183,179
Oklahoma,Cotton County,8,332,166,166
Oklahoma,Cotton County,9,363,192,171
Oklahoma,Cotton County,10,386,191,195
Oklahoma,Cotton County,11,488,247,241
Oklahoma,Cotton County,12,445,216,229
Oklahoma,Cotton County,13,387,197,190
Oklahoma,Cotton County,14,348,172,176
Oklahoma,Cotton County,15,293,128,165
Oklahoma,Cotton County,16,229,112,117
Oklahoma,Cotton County,17,130,58,72
Oklahoma,Cotton County,18,119,38,81
Oklahoma,Craig County,0,14582,7474,7108
Oklahoma,Craig County,1,789,454,335
Oklahoma,Craig County,2,894,442,452
Oklahoma,Craig County,3,948,495,453
Oklahoma,Craig County,4,911,474,437
Oklahoma,Craig County,5,863,481,382
Oklahoma,Craig County,6,856,476,380
Oklahoma,Craig County,7,819,436,383
Oklahoma,Craig County,8,852,481,371
Oklahoma,Craig County,9,880,445,435
Oklahoma,Craig County,10,963,527,436
Oklahoma,Craig County,11,1160,603,557
Oklahoma,Craig County,12,1040,523,517
Oklahoma,Craig County,13,875,444,431
Oklahoma,Craig County,14,809,392,417
Oklahoma,Craig County,15,761,332,429
Oklahoma,Craig County,16,497,226,271
Oklahoma,Craig County,17,375,151,224
Oklahoma,Craig County,18,290,92,198
Oklahoma,Creek County,0,70632,34996,35636
Oklahoma,Creek County,1,4405,2298,2107
Oklahoma,Creek County,2,4649,2442,2207
Oklahoma,Creek County,3,4965,2575,2390
Oklahoma,Creek County,4,4616,2356,2260
Oklahoma,Creek County,5,4188,2135,2053
Oklahoma,Creek County,6,3960,2027,1933
Oklahoma,Creek County,7,4213,2079,2134
Oklahoma,Creek County,8,4036,2013,2023
Oklahoma,Creek County,9,4415,2195,2220
Oklahoma,Creek County,10,4433,2180,2253
Oklahoma,Creek County,11,5259,2629,2630
Oklahoma,Creek County,12,5022,2470,2552
Oklahoma,Creek County,13,4535,2198,2337
Oklahoma,Creek County,14,3959,1902,2057
Oklahoma,Creek County,15,3108,1497,1611
Oklahoma,Creek County,16,2034,928,1106
Oklahoma,Creek County,17,1447,600,847
Oklahoma,Creek County,18,1388,472,916
Oklahoma,Custer County,0,29500,14739,14761
Oklahoma,Custer County,1,2245,1118,1127
Oklahoma,Custer County,2,1990,990,1000
Oklahoma,Custer County,3,1929,941,988
Oklahoma,Custer County,4,2285,1172,1113
Oklahoma,Custer County,5,3902,1977,1925
Oklahoma,Custer County,6,2137,1161,976
Oklahoma,Custer County,7,1987,1034,953
Oklahoma,Custer County,8,1510,777,733
Oklahoma,Custer County,9,1458,765,693
Oklahoma,Custer County,10,1369,701,668
Oklahoma,Custer County,11,1751,902,849
Oklahoma,Custer County,12,1642,780,862
Oklahoma,Custer County,13,1437,727,710
Oklahoma,Custer County,14,1093,511,582
Oklahoma,Custer County,15,891,396,495
Oklahoma,Custer County,16,699,333,366
Oklahoma,Custer County,17,559,224,335
Oklahoma,Custer County,18,616,230,386
Oklahoma,Delaware County,0,41446,20364,21082
Oklahoma,Delaware County,1,1983,1010,973
Oklahoma,Delaware County,2,2512,1294,1218
Oklahoma,Delaware County,3,2670,1337,1333
Oklahoma,Delaware County,4,2556,1262,1294
Oklahoma,Delaware County,5,2176,1117,1059
Oklahoma,Delaware County,6,1990,976,1014
Oklahoma,Delaware County,7,1982,933,1049
Oklahoma,Delaware County,8,2080,1034,1046
Oklahoma,Delaware County,9,2310,1160,1150
Oklahoma,Delaware County,10,2431,1190,1241
Oklahoma,Delaware County,11,3015,1458,1557
Oklahoma,Delaware County,12,3143,1467,1676
Oklahoma,Delaware County,13,3086,1447,1639
Oklahoma,Delaware County,14,3262,1622,1640
Oklahoma,Delaware County,15,2637,1316,1321
Oklahoma,Delaware County,16,1755,917,838
Oklahoma,Delaware County,17,1073,514,559
Oklahoma,Delaware County,18,785,310,475
Oklahoma,Dewey County,0,4914,2409,2505
Oklahoma,Dewey County,1,332,170,162
Oklahoma,Dewey County,2,361,173,188
Oklahoma,Dewey County,3,367,175,192
Oklahoma,Dewey County,4,332,173,159
Oklahoma,Dewey County,5,269,142,127
Oklahoma,Dewey County,6,249,131,118
Oklahoma,Dewey County,7,284,138,146
Oklahoma,Dewey County,8,271,142,129
Oklahoma,Dewey County,9,238,115,123
Oklahoma,Dewey County,10,285,151,134
Oklahoma,Dewey County,11,330,167,163
Oklahoma,Dewey County,12,368,170,198
Oklahoma,Dewey County,13,276,140,136
Oklahoma,Dewey County,14,273,133,140
Oklahoma,Dewey County,15,257,121,136
Oklahoma,Dewey County,16,196,88,108
Oklahoma,Dewey County,17,99,47,52
Oklahoma,Dewey County,18,127,33,94
Oklahoma,Ellis County,0,4150,2052,2098
Oklahoma,Ellis County,1,223,109,114
Oklahoma,Ellis County,2,268,134,134
Oklahoma,Ellis County,3,298,151,147
Oklahoma,Ellis County,4,267,134,133
Oklahoma,Ellis County,5,209,103,106
Oklahoma,Ellis County,6,170,98,72
Oklahoma,Ellis County,7,229,104,125
Oklahoma,Ellis County,8,263,144,119
Oklahoma,Ellis County,9,218,106,112
Oklahoma,Ellis County,10,217,109,108
Oklahoma,Ellis County,11,287,147,140
Oklahoma,Ellis County,12,331,164,167
Oklahoma,Ellis County,13,330,167,163
Oklahoma,Ellis County,14,244,121,123
Oklahoma,Ellis County,15,189,88,101
Oklahoma,Ellis County,16,189,95,94
Oklahoma,Ellis County,17,100,41,59
Oklahoma,Ellis County,18,118,37,81
Oklahoma,Garfield County,0,63091,31407,31684
Oklahoma,Garfield County,1,4662,2272,2390
Oklahoma,Garfield County,2,4804,2405,2399
Oklahoma,Garfield County,3,4264,2170,2094
Oklahoma,Garfield County,4,3929,2036,1893
Oklahoma,Garfield County,5,4386,2369,2017
Oklahoma,Garfield County,6,4470,2387,2083
Oklahoma,Garfield County,7,4474,2355,2119
Oklahoma,Garfield County,8,3727,1894,1833
Oklahoma,Garfield County,9,3392,1707,1685
Oklahoma,Garfield County,10,3361,1686,1675
Oklahoma,Garfield County,11,4246,2167,2079
Oklahoma,Garfield County,12,4191,2095,2096
Oklahoma,Garfield County,13,3605,1744,1861
Oklahoma,Garfield County,14,2762,1285,1477
Oklahoma,Garfield County,15,2233,1042,1191
Oklahoma,Garfield County,16,1754,744,1010
Oklahoma,Garfield County,17,1328,532,796
Oklahoma,Garfield County,18,1503,517,986
Oklahoma,Garvin County,0,27561,13591,13970
Oklahoma,Garvin County,1,1849,954,895
Oklahoma,Garvin County,2,1966,1002,964
Oklahoma,Garvin County,3,1931,956,975
Oklahoma,Garvin County,4,1735,941,794
Oklahoma,Garvin County,5,1598,809,789
Oklahoma,Garvin County,6,1571,752,819
Oklahoma,Garvin County,7,1825,939,886
Oklahoma,Garvin County,8,1570,819,751
Oklahoma,Garvin County,9,1687,832,855
Oklahoma,Garvin County,10,1573,775,798
Oklahoma,Garvin County,11,1897,896,1001
Oklahoma,Garvin County,12,1926,960,966
Oklahoma,Garvin County,13,1726,842,884
Oklahoma,Garvin County,14,1409,695,714
Oklahoma,Garvin County,15,1199,531,668
Oklahoma,Garvin County,16,936,413,523
Oklahoma,Garvin County,17,597,250,347
Oklahoma,Garvin County,18,566,225,341
Oklahoma,Grady County,0,53854,26787,27067
Oklahoma,Grady County,1,3234,1657,1577
Oklahoma,Grady County,2,3755,1939,1816
Oklahoma,Grady County,3,3846,2045,1801
Oklahoma,Grady County,4,3643,1959,1684
Oklahoma,Grady County,5,3271,1642,1629
Oklahoma,Grady County,6,3109,1519,1590
Oklahoma,Grady County,7,3553,1750,1803
Oklahoma,Grady County,8,3323,1657,1666
Oklahoma,Grady County,9,3446,1679,1767
Oklahoma,Grady County,10,3340,1701,1639
Oklahoma,Grady County,11,4116,2039,2077
Oklahoma,Grady County,12,3902,1938,1964
Oklahoma,Grady County,13,3296,1625,1671
Oklahoma,Grady County,14,2705,1305,1400
Oklahoma,Grady County,15,2073,973,1100
Oklahoma,Grady County,16,1465,683,782
Oklahoma,Grady County,17,942,399,543
Oklahoma,Grady County,18,835,277,558
Oklahoma,Grant County,0,4501,2212,2289
Oklahoma,Grant County,1,276,117,159
Oklahoma,Grant County,2,304,142,162
Oklahoma,Grant County,3,316,165,151
Oklahoma,Grant County,4,268,139,129
Oklahoma,Grant County,5,219,112,107
Oklahoma,Grant County,6,231,120,111
Oklahoma,Grant County,7,236,103,133
Oklahoma,Grant County,8,238,124,114
Oklahoma,Grant County,9,228,116,112
Oklahoma,Grant County,10,267,134,133
Oklahoma,Grant County,11,347,195,152
Oklahoma,Grant County,12,327,167,160
Oklahoma,Grant County,13,315,165,150
Oklahoma,Grant County,14,248,117,131
Oklahoma,Grant County,15,197,84,113
Oklahoma,Grant County,16,191,99,92
Oklahoma,Grant County,17,160,62,98
Oklahoma,Grant County,18,133,51,82
Oklahoma,Greer County,0,6151,3530,2621
Oklahoma,Greer County,1,321,163,158
Oklahoma,Greer County,2,339,178,161
Oklahoma,Greer County,3,365,174,191
Oklahoma,Greer County,4,310,162,148
Oklahoma,Greer County,5,390,270,120
Oklahoma,Greer County,6,526,386,140
Oklahoma,Greer County,7,485,330,155
Oklahoma,Greer County,8,405,270,135
Oklahoma,Greer County,9,378,252,126
Oklahoma,Greer County,10,416,257,159
Oklahoma,Greer County,11,403,248,155
Oklahoma,Greer County,12,379,204,175
Oklahoma,Greer County,13,315,144,171
Oklahoma,Greer County,14,306,161,145
Oklahoma,Greer County,15,245,111,134
Oklahoma,Greer County,16,224,98,126
Oklahoma,Greer County,17,158,63,95
Oklahoma,Greer County,18,186,59,127
Oklahoma,Harmon County,0,2798,1349,1449
Oklahoma,Harmon County,1,210,104,106
Oklahoma,Harmon County,2,206,88,118
Oklahoma,Harmon County,3,172,89,83
Oklahoma,Harmon County,4,171,85,86
Oklahoma,Harmon County,5,155,74,81
Oklahoma,Harmon County,6,150,72,78
Oklahoma,Harmon County,7,182,103,79
Oklahoma,Harmon County,8,123,59,64
Oklahoma,Harmon County,9,163,81,82
Oklahoma,Harmon County,10,172,81,91
Oklahoma,Harmon County,11,180,89,91
Oklahoma,Harmon County,12,187,108,79
Oklahoma,Harmon County,13,183,85,98
Oklahoma,Harmon County,14,157,77,80
Oklahoma,Harmon County,15,112,49,63
Oklahoma,Harmon County,16,108,42,66
Oklahoma,Harmon County,17,81,34,47
Oklahoma,Harmon County,18,86,29,57
Oklahoma,Harper County,0,3812,1886,1926
Oklahoma,Harper County,1,276,125,151
Oklahoma,Harper County,2,297,128,169
Oklahoma,Harper County,3,264,142,122
Oklahoma,Harper County,4,215,105,110
Oklahoma,Harper County,5,217,117,100
Oklahoma,Harper County,6,164,84,80
Oklahoma,Harper County,7,256,125,131
Oklahoma,Harper County,8,236,131,105
Oklahoma,Harper County,9,177,93,84
Oklahoma,Harper County,10,215,108,107
Oklahoma,Harper County,11,299,158,141
Oklahoma,Harper County,12,269,145,124
Oklahoma,Harper County,13,250,132,118
Oklahoma,Harper County,14,169,76,93
Oklahoma,Harper County,15,142,74,68
Oklahoma,Harper County,16,137,49,88
Oklahoma,Harper County,17,134,59,75
Oklahoma,Harper County,18,95,35,60
Oklahoma,Haskell County,0,12896,6476,6420
Oklahoma,Haskell County,1,769,379,390
Oklahoma,Haskell County,2,871,445,426
Oklahoma,Haskell County,3,905,514,391
Oklahoma,Haskell County,4,864,451,413
Oklahoma,Haskell County,5,739,411,328
Oklahoma,Haskell County,6,702,348,354
Oklahoma,Haskell County,7,750,389,361
Oklahoma,Haskell County,8,724,367,357
Oklahoma,Haskell County,9,712,354,358
Oklahoma,Haskell County,10,780,394,386
Oklahoma,Haskell County,11,877,415,462
Oklahoma,Haskell County,12,829,401,428
Oklahoma,Haskell County,13,822,431,391
Oklahoma,Haskell County,14,843,404,439
Oklahoma,Haskell County,15,664,314,350
Oklahoma,Haskell County,16,434,216,218
Oklahoma,Haskell County,17,301,122,179
Oklahoma,Haskell County,18,310,121,189
Oklahoma,Hughes County,0,13806,7389,6417
Oklahoma,Hughes County,1,676,330,346
Oklahoma,Hughes County,2,850,464,386
Oklahoma,Hughes County,3,879,463,416
Oklahoma,Hughes County,4,861,445,416
Oklahoma,Hughes County,5,888,536,352
Oklahoma,Hughes County,6,852,573,279
Oklahoma,Hughes County,7,955,589,366
Oklahoma,Hughes County,8,832,511,321
Oklahoma,Hughes County,9,868,501,367
Oklahoma,Hughes County,10,821,460,361
Oklahoma,Hughes County,11,940,492,448
Oklahoma,Hughes County,12,897,445,452
Oklahoma,Hughes County,13,890,434,456
Oklahoma,Hughes County,14,770,370,400
Oklahoma,Hughes County,15,654,285,369
Oklahoma,Hughes County,16,461,204,257
Oklahoma,Hughes County,17,374,162,212
Oklahoma,Hughes County,18,338,125,213
Oklahoma,Jackson County,0,25998,12922,13076
Oklahoma,Jackson County,1,2150,1069,1081
Oklahoma,Jackson County,2,1850,905,945
Oklahoma,Jackson County,3,1715,909,806
Oklahoma,Jackson County,4,1637,860,777
Oklahoma,Jackson County,5,2147,1223,924
Oklahoma,Jackson County,6,2042,1045,997
Oklahoma,Jackson County,7,1815,922,893
Oklahoma,Jackson County,8,1498,756,742
Oklahoma,Jackson County,9,1458,702,756
Oklahoma,Jackson County,10,1453,684,769
Oklahoma,Jackson County,11,1662,798,864
Oklahoma,Jackson County,12,1664,830,834
Oklahoma,Jackson County,13,1339,615,724
Oklahoma,Jackson County,14,1106,556,550
Oklahoma,Jackson County,15,877,397,480
Oklahoma,Jackson County,16,702,315,387
Oklahoma,Jackson County,17,439,176,263
Oklahoma,Jackson County,18,444,160,284
Oklahoma,Jefferson County,0,6292,3179,3113
Oklahoma,Jefferson County,1,411,232,179
Oklahoma,Jefferson County,2,443,229,214
Oklahoma,Jefferson County,3,411,200,211
Oklahoma,Jefferson County,4,380,226,154
Oklahoma,Jefferson County,5,336,178,158
Oklahoma,Jefferson County,6,332,169,163
Oklahoma,Jefferson County,7,327,175,152
Oklahoma,Jefferson County,8,337,160,177
Oklahoma,Jefferson County,9,358,184,174
Oklahoma,Jefferson County,10,366,182,184
Oklahoma,Jefferson County,11,446,225,221
Oklahoma,Jefferson County,12,482,239,243
Oklahoma,Jefferson County,13,438,212,226
Oklahoma,Jefferson County,14,382,179,203
Oklahoma,Jefferson County,15,317,163,154
Oklahoma,Jefferson County,16,207,89,118
Oklahoma,Jefferson County,17,166,79,87
Oklahoma,Jefferson County,18,153,58,95
Oklahoma,Johnston County,0,11103,5426,5677
Oklahoma,Johnston County,1,688,323,365
Oklahoma,Johnston County,2,776,416,360
Oklahoma,Johnston County,3,703,348,355
Oklahoma,Johnston County,4,804,402,402
Oklahoma,Johnston County,5,706,365,341
Oklahoma,Johnston County,6,655,299,356
Oklahoma,Johnston County,7,644,313,331
Oklahoma,Johnston County,8,603,326,277
Oklahoma,Johnston County,9,630,294,336
Oklahoma,Johnston County,10,681,349,332
Oklahoma,Johnston County,11,783,382,401
Oklahoma,Johnston County,12,737,356,381
Oklahoma,Johnston County,13,715,334,381
Oklahoma,Johnston County,14,650,319,331
Oklahoma,Johnston County,15,510,244,266
Oklahoma,Johnston County,16,380,182,198
Oklahoma,Johnston County,17,248,92,156
Oklahoma,Johnston County,18,190,82,108
Oklahoma,Kay County,0,45478,22485,22993
Oklahoma,Kay County,1,3211,1632,1579
Oklahoma,Kay County,2,3221,1635,1586
Oklahoma,Kay County,3,3120,1616,1504
Oklahoma,Kay County,4,3033,1563,1470
Oklahoma,Kay County,5,2974,1493,1481
Oklahoma,Kay County,6,2478,1212,1266
Oklahoma,Kay County,7,2733,1431,1302
Oklahoma,Kay County,8,2604,1329,1275
Oklahoma,Kay County,9,2424,1257,1167
Oklahoma,Kay County,10,2492,1289,1203
Oklahoma,Kay County,11,3024,1514,1510
Oklahoma,Kay County,12,3079,1519,1560
Oklahoma,Kay County,13,2857,1343,1514
Oklahoma,Kay County,14,2494,1211,1283
Oklahoma,Kay County,15,1927,888,1039
Oklahoma,Kay County,16,1543,689,854
Oklahoma,Kay County,17,1084,436,648
Oklahoma,Kay County,18,1180,428,752
Oklahoma,Kingfisher County,0,15532,7736,7796
Oklahoma,Kingfisher County,1,1152,584,568
Oklahoma,Kingfisher County,2,1174,602,572
Oklahoma,Kingfisher County,3,1190,632,558
Oklahoma,Kingfisher County,4,1058,547,511
Oklahoma,Kingfisher County,5,903,458,445
Oklahoma,Kingfisher County,6,840,444,396
Oklahoma,Kingfisher County,7,986,462,524
Oklahoma,Kingfisher County,8,888,451,437
Oklahoma,Kingfisher County,9,928,460,468
Oklahoma,Kingfisher County,10,971,483,488
Oklahoma,Kingfisher County,11,1139,590,549
Oklahoma,Kingfisher County,12,1059,521,538
Oklahoma,Kingfisher County,13,897,468,429
Oklahoma,Kingfisher County,14,693,333,360
Oklahoma,Kingfisher County,15,540,237,303
Oklahoma,Kingfisher County,16,456,209,247
Oklahoma,Kingfisher County,17,329,126,203
Oklahoma,Kingfisher County,18,329,129,200
Oklahoma,Kiowa County,0,9336,4597,4739
Oklahoma,Kiowa County,1,611,313,298
Oklahoma,Kiowa County,2,582,272,310
Oklahoma,Kiowa County,3,628,305,323
Oklahoma,Kiowa County,4,607,296,311
Oklahoma,Kiowa County,5,515,285,230
Oklahoma,Kiowa County,6,489,234,255
Oklahoma,Kiowa County,7,552,279,273
Oklahoma,Kiowa County,8,486,255,231
Oklahoma,Kiowa County,9,522,262,260
Oklahoma,Kiowa County,10,538,275,263
Oklahoma,Kiowa County,11,705,347,358
Oklahoma,Kiowa County,12,711,348,363
Oklahoma,Kiowa County,13,622,320,302
Oklahoma,Kiowa County,14,556,263,293
Oklahoma,Kiowa County,15,466,230,236
Oklahoma,Kiowa County,16,339,161,178
Oklahoma,Kiowa County,17,232,96,136
Oklahoma,Kiowa County,18,175,56,119
Oklahoma,Latimer County,0,10693,5413,5280
Oklahoma,Latimer County,1,658,332,326
Oklahoma,Latimer County,2,651,347,304
Oklahoma,Latimer County,3,674,367,307
Oklahoma,Latimer County,4,781,418,363
Oklahoma,Latimer County,5,791,400,391
Oklahoma,Latimer County,6,564,266,298
Oklahoma,Latimer County,7,625,312,313
Oklahoma,Latimer County,8,516,265,251
Oklahoma,Latimer County,9,583,288,295
Oklahoma,Latimer County,10,628,305,323
Oklahoma,Latimer County,11,770,374,396
Oklahoma,Latimer County,12,700,348,352
Oklahoma,Latimer County,13,693,348,345
Oklahoma,Latimer County,14,620,323,297
Oklahoma,Latimer County,15,516,252,264
Oklahoma,Latimer County,16,389,203,186
Oklahoma,Latimer County,17,257,134,123
Oklahoma,Latimer County,18,277,131,146
Oklahoma,Le Flore County,0,49761,24875,24886
Oklahoma,Le Flore County,1,3050,1560,1490
Oklahoma,Le Flore County,2,3465,1789,1676
Oklahoma,Le Flore County,3,3450,1773,1677
Oklahoma,Le Flore County,4,3213,1610,1603
Oklahoma,Le Flore County,5,3074,1577,1497
Oklahoma,Le Flore County,6,2959,1547,1412
Oklahoma,Le Flore County,7,3031,1530,1501
Oklahoma,Le Flore County,8,2987,1602,1385
Oklahoma,Le Flore County,9,3019,1535,1484
Oklahoma,Le Flore County,10,3088,1604,1484
Oklahoma,Le Flore County,11,3452,1724,1728
Oklahoma,Le Flore County,12,3418,1636,1782
Oklahoma,Le Flore County,13,3134,1503,1631
Oklahoma,Le Flore County,14,2896,1436,1460
Oklahoma,Le Flore County,15,2121,992,1129
Oklahoma,Le Flore County,16,1582,722,860
Oklahoma,Le Flore County,17,930,416,514
Oklahoma,Le Flore County,18,892,319,573
Oklahoma,Lincoln County,0,34619,17269,17350
Oklahoma,Lincoln County,1,2043,1078,965
Oklahoma,Lincoln County,2,2415,1281,1134
Oklahoma,Lincoln County,3,2501,1252,1249
Oklahoma,Lincoln County,4,2347,1238,1109
Oklahoma,Lincoln County,5,1939,993,946
Oklahoma,Lincoln County,6,1774,855,919
Oklahoma,Lincoln County,7,1945,964,981
Oklahoma,Lincoln County,8,1918,938,980
Oklahoma,Lincoln County,9,2112,1069,1043
Oklahoma,Lincoln County,10,2219,1104,1115
Oklahoma,Lincoln County,11,2709,1376,1333
Oklahoma,Lincoln County,12,2630,1322,1308
Oklahoma,Lincoln County,13,2180,1059,1121
Oklahoma,Lincoln County,14,1960,927,1033
Oklahoma,Lincoln County,15,1560,736,824
Oklahoma,Lincoln County,16,1092,530,562
Oklahoma,Lincoln County,17,686,317,369
Oklahoma,Lincoln County,18,589,230,359
Oklahoma,Logan County,0,45276,22433,22843
Oklahoma,Logan County,1,2617,1339,1278
Oklahoma,Logan County,2,3095,1630,1465
Oklahoma,Logan County,3,3104,1607,1497
Oklahoma,Logan County,4,3750,1895,1855
Oklahoma,Logan County,5,3123,1611,1512
Oklahoma,Logan County,6,2337,1151,1186
Oklahoma,Logan County,7,2841,1376,1465
Oklahoma,Logan County,8,2690,1332,1358
Oklahoma,Logan County,9,2923,1433,1490
Oklahoma,Logan County,10,2664,1317,1347
Oklahoma,Logan County,11,3357,1638,1719
Oklahoma,Logan County,12,3230,1552,1678
Oklahoma,Logan County,13,2764,1349,1415
Oklahoma,Logan County,14,2253,1125,1128
Oklahoma,Logan County,15,1771,865,906
Oklahoma,Logan County,16,1240,591,649
Oklahoma,Logan County,17,770,355,415
Oklahoma,Logan County,18,747,267,480
Oklahoma,Love County,0,9773,4833,4940
Oklahoma,Love County,1,652,316,336
Oklahoma,Love County,2,705,338,367
Oklahoma,Love County,3,692,347,345
Oklahoma,Love County,4,634,317,317
Oklahoma,Love County,5,569,285,284
Oklahoma,Love County,6,541,271,270
Oklahoma,Love County,7,622,325,297
Oklahoma,Love County,8,518,255,263
Oklahoma,Love County,9,542,282,260
Oklahoma,Love County,10,566,269,297
Oklahoma,Love County,11,668,328,340
Oklahoma,Love County,12,670,333,337
Oklahoma,Love County,13,606,315,291
Oklahoma,Love County,14,586,297,289
Oklahoma,Love County,15,482,245,237
Oklahoma,Love County,16,357,169,188
Oklahoma,Love County,17,196,79,117
Oklahoma,Love County,18,167,62,105
Oklahoma,McClain County,0,37313,18504,18809
Oklahoma,McClain County,1,2355,1196,1159
Oklahoma,McClain County,2,2835,1422,1413
Oklahoma,McClain County,3,2805,1444,1361
Oklahoma,McClain County,4,2534,1346,1188
Oklahoma,McClain County,5,2035,1047,988
Oklahoma,McClain County,6,2033,1005,1028
Oklahoma,McClain County,7,2438,1181,1257
Oklahoma,McClain County,8,2415,1172,1243
Oklahoma,McClain County,9,2450,1217,1233
Oklahoma,McClain County,10,2390,1200,1190
Oklahoma,McClain County,11,2803,1401,1402
Oklahoma,McClain County,12,2563,1226,1337
Oklahoma,McClain County,13,2186,1077,1109
Oklahoma,McClain County,14,1885,902,983
Oklahoma,McClain County,15,1466,711,755
Oklahoma,McClain County,16,1023,485,538
Oklahoma,McClain County,17,635,285,350
Oklahoma,McClain County,18,462,187,275
Oklahoma,McCurtain County,0,33050,16205,16845
Oklahoma,McCurtain County,1,2412,1215,1197
Oklahoma,McCurtain County,2,2353,1220,1133
Oklahoma,McCurtain County,3,2289,1169,1120
Oklahoma,McCurtain County,4,2193,1136,1057
Oklahoma,McCurtain County,5,2036,1014,1022
Oklahoma,McCurtain County,6,1811,899,912
Oklahoma,McCurtain County,7,1919,935,984
Oklahoma,McCurtain County,8,1877,924,953
Oklahoma,McCurtain County,9,1951,934,1017
Oklahoma,McCurtain County,10,2068,1044,1024
Oklahoma,McCurtain County,11,2263,1132,1131
Oklahoma,McCurtain County,12,2156,1026,1130
Oklahoma,McCurtain County,13,2104,989,1115
Oklahoma,McCurtain County,14,1816,850,966
Oklahoma,McCurtain County,15,1470,722,748
Oklahoma,McCurtain County,16,1045,499,546
Oklahoma,McCurtain County,17,739,301,438
Oklahoma,McCurtain County,18,548,196,352
Oklahoma,McIntosh County,0,20088,9941,10147
Oklahoma,McIntosh County,1,1012,532,480
Oklahoma,McIntosh County,2,1141,588,553
Oklahoma,McIntosh County,3,1157,617,540
Oklahoma,McIntosh County,4,1172,613,559
Oklahoma,McIntosh County,5,985,505,480
Oklahoma,McIntosh County,6,917,454,463
Oklahoma,McIntosh County,7,990,482,508
Oklahoma,McIntosh County,8,923,440,483
Oklahoma,McIntosh County,9,1079,498,581
Oklahoma,McIntosh County,10,1137,599,538
Oklahoma,McIntosh County,11,1576,759,817
Oklahoma,McIntosh County,12,1612,794,818
Oklahoma,McIntosh County,13,1446,681,765
Oklahoma,McIntosh County,14,1510,753,757
Oklahoma,McIntosh County,15,1326,621,705
Oklahoma,McIntosh County,16,944,472,472
Oklahoma,McIntosh County,17,664,340,324
Oklahoma,McIntosh County,18,497,193,304
Oklahoma,Major County,0,7750,3809,3941
Oklahoma,Major County,1,574,287,287
Oklahoma,Major County,2,556,287,269
Oklahoma,Major County,3,537,248,289
Oklahoma,Major County,4,424,228,196
Oklahoma,Major County,5,390,201,189
Oklahoma,Major County,6,392,199,193
Oklahoma,Major County,7,490,249,241
Oklahoma,Major County,8,421,214,207
Oklahoma,Major County,9,405,188,217
Oklahoma,Major County,10,432,197,235
Oklahoma,Major County,11,563,298,265
Oklahoma,Major County,12,595,306,289
Oklahoma,Major County,13,521,269,252
Oklahoma,Major County,14,393,183,210
Oklahoma,Major County,15,333,142,191
Oklahoma,Major County,16,299,137,162
Oklahoma,Major County,17,209,90,119
Oklahoma,Major County,18,216,86,130
Oklahoma,Marshall County,0,16182,8040,8142
Oklahoma,Marshall County,1,1043,521,522
Oklahoma,Marshall County,2,1132,595,537
Oklahoma,Marshall County,3,1061,568,493
Oklahoma,Marshall County,4,986,530,456
Oklahoma,Marshall County,5,853,435,418
Oklahoma,Marshall County,6,797,387,410
Oklahoma,Marshall County,7,843,420,423
Oklahoma,Marshall County,8,848,405,443
Oklahoma,Marshall County,9,921,440,481
Oklahoma,Marshall County,10,938,491,447
Oklahoma,Marshall County,11,1192,577,615
Oklahoma,Marshall County,12,1175,589,586
Oklahoma,Marshall County,13,1034,472,562
Oklahoma,Marshall County,14,1044,524,520
Oklahoma,Marshall County,15,930,471,459
Oklahoma,Marshall County,16,646,321,325
Oklahoma,Marshall County,17,423,196,227
Oklahoma,Marshall County,18,316,98,218
Oklahoma,Mayes County,0,40816,20270,20546
Oklahoma,Mayes County,1,2611,1300,1311
Oklahoma,Mayes County,2,2738,1406,1332
Oklahoma,Mayes County,3,2741,1428,1313
Oklahoma,Mayes County,4,2769,1474,1295
Oklahoma,Mayes County,5,2478,1212,1266
Oklahoma,Mayes County,6,2272,1089,1183
Oklahoma,Mayes County,7,2443,1238,1205
Oklahoma,Mayes County,8,2313,1174,1139
Oklahoma,Mayes County,9,2456,1231,1225
Oklahoma,Mayes County,10,2461,1242,1219
Oklahoma,Mayes County,11,2936,1473,1463
Oklahoma,Mayes County,12,2987,1489,1498
Oklahoma,Mayes County,13,2623,1297,1326
Oklahoma,Mayes County,14,2325,1134,1191
Oklahoma,Mayes County,15,1873,911,962
Oklahoma,Mayes County,16,1299,578,721
Oklahoma,Mayes County,17,781,328,453
Oklahoma,Mayes County,18,710,266,444
Oklahoma,Murray County,0,13803,6900,6903
Oklahoma,Murray County,1,798,410,388
Oklahoma,Murray County,2,952,485,467
Oklahoma,Murray County,3,930,497,433
Oklahoma,Murray County,4,863,451,412
Oklahoma,Murray County,5,721,351,370
Oklahoma,Murray County,6,758,409,349
Oklahoma,Murray County,7,861,437,424
Oklahoma,Murray County,8,721,355,366
Oklahoma,Murray County,9,873,429,444
Oklahoma,Murray County,10,805,397,408
Oklahoma,Murray County,11,956,474,482
Oklahoma,Murray County,12,1033,513,520
Oklahoma,Murray County,13,901,445,456
Oklahoma,Murray County,14,842,408,434
Oklahoma,Murray County,15,656,314,342
Oklahoma,Murray County,16,495,247,248
Oklahoma,Murray County,17,353,168,185
Oklahoma,Murray County,18,285,110,175
Oklahoma,Muskogee County,0,69966,34111,35855
Oklahoma,Muskogee County,1,4890,2483,2407
Oklahoma,Muskogee County,2,4835,2459,2376
Oklahoma,Muskogee County,3,4635,2382,2253
Oklahoma,Muskogee County,4,4624,2417,2207
Oklahoma,Muskogee County,5,4548,2345,2203
Oklahoma,Muskogee County,6,4428,2134,2294
Oklahoma,Muskogee County,7,4693,2289,2404
Oklahoma,Muskogee County,8,4205,2073,2132
Oklahoma,Muskogee County,9,4215,2070,2145
Oklahoma,Muskogee County,10,4049,2003,2046
Oklahoma,Muskogee County,11,4749,2344,2405
Oklahoma,Muskogee County,12,4712,2247,2465
Oklahoma,Muskogee County,13,4182,1979,2203
Oklahoma,Muskogee County,14,3689,1782,1907
Oklahoma,Muskogee County,15,2657,1201,1456
Oklahoma,Muskogee County,16,1996,848,1148
Oklahoma,Muskogee County,17,1480,593,887
Oklahoma,Muskogee County,18,1379,462,917
Oklahoma,Noble County,0,11494,5673,5821
Oklahoma,Noble County,1,643,336,307
Oklahoma,Noble County,2,804,392,412
Oklahoma,Noble County,3,837,448,389
Oklahoma,Noble County,4,753,390,363
Oklahoma,Noble County,5,618,300,318
Oklahoma,Noble County,6,600,290,310
Oklahoma,Noble County,7,704,351,353
Oklahoma,Noble County,8,641,330,311
Oklahoma,Noble County,9,689,331,358
Oklahoma,Noble County,10,770,384,386
Oklahoma,Noble County,11,855,420,435
Oklahoma,Noble County,12,798,401,397
Oklahoma,Noble County,13,760,399,361
Oklahoma,Noble County,14,595,284,311
Oklahoma,Noble County,15,509,230,279
Oklahoma,Noble County,16,390,187,203
Oklahoma,Noble County,17,293,120,173
Oklahoma,Noble County,18,235,80,155
Oklahoma,Nowata County,0,10524,5181,5343
Oklahoma,Nowata County,1,617,300,317
Oklahoma,Nowata County,2,683,330,353
Oklahoma,Nowata County,3,705,369,336
Oklahoma,Nowata County,4,681,350,331
Oklahoma,Nowata County,5,622,308,314
Oklahoma,Nowata County,6,559,295,264
Oklahoma,Nowata County,7,603,302,301
Oklahoma,Nowata County,8,566,291,275
Oklahoma,Nowata County,9,578,304,274
Oklahoma,Nowata County,10,665,317,348
Oklahoma,Nowata County,11,799,403,396
Oklahoma,Nowata County,12,798,396,402
Oklahoma,Nowata County,13,659,318,341
Oklahoma,Nowata County,14,617,287,330
Oklahoma,Nowata County,15,511,243,268
Oklahoma,Nowata County,16,379,178,201
Oklahoma,Nowata County,17,255,96,159
Oklahoma,Nowata County,18,227,94,133
Oklahoma,Okfuskee County,0,12186,6503,5683
Oklahoma,Okfuskee County,1,831,413,418
Oklahoma,Okfuskee County,2,790,403,387
Oklahoma,Okfuskee County,3,722,382,340
Oklahoma,Okfuskee County,4,785,401,384
Oklahoma,Okfuskee County,5,762,439,323
Oklahoma,Okfuskee County,6,699,391,308
Oklahoma,Okfuskee County,7,782,462,320
Oklahoma,Okfuskee County,8,730,426,304
Oklahoma,Okfuskee County,9,783,464,319
Oklahoma,Okfuskee County,10,779,449,330
Oklahoma,Okfuskee County,11,917,514,403
Oklahoma,Okfuskee County,12,826,444,382
Oklahoma,Okfuskee County,13,706,351,355
Oklahoma,Okfuskee County,14,665,332,333
Oklahoma,Okfuskee County,15,574,281,293
Oklahoma,Okfuskee County,16,359,170,189
Oklahoma,Okfuskee County,17,248,106,142
Oklahoma,Okfuskee County,18,228,75,153
Oklahoma,Oklahoma County,0,766215,375046,391169
Oklahoma,Oklahoma County,1,60014,30811,29203
Oklahoma,Oklahoma County,2,55678,28397,27281
Oklahoma,Oklahoma County,3,51415,26397,25018
Oklahoma,Oklahoma County,4,47055,24107,22948
Oklahoma,Oklahoma County,5,55581,27695,27886
Oklahoma,Oklahoma County,6,62196,30861,31335
Oklahoma,Oklahoma County,7,58805,29489,29316
Oklahoma,Oklahoma County,8,49480,24517,24963
Oklahoma,Oklahoma County,9,46384,22964,23420
Oklahoma,Oklahoma County,10,43642,21443,22199
Oklahoma,Oklahoma County,11,49985,24273,25712
Oklahoma,Oklahoma County,12,48670,23482,25188
Oklahoma,Oklahoma County,13,41549,19718,21831
Oklahoma,Oklahoma County,14,32176,14978,17198
Oklahoma,Oklahoma County,15,22184,9891,12293
Oklahoma,Oklahoma County,16,16241,6952,9289
Oklahoma,Oklahoma County,17,12462,4861,7601
Oklahoma,Oklahoma County,18,12698,4210,8488
Oklahoma,Okmulgee County,0,39095,19292,19803
Oklahoma,Okmulgee County,1,2390,1270,1120
Oklahoma,Okmulgee County,2,2595,1293,1302
Oklahoma,Okmulgee County,3,2717,1373,1344
Oklahoma,Okmulgee County,4,2732,1446,1286
Oklahoma,Okmulgee County,5,2829,1571,1258
Oklahoma,Okmulgee County,6,2218,1141,1077
Oklahoma,Okmulgee County,7,2305,1128,1177
Oklahoma,Okmulgee County,8,2035,987,1048
Oklahoma,Okmulgee County,9,2227,1116,1111
Oklahoma,Okmulgee County,10,2332,1145,1187
Oklahoma,Okmulgee County,11,2745,1338,1407
Oklahoma,Okmulgee County,12,2747,1332,1415
Oklahoma,Okmulgee County,13,2458,1154,1304
Oklahoma,Okmulgee County,14,2136,997,1139
Oklahoma,Okmulgee County,15,1734,816,918
Oklahoma,Okmulgee County,16,1233,548,685
Oklahoma,Okmulgee County,17,898,367,531
Oklahoma,Okmulgee County,18,764,270,494
Oklahoma,Osage County,0,47981,24140,23841
Oklahoma,Osage County,1,2485,1226,1259
Oklahoma,Osage County,2,3035,1515,1520
Oklahoma,Osage County,3,3380,1778,1602
Oklahoma,Osage County,4,3116,1659,1457
Oklahoma,Osage County,5,2726,1453,1273
Oklahoma,Osage County,6,2496,1347,1149
Oklahoma,Osage County,7,2778,1475,1303
Oklahoma,Osage County,8,2658,1321,1337
Oklahoma,Osage County,9,2774,1435,1339
Oklahoma,Osage County,10,3023,1540,1483
Oklahoma,Osage County,11,3650,1839,1811
Oklahoma,Osage County,12,3744,1842,1902
Oklahoma,Osage County,13,3255,1589,1666
Oklahoma,Osage County,14,2922,1373,1549
Oklahoma,Osage County,15,2316,1136,1180
Oklahoma,Osage County,16,1662,765,897
Oklahoma,Osage County,17,1131,497,634
Oklahoma,Osage County,18,830,350,480
Oklahoma,Ottawa County,0,32105,15728,16377
Oklahoma,Ottawa County,1,2230,1129,1101
Oklahoma,Ottawa County,2,2222,1141,1081
Oklahoma,Ottawa County,3,2159,1138,1021
Oklahoma,Ottawa County,4,2380,1244,1136
Oklahoma,Ottawa County,5,2256,1183,1073
Oklahoma,Ottawa County,6,1771,838,933
Oklahoma,Ottawa County,7,1804,884,920
Oklahoma,Ottawa County,8,1775,879,896
Oklahoma,Ottawa County,9,1876,960,916
Oklahoma,Ottawa County,10,1847,882,965
Oklahoma,Ottawa County,11,2129,1031,1098
Oklahoma,Ottawa County,12,1994,979,1015
Oklahoma,Ottawa County,13,1867,881,986
Oklahoma,Ottawa County,14,1862,875,987
Oklahoma,Ottawa County,15,1458,678,780
Oklahoma,Ottawa County,16,1046,464,582
Oklahoma,Ottawa County,17,749,318,431
Oklahoma,Ottawa County,18,680,224,456
Oklahoma,Pawnee County,0,16401,8182,8219
Oklahoma,Pawnee County,1,1010,563,447
Oklahoma,Pawnee County,2,1080,555,525
Oklahoma,Pawnee County,3,1153,590,563
Oklahoma,Pawnee County,4,1075,549,526
Oklahoma,Pawnee County,5,904,474,430
Oklahoma,Pawnee County,6,801,394,407
Oklahoma,Pawnee County,7,898,435,463
Oklahoma,Pawnee County,8,922,479,443
Oklahoma,Pawnee County,9,975,457,518
Oklahoma,Pawnee County,10,1104,577,527
Oklahoma,Pawnee County,11,1158,580,578
Oklahoma,Pawnee County,12,1274,609,665
Oklahoma,Pawnee County,13,1076,520,556
Oklahoma,Pawnee County,14,991,503,488
Oklahoma,Pawnee County,15,782,374,408
Oklahoma,Pawnee County,16,554,259,295
Oklahoma,Pawnee County,17,343,157,186
Oklahoma,Pawnee County,18,301,107,194
Oklahoma,Payne County,0,80264,41050,39214
Oklahoma,Payne County,1,4601,2260,2341
Oklahoma,Payne County,2,4427,2283,2144
Oklahoma,Payne County,3,4184,2208,1976
Oklahoma,Payne County,4,7541,3734,3807
Oklahoma,Payne County,5,17161,9484,7677
Oklahoma,Payne County,6,5948,3209,2739
Oklahoma,Payne County,7,5035,2638,2397
Oklahoma,Payne County,8,4094,2164,1930
Oklahoma,Payne County,9,3508,1794,1714
Oklahoma,Payne County,10,3364,1715,1649
Oklahoma,Payne County,11,4080,1977,2103
Oklahoma,Payne County,12,3909,1927,1982
Oklahoma,Payne County,13,3479,1677,1802
Oklahoma,Payne County,14,2804,1327,1477
Oklahoma,Payne County,15,2193,991,1202
Oklahoma,Payne County,16,1592,688,904
Oklahoma,Payne County,17,1116,485,631
Oklahoma,Payne County,18,1228,489,739
Oklahoma,Pittsburg County,0,44626,22676,21950
Oklahoma,Pittsburg County,1,2795,1435,1360
Oklahoma,Pittsburg County,2,2829,1415,1414
Oklahoma,Pittsburg County,3,2681,1372,1309
Oklahoma,Pittsburg County,4,2506,1273,1233
Oklahoma,Pittsburg County,5,2723,1437,1286
Oklahoma,Pittsburg County,6,2938,1688,1250
Oklahoma,Pittsburg County,7,2913,1593,1320
Oklahoma,Pittsburg County,8,2636,1468,1168
Oklahoma,Pittsburg County,9,2558,1375,1183
Oklahoma,Pittsburg County,10,2769,1489,1280
Oklahoma,Pittsburg County,11,3205,1624,1581
Oklahoma,Pittsburg County,12,3037,1456,1581
Oklahoma,Pittsburg County,13,2945,1483,1462
Oklahoma,Pittsburg County,14,2544,1213,1331
Oklahoma,Pittsburg County,15,2098,946,1152
Oklahoma,Pittsburg County,16,1439,627,812
Oklahoma,Pittsburg County,17,1008,421,587
Oklahoma,Pittsburg County,18,1002,361,641
Oklahoma,Pontotoc County,0,38005,18549,19456
Oklahoma,Pontotoc County,1,2678,1423,1255
Oklahoma,Pontotoc County,2,2582,1343,1239
Oklahoma,Pontotoc County,3,2378,1184,1194
Oklahoma,Pontotoc County,4,2589,1269,1320
Oklahoma,Pontotoc County,5,3267,1601,1666
Oklahoma,Pontotoc County,6,2855,1441,1414
Oklahoma,Pontotoc County,7,2477,1300,1177
Oklahoma,Pontotoc County,8,2125,1023,1102
Oklahoma,Pontotoc County,9,2054,984,1070
Oklahoma,Pontotoc County,10,2108,1044,1064
Oklahoma,Pontotoc County,11,2498,1226,1272
Oklahoma,Pontotoc County,12,2378,1131,1247
Oklahoma,Pontotoc County,13,2053,966,1087
Oklahoma,Pontotoc County,14,1851,869,982
Oklahoma,Pontotoc County,15,1440,672,768
Oklahoma,Pontotoc County,16,1135,502,633
Oklahoma,Pontotoc County,17,842,344,498
Oklahoma,Pontotoc County,18,695,227,468
Oklahoma,Pottawatomie County,0,71811,34258,37553
Oklahoma,Pottawatomie County,1,4793,2448,2345
Oklahoma,Pottawatomie County,2,4878,2439,2439
Oklahoma,Pottawatomie County,3,4863,2508,2355
Oklahoma,Pottawatomie County,4,5012,2549,2463
Oklahoma,Pottawatomie County,5,5122,2411,2711
Oklahoma,Pottawatomie County,6,4582,2152,2430
Oklahoma,Pottawatomie County,7,4603,2068,2535
Oklahoma,Pottawatomie County,8,4266,2036,2230
Oklahoma,Pottawatomie County,9,4470,2082,2388
Oklahoma,Pottawatomie County,10,4253,2031,2222
Oklahoma,Pottawatomie County,11,5022,2384,2638
Oklahoma,Pottawatomie County,12,4639,2251,2388
Oklahoma,Pottawatomie County,13,4099,1924,2175
Oklahoma,Pottawatomie County,14,3616,1663,1953
Oklahoma,Pottawatomie County,15,2935,1382,1553
Oklahoma,Pottawatomie County,16,2019,920,1099
Oklahoma,Pottawatomie County,17,1404,585,819
Oklahoma,Pottawatomie County,18,1235,425,810
Oklahoma,Pushmataha County,0,11125,5450,5675
Oklahoma,Pushmataha County,1,624,320,304
Oklahoma,Pushmataha County,2,672,354,318
Oklahoma,Pushmataha County,3,682,350,332
Oklahoma,Pushmataha County,4,670,349,321
Oklahoma,Pushmataha County,5,583,294,289
Oklahoma,Pushmataha County,6,580,266,314
Oklahoma,Pushmataha County,7,592,299,293
Oklahoma,Pushmataha County,8,555,285,270
Oklahoma,Pushmataha County,9,594,303,291
Oklahoma,Pushmataha County,10,694,322,372
Oklahoma,Pushmataha County,11,830,420,410
Oklahoma,Pushmataha County,12,790,402,388
Oklahoma,Pushmataha County,13,792,364,428
Oklahoma,Pushmataha County,14,750,342,408
Oklahoma,Pushmataha County,15,665,327,338
Oklahoma,Pushmataha County,16,464,215,249
Oklahoma,Pushmataha County,17,298,113,185
Oklahoma,Pushmataha County,18,290,125,165
Oklahoma,Roger Mills County,0,3761,1900,1861
Oklahoma,Roger Mills County,1,247,146,101
Oklahoma,Roger Mills County,2,300,144,156
Oklahoma,Roger Mills County,3,285,141,144
Oklahoma,Roger Mills County,4,201,99,102
Oklahoma,Roger Mills County,5,174,91,83
Oklahoma,Roger Mills County,6,192,102,90
Oklahoma,Roger Mills County,7,265,130,135
Oklahoma,Roger Mills County,8,210,111,99
Oklahoma,Roger Mills County,9,206,112,94
Oklahoma,Roger Mills County,10,218,116,102
Oklahoma,Roger Mills County,11,247,121,126
Oklahoma,Roger Mills County,12,273,147,126
Oklahoma,Roger Mills County,13,256,132,124
Oklahoma,Roger Mills County,14,214,103,111
Oklahoma,Roger Mills County,15,155,70,85
Oklahoma,Roger Mills County,16,146,56,90
Oklahoma,Roger Mills County,17,88,40,48
Oklahoma,Roger Mills County,18,84,39,45
Oklahoma,Rogers County,0,89815,44711,45104
Oklahoma,Rogers County,1,5093,2656,2437
Oklahoma,Rogers County,2,6032,3119,2913
Oklahoma,Rogers County,3,6696,3417,3279
Oklahoma,Rogers County,4,6521,3331,3190
Oklahoma,Rogers County,5,5801,2953,2848
Oklahoma,Rogers County,6,5174,2638,2536
Oklahoma,Rogers County,7,5349,2611,2738
Oklahoma,Rogers County,8,5172,2551,2621
Oklahoma,Rogers County,9,5863,2918,2945
Oklahoma,Rogers County,10,6032,2974,3058
Oklahoma,Rogers County,11,6859,3404,3455
Oklahoma,Rogers County,12,6208,3078,3130
Oklahoma,Rogers County,13,5167,2541,2626
Oklahoma,Rogers County,14,4604,2240,2364
Oklahoma,Rogers County,15,3574,1682,1892
Oklahoma,Rogers County,16,2559,1195,1364
Oklahoma,Rogers County,17,1690,795,895
Oklahoma,Rogers County,18,1421,608,813
Oklahoma,Seminole County,0,25421,12484,12937
Oklahoma,Seminole County,1,1657,842,815
Oklahoma,Seminole County,2,1690,895,795
Oklahoma,Seminole County,3,1952,969,983
Oklahoma,Seminole County,4,1860,990,870
Oklahoma,Seminole County,5,1592,804,788
Oklahoma,Seminole County,6,1315,665,650
Oklahoma,Seminole County,7,1503,733,770
Oklahoma,Seminole County,8,1394,652,742
Oklahoma,Seminole County,9,1488,754,734
Oklahoma,Seminole County,10,1548,758,790
Oklahoma,Seminole County,11,1823,885,938
Oklahoma,Seminole County,12,1705,850,855
Oklahoma,Seminole County,13,1561,748,813
Oklahoma,Seminole County,14,1329,638,691
Oklahoma,Seminole County,15,1125,492,633
Oklahoma,Seminole County,16,820,401,419
Oklahoma,Seminole County,17,532,214,318
Oklahoma,Seminole County,18,527,194,333
Oklahoma,Sequoyah County,0,41358,20411,20947
Oklahoma,Sequoyah County,1,2379,1182,1197
Oklahoma,Sequoyah County,2,2819,1469,1350
Oklahoma,Sequoyah County,3,2935,1509,1426
Oklahoma,Sequoyah County,4,2835,1505,1330
Oklahoma,Sequoyah County,5,2476,1269,1207
Oklahoma,Sequoyah County,6,2292,1126,1166
Oklahoma,Sequoyah County,7,2402,1196,1206
Oklahoma,Sequoyah County,8,2408,1197,1211
Oklahoma,Sequoyah County,9,2677,1288,1389
Oklahoma,Sequoyah County,10,2752,1351,1401
Oklahoma,Sequoyah County,11,3078,1543,1535
Oklahoma,Sequoyah County,12,2695,1278,1417
Oklahoma,Sequoyah County,13,2609,1236,1373
Oklahoma,Sequoyah County,14,2326,1151,1175
Oklahoma,Sequoyah County,15,1877,870,1007
Oklahoma,Sequoyah County,16,1299,612,687
Oklahoma,Sequoyah County,17,822,381,441
Oklahoma,Sequoyah County,18,677,248,429
Oklahoma,Stephens County,0,44493,21666,22827
Oklahoma,Stephens County,1,2865,1431,1434
Oklahoma,Stephens County,2,2934,1481,1453
Oklahoma,Stephens County,3,2975,1497,1478
Oklahoma,Stephens County,4,2788,1406,1382
Oklahoma,Stephens County,5,2585,1303,1282
Oklahoma,Stephens County,6,2590,1299,1291
Oklahoma,Stephens County,7,2766,1380,1386
Oklahoma,Stephens County,8,2576,1283,1293
Oklahoma,Stephens County,9,2519,1248,1271
Oklahoma,Stephens County,10,2518,1232,1286
Oklahoma,Stephens County,11,3171,1572,1599
Oklahoma,Stephens County,12,3250,1594,1656
Oklahoma,Stephens County,13,2956,1421,1535
Oklahoma,Stephens County,14,2378,1111,1267
Oklahoma,Stephens County,15,1900,869,1031
Oklahoma,Stephens County,16,1535,683,852
Oklahoma,Stephens County,17,1141,476,665
Oklahoma,Stephens County,18,1046,380,666
Oklahoma,Texas County,0,21853,11617,10236
Oklahoma,Texas County,1,1774,892,882
Oklahoma,Texas County,2,1695,847,848
Oklahoma,Texas County,3,1636,865,771
Oklahoma,Texas County,4,1613,890,723
Oklahoma,Texas County,5,1831,1078,753
Oklahoma,Texas County,6,1600,909,691
Oklahoma,Texas County,7,1617,916,701
Oklahoma,Texas County,8,1459,802,657
Oklahoma,Texas County,9,1405,704,701
Oklahoma,Texas County,10,1298,709,589
Oklahoma,Texas County,11,1339,717,622
Oklahoma,Texas County,12,1248,658,590
Oklahoma,Texas County,13,1051,519,532
Oklahoma,Texas County,14,731,388,343
Oklahoma,Texas County,15,518,265,253
Oklahoma,Texas County,16,441,222,219
Oklahoma,Texas County,17,303,129,174
Oklahoma,Texas County,18,294,107,187
Oklahoma,Tillman County,0,7628,3807,3821
Oklahoma,Tillman County,1,475,224,251
Oklahoma,Tillman County,2,538,262,276
Oklahoma,Tillman County,3,519,259,260
Oklahoma,Tillman County,4,512,265,247
Oklahoma,Tillman County,5,431,237,194
Oklahoma,Tillman County,6,448,241,207
Oklahoma,Tillman County,7,458,231,227
Oklahoma,Tillman County,8,392,217,175
Oklahoma,Tillman County,9,428,218,210
Oklahoma,Tillman County,10,470,244,226
Oklahoma,Tillman County,11,560,295,265
Oklahoma,Tillman County,12,523,268,255
Oklahoma,Tillman County,13,486,227,259
Oklahoma,Tillman County,14,427,211,216
Oklahoma,Tillman County,15,336,153,183
Oklahoma,Tillman County,16,277,122,155
Oklahoma,Tillman County,17,169,82,87
Oklahoma,Tillman County,18,179,51,128
Oklahoma,Tulsa County,0,629598,306577,323021
Oklahoma,Tulsa County,1,46452,23581,22871
Oklahoma,Tulsa County,2,45455,23273,22182
Oklahoma,Tulsa County,3,43535,22397,21138
Oklahoma,Tulsa County,4,40270,20590,19680
Oklahoma,Tulsa County,5,43664,21552,22112
Oklahoma,Tulsa County,6,46320,22731,23589
Oklahoma,Tulsa County,7,45851,22666,23185
Oklahoma,Tulsa County,8,40768,20075,20693
Oklahoma,Tulsa County,9,39784,19770,20014
Oklahoma,Tulsa County,10,38286,18968,19318
Oklahoma,Tulsa County,11,41646,20363,21283
Oklahoma,Tulsa County,12,40906,19477,21429
Oklahoma,Tulsa County,13,34870,16606,18264
Oklahoma,Tulsa County,14,27356,12531,14825
Oklahoma,Tulsa County,15,18879,8397,10482
Oklahoma,Tulsa County,16,13692,5741,7951
Oklahoma,Tulsa County,17,10516,4088,6428
Oklahoma,Tulsa County,18,11348,3771,7577
Oklahoma,Wagoner County,0,75702,37467,38235
Oklahoma,Wagoner County,1,4700,2439,2261
Oklahoma,Wagoner County,2,5382,2725,2657
Oklahoma,Wagoner County,3,5662,2863,2799
Oklahoma,Wagoner County,4,4947,2606,2341
Oklahoma,Wagoner County,5,4151,2166,1985
Oklahoma,Wagoner County,6,4329,2067,2262
Oklahoma,Wagoner County,7,5182,2522,2660
Oklahoma,Wagoner County,8,4845,2372,2473
Oklahoma,Wagoner County,9,5143,2591,2552
Oklahoma,Wagoner County,10,4892,2453,2439
Oklahoma,Wagoner County,11,5323,2664,2659
Oklahoma,Wagoner County,12,5235,2504,2731
Oklahoma,Wagoner County,13,4657,2197,2460
Oklahoma,Wagoner County,14,4162,2028,2134
Oklahoma,Wagoner County,15,3075,1451,1624
Oklahoma,Wagoner County,16,1952,960,992
Oklahoma,Wagoner County,17,1155,501,654
Oklahoma,Wagoner County,18,910,358,552
Oklahoma,Washington County,0,51937,25233,26704
Oklahoma,Washington County,1,3303,1716,1587
Oklahoma,Washington County,2,3439,1793,1646
Oklahoma,Washington County,3,3490,1838,1652
Oklahoma,Washington County,4,3260,1708,1552
Oklahoma,Washington County,5,3200,1627,1573
Oklahoma,Washington County,6,2993,1500,1493
Oklahoma,Washington County,7,3251,1632,1619
Oklahoma,Washington County,8,2881,1403,1478
Oklahoma,Washington County,9,2981,1447,1534
Oklahoma,Washington County,10,2877,1348,1529
Oklahoma,Washington County,11,3591,1643,1948
Oklahoma,Washington County,12,3845,1854,1991
Oklahoma,Washington County,13,3168,1532,1636
Oklahoma,Washington County,14,2747,1247,1500
Oklahoma,Washington County,15,2210,998,1212
Oklahoma,Washington County,16,1838,805,1033
Oklahoma,Washington County,17,1419,590,829
Oklahoma,Washington County,18,1444,552,892
Oklahoma,Washita County,0,11547,5792,5755
Oklahoma,Washita County,1,770,448,322
Oklahoma,Washita County,2,837,450,387
Oklahoma,Washita County,3,849,419,430
Oklahoma,Washita County,4,765,377,388
Oklahoma,Washita County,5,621,337,284
Oklahoma,Washita County,6,706,340,366
Oklahoma,Washita County,7,779,395,384
Oklahoma,Washita County,8,679,354,325
Oklahoma,Washita County,9,604,307,297
Oklahoma,Washita County,10,638,336,302
Oklahoma,Washita County,11,849,426,423
Oklahoma,Washita County,12,869,450,419
Oklahoma,Washita County,13,670,326,344
Oklahoma,Washita County,14,539,256,283
Oklahoma,Washita County,15,446,197,249
Oklahoma,Washita County,16,348,168,180
Oklahoma,Washita County,17,262,109,153
Oklahoma,Washita County,18,316,97,219
Oklahoma,Woods County,0,9288,4999,4289
Oklahoma,Woods County,1,552,278,274
Oklahoma,Woods County,2,563,291,272
Oklahoma,Woods County,3,484,259,225
Oklahoma,Woods County,4,713,403,310
Oklahoma,Woods County,5,1218,766,452
Oklahoma,Woods County,6,727,439,288
Oklahoma,Woods County,7,592,347,245
Oklahoma,Woods County,8,511,264,247
Oklahoma,Woods County,9,396,214,182
Oklahoma,Woods County,10,460,243,217
Oklahoma,Woods County,11,549,277,272
Oklahoma,Woods County,12,526,257,269
Oklahoma,Woods County,13,503,265,238
Oklahoma,Woods County,14,388,188,200
Oklahoma,Woods County,15,334,165,169
Oklahoma,Woods County,16,307,150,157
Oklahoma,Woods County,17,209,97,112
Oklahoma,Woods County,18,256,96,160
Oklahoma,Woodward County,0,21529,11402,10127
Oklahoma,Woodward County,1,1606,867,739
Oklahoma,Woodward County,2,1585,801,784
Oklahoma,Woodward County,3,1482,734,748
Oklahoma,Woodward County,4,1325,700,625
Oklahoma,Woodward County,5,1427,794,633
Oklahoma,Woodward County,6,1611,943,668
Oklahoma,Woodward County,7,1639,921,718
Oklahoma,Woodward County,8,1412,820,592
Oklahoma,Woodward County,9,1290,721,569
Oklahoma,Woodward County,10,1248,714,534
Oklahoma,Woodward County,11,1471,764,707
Oklahoma,Woodward County,12,1374,732,642
Oklahoma,Woodward County,13,1073,542,531
Oklahoma,Woodward County,14,904,435,469
Oklahoma,Woodward County,15,792,388,404
Oklahoma,Woodward County,16,598,274,324
Oklahoma,Woodward County,17,375,147,228
Oklahoma,Woodward County,18,317,105,212
Oregon,Baker County,0,16059,8112,7947
Oregon,Baker County,1,840,448,392
Oregon,Baker County,2,883,440,443
Oregon,Baker County,3,844,437,407
Oregon,Baker County,4,856,454,402
Oregon,Baker County,5,767,436,331
Oregon,Baker County,6,805,400,405
Oregon,Baker County,7,865,456,409
Oregon,Baker County,8,731,399,332
Oregon,Baker County,9,850,445,405
Oregon,Baker County,10,900,450,450
Oregon,Baker County,11,1129,542,587
Oregon,Baker County,12,1253,605,648
Oregon,Baker County,13,1366,677,689
Oregon,Baker County,14,1241,598,643
Oregon,Baker County,15,1025,515,510
Oregon,Baker County,16,740,373,367
Oregon,Baker County,17,475,229,246
Oregon,Baker County,18,489,208,281
Oregon,Benton County,0,86316,43279,43037
Oregon,Benton County,1,3579,1824,1755
Oregon,Benton County,2,4012,2019,1993
Oregon,Benton County,3,4248,2085,2163
Oregon,Benton County,4,7650,3912,3738
Oregon,Benton County,5,14554,7816,6738
Oregon,Benton County,6,6184,3339,2845
Oregon,Benton County,7,4950,2566,2384
Oregon,Benton County,8,4223,2129,2094
Oregon,Benton County,9,4307,2135,2172
Oregon,Benton County,10,4184,2051,2133
Oregon,Benton County,11,4979,2388,2591
Oregon,Benton County,12,5504,2547,2957
Oregon,Benton County,13,5567,2752,2815
Oregon,Benton County,14,4301,2170,2131
Oregon,Benton County,15,2887,1367,1520
Oregon,Benton County,16,1949,896,1053
Oregon,Benton County,17,1482,661,821
Oregon,Benton County,18,1756,622,1134
Oregon,Clackamas County,0,394972,194337,200635
Oregon,Clackamas County,1,20922,10734,10188
Oregon,Clackamas County,2,23946,12255,11691
Oregon,Clackamas County,3,25932,13268,12664
Oregon,Clackamas County,4,25741,13347,12394
Oregon,Clackamas County,5,23076,11740,11336
Oregon,Clackamas County,6,22658,11610,11048
Oregon,Clackamas County,7,23664,11795,11869
Oregon,Clackamas County,8,24354,12105,12249
Oregon,Clackamas County,9,25851,12747,13104
Oregon,Clackamas County,10,26804,13168,13636
Oregon,Clackamas County,11,29960,14671,15289
Oregon,Clackamas County,12,30190,14720,15470
Oregon,Clackamas County,13,28078,13582,14496
Oregon,Clackamas County,14,22902,10913,11989
Oregon,Clackamas County,15,15653,7443,8210
Oregon,Clackamas County,16,9822,4471,5351
Oregon,Clackamas County,17,6771,2846,3925
Oregon,Clackamas County,18,8648,2922,5726
Oregon,Clatsop County,0,37474,18499,18975
Oregon,Clatsop County,1,1984,983,1001
Oregon,Clatsop County,2,2078,1003,1075
Oregon,Clatsop County,3,2007,1029,978
Oregon,Clatsop County,4,2072,1056,1016
Oregon,Clatsop County,5,2291,1205,1086
Oregon,Clatsop County,6,2302,1176,1126
Oregon,Clatsop County,7,2338,1182,1156
Oregon,Clatsop County,8,2083,1060,1023
Oregon,Clatsop County,9,2018,1012,1006
Oregon,Clatsop County,10,2093,1029,1064
Oregon,Clatsop County,11,2689,1328,1361
Oregon,Clatsop County,12,3054,1488,1566
Oregon,Clatsop County,13,3222,1563,1659
Oregon,Clatsop County,14,2675,1341,1334
Oregon,Clatsop County,15,1819,878,941
Oregon,Clatsop County,16,1167,580,587
Oregon,Clatsop County,17,770,313,457
Oregon,Clatsop County,18,812,273,539
Oregon,Columbia County,0,49459,24601,24858
Oregon,Columbia County,1,2539,1286,1253
Oregon,Columbia County,2,2959,1537,1422
Oregon,Columbia County,3,3390,1734,1656
Oregon,Columbia County,4,3249,1710,1539
Oregon,Columbia County,5,2611,1319,1292
Oregon,Columbia County,6,2531,1241,1290
Oregon,Columbia County,7,2769,1366,1403
Oregon,Columbia County,8,2916,1395,1521
Oregon,Columbia County,9,3146,1561,1585
Oregon,Columbia County,10,3303,1687,1616
Oregon,Columbia County,11,3834,1900,1934
Oregon,Columbia County,12,4013,1998,2015
Oregon,Columbia County,13,3723,1852,1871
Oregon,Columbia County,14,3123,1526,1597
Oregon,Columbia County,15,2207,1127,1080
Oregon,Columbia County,16,1357,664,693
Oregon,Columbia County,17,906,387,519
Oregon,Columbia County,18,883,311,572
Oregon,Coos County,0,62475,30804,31671
Oregon,Coos County,1,3081,1579,1502
Oregon,Coos County,2,3217,1617,1600
Oregon,Coos County,3,3222,1623,1599
Oregon,Coos County,4,3115,1583,1532
Oregon,Coos County,5,3425,1735,1690
Oregon,Coos County,6,3276,1672,1604
Oregon,Coos County,7,3415,1763,1652
Oregon,Coos County,8,3138,1599,1539
Oregon,Coos County,9,3133,1579,1554
Oregon,Coos County,10,3395,1724,1671
Oregon,Coos County,11,4477,2150,2327
Oregon,Coos County,12,5212,2470,2742
Oregon,Coos County,13,5362,2533,2829
Oregon,Coos County,14,4831,2376,2455
Oregon,Coos County,15,3848,1859,1989
Oregon,Coos County,16,2784,1340,1444
Oregon,Coos County,17,1870,887,983
Oregon,Coos County,18,1674,715,959
Oregon,Crook County,0,20998,10365,10633
Oregon,Crook County,1,894,432,462
Oregon,Crook County,2,1107,572,535
Oregon,Crook County,3,1242,652,590
Oregon,Crook County,4,1232,616,616
Oregon,Crook County,5,929,487,442
Oregon,Crook County,6,901,448,453
Oregon,Crook County,7,1014,493,521
Oregon,Crook County,8,1179,565,614
Oregon,Crook County,9,1141,565,576
Oregon,Crook County,10,1178,568,610
Oregon,Crook County,11,1526,728,798
Oregon,Crook County,12,1739,844,895
Oregon,Crook County,13,1838,847,991
Oregon,Crook County,14,1839,921,918
Oregon,Crook County,15,1336,738,598
Oregon,Crook County,16,853,433,420
Oregon,Crook County,17,544,238,306
Oregon,Crook County,18,506,218,288
Oregon,Curry County,0,22335,11014,11321
Oregon,Curry County,1,956,496,460
Oregon,Curry County,2,854,452,402
Oregon,Curry County,3,985,511,474
Oregon,Curry County,4,1038,584,454
Oregon,Curry County,5,875,463,412
Oregon,Curry County,6,876,437,439
Oregon,Curry County,7,902,461,441
Oregon,Curry County,8,902,441,461
Oregon,Curry County,9,987,476,511
Oregon,Curry County,10,1192,576,616
Oregon,Curry County,11,1590,764,826
Oregon,Curry County,12,1919,879,1040
Oregon,Curry County,13,2270,1109,1161
Oregon,Curry County,14,2239,1095,1144
Oregon,Curry County,15,1788,900,888
Oregon,Curry County,16,1297,635,662
Oregon,Curry County,17,835,400,435
Oregon,Curry County,18,830,335,495
Oregon,Deschutes County,0,170388,83917,86471
Oregon,Deschutes County,1,9006,4640,4366
Oregon,Deschutes County,2,10377,5360,5017
Oregon,Deschutes County,3,10524,5297,5227
Oregon,Deschutes County,4,9820,5082,4738
Oregon,Deschutes County,5,8677,4371,4306
Oregon,Deschutes County,6,9916,4967,4949
Oregon,Deschutes County,7,11028,5465,5563
Oregon,Deschutes County,8,10786,5360,5426
Oregon,Deschutes County,9,11505,5807,5698
Oregon,Deschutes County,10,10747,5267,5480
Oregon,Deschutes County,11,11576,5486,6090
Oregon,Deschutes County,12,12443,5848,6595
Oregon,Deschutes County,13,12813,6067,6746
Oregon,Deschutes County,14,11481,5686,5795
Oregon,Deschutes County,15,8041,3977,4064
Oregon,Deschutes County,16,5025,2531,2494
Oregon,Deschutes County,17,3162,1462,1700
Oregon,Deschutes County,18,3461,1244,2217
Oregon,Douglas County,0,106972,52790,54182
Oregon,Douglas County,1,5446,2785,2661
Oregon,Douglas County,2,5743,2964,2779
Oregon,Douglas County,3,5861,2978,2883
Oregon,Douglas County,4,5993,3207,2786
Oregon,Douglas County,5,5624,2908,2716
Oregon,Douglas County,6,5599,2812,2787
Oregon,Douglas County,7,5563,2732,2831
Oregon,Douglas County,8,5381,2724,2657
Oregon,Douglas County,9,5572,2756,2816
Oregon,Douglas County,10,6037,2937,3100
Oregon,Douglas County,11,7558,3605,3953
Oregon,Douglas County,12,8620,4186,4434
Oregon,Douglas County,13,8723,4188,4535
Oregon,Douglas County,14,7978,3962,4016
Oregon,Douglas County,15,6215,3100,3115
Oregon,Douglas County,16,4603,2212,2391
Oregon,Douglas County,17,3227,1462,1765
Oregon,Douglas County,18,3229,1272,1957
Oregon,Gilliam County,0,1932,968,964
Oregon,Gilliam County,1,117,55,62
Oregon,Gilliam County,2,104,53,51
Oregon,Gilliam County,3,97,49,48
Oregon,Gilliam County,4,97,58,39
Oregon,Gilliam County,5,78,49,29
Oregon,Gilliam County,6,79,42,37
Oregon,Gilliam County,7,84,40,44
Oregon,Gilliam County,8,105,50,55
Oregon,Gilliam County,9,100,49,51
Oregon,Gilliam County,10,101,57,44
Oregon,Gilliam County,11,150,68,82
Oregon,Gilliam County,12,177,99,78
Oregon,Gilliam County,13,177,92,85
Oregon,Gilliam County,14,135,73,62
Oregon,Gilliam County,15,106,46,60
Oregon,Gilliam County,16,95,40,55
Oregon,Gilliam County,17,49,22,27
Oregon,Gilliam County,18,81,26,55
Oregon,Grant County,0,7180,3553,3627
Oregon,Grant County,1,334,157,177
Oregon,Grant County,2,353,186,167
Oregon,Grant County,3,380,179,201
Oregon,Grant County,4,382,195,187
Oregon,Grant County,5,270,149,121
Oregon,Grant County,6,302,149,153
Oregon,Grant County,7,331,158,173
Oregon,Grant County,8,328,165,163
Oregon,Grant County,9,351,170,181
Oregon,Grant County,10,359,162,197
Oregon,Grant County,11,510,260,250
Oregon,Grant County,12,629,287,342
Oregon,Grant County,13,691,351,340
Oregon,Grant County,14,593,297,296
Oregon,Grant County,15,497,270,227
Oregon,Grant County,16,367,179,188
Oregon,Grant County,17,258,133,125
Oregon,Grant County,18,245,106,139
Oregon,Harney County,0,7126,3605,3521
Oregon,Harney County,1,365,198,167
Oregon,Harney County,2,401,213,188
Oregon,Harney County,3,422,220,202
Oregon,Harney County,4,417,244,173
Oregon,Harney County,5,364,201,163
Oregon,Harney County,6,331,156,175
Oregon,Harney County,7,367,172,195
Oregon,Harney County,8,404,204,200
Oregon,Harney County,9,353,179,174
Oregon,Harney County,10,392,179,213
Oregon,Harney County,11,516,248,268
Oregon,Harney County,12,585,296,289
Oregon,Harney County,13,605,300,305
Oregon,Harney County,14,515,268,247
Oregon,Harney County,15,413,221,192
Oregon,Harney County,16,313,161,152
Oregon,Harney County,17,195,82,113
Oregon,Harney County,18,168,63,105
Oregon,Hood River County,0,22885,11461,11424
Oregon,Hood River County,1,1502,764,738
Oregon,Hood River County,2,1565,773,792
Oregon,Hood River County,3,1652,853,799
Oregon,Hood River County,4,1546,800,746
Oregon,Hood River County,5,1349,685,664
Oregon,Hood River County,6,1338,704,634
Oregon,Hood River County,7,1483,743,740
Oregon,Hood River County,8,1435,735,700
Oregon,Hood River County,9,1480,733,747
Oregon,Hood River County,10,1551,770,781
Oregon,Hood River County,11,1632,823,809
Oregon,Hood River County,12,1672,846,826
Oregon,Hood River County,13,1443,753,690
Oregon,Hood River County,14,1048,540,508
Oregon,Hood River County,15,747,355,392
Oregon,Hood River County,16,522,254,268
Oregon,Hood River County,17,425,184,241
Oregon,Hood River County,18,495,146,349
Oregon,Jackson County,0,210287,102304,107983
Oregon,Jackson County,1,11924,6010,5914
Oregon,Jackson County,2,12301,6234,6067
Oregon,Jackson County,3,12161,6203,5958
Oregon,Jackson County,4,12391,6207,6184
Oregon,Jackson County,5,12495,6216,6279
Oregon,Jackson County,6,12692,6281,6411
Oregon,Jackson County,7,12569,6311,6258
Oregon,Jackson County,8,11856,5845,6011
Oregon,Jackson County,9,11866,5918,5948
Oregon,Jackson County,10,12053,5976,6077
Oregon,Jackson County,11,14225,6920,7305
Oregon,Jackson County,12,15408,7292,8116
Oregon,Jackson County,13,15952,7605,8347
Oregon,Jackson County,14,14123,6744,7379
Oregon,Jackson County,15,10237,4885,5352
Oregon,Jackson County,16,7037,3277,3760
Oregon,Jackson County,17,5203,2247,2956
Oregon,Jackson County,18,5794,2133,3661
Oregon,Jefferson County,0,22192,11509,10683
Oregon,Jefferson County,1,1497,788,709
Oregon,Jefferson County,2,1532,820,712
Oregon,Jefferson County,3,1422,700,722
Oregon,Jefferson County,4,1382,725,657
Oregon,Jefferson County,5,1389,747,642
Oregon,Jefferson County,6,1310,707,603
Oregon,Jefferson County,7,1260,672,588
Oregon,Jefferson County,8,1225,655,570
Oregon,Jefferson County,9,1290,690,600
Oregon,Jefferson County,10,1320,699,621
Oregon,Jefferson County,11,1513,767,746
Oregon,Jefferson County,12,1515,767,748
Oregon,Jefferson County,13,1546,772,774
Oregon,Jefferson County,14,1428,716,712
Oregon,Jefferson County,15,1088,559,529
Oregon,Jefferson County,16,763,393,370
Oregon,Jefferson County,17,384,196,188
Oregon,Jefferson County,18,328,136,192
Oregon,Josephine County,0,83599,40837,42762
Oregon,Josephine County,1,4108,2166,1942
Oregon,Josephine County,2,4590,2359,2231
Oregon,Josephine County,3,4635,2399,2236
Oregon,Josephine County,4,4659,2420,2239
Oregon,Josephine County,5,4196,2185,2011
Oregon,Josephine County,6,4102,2086,2016
Oregon,Josephine County,7,4118,2055,2063
Oregon,Josephine County,8,4099,1988,2111
Oregon,Josephine County,9,4329,2178,2151
Oregon,Josephine County,10,4730,2309,2421
Oregon,Josephine County,11,5808,2755,3053
Oregon,Josephine County,12,6482,3043,3439
Oregon,Josephine County,13,6983,3261,3722
Oregon,Josephine County,14,6792,3256,3536
Oregon,Josephine County,15,5130,2441,2689
Oregon,Josephine County,16,3686,1757,1929
Oregon,Josephine County,17,2512,1151,1361
Oregon,Josephine County,18,2640,1028,1612
Oregon,Klamath County,0,65455,32661,32794
Oregon,Klamath County,1,3939,1970,1969
Oregon,Klamath County,2,3933,2008,1925
Oregon,Klamath County,3,3759,1953,1806
Oregon,Klamath County,4,4120,2178,1942
Oregon,Klamath County,5,4273,2205,2068
Oregon,Klamath County,6,4021,2056,1965
Oregon,Klamath County,7,3561,1790,1771
Oregon,Klamath County,8,3346,1685,1661
Oregon,Klamath County,9,3715,1859,1856
Oregon,Klamath County,10,3803,1901,1902
Oregon,Klamath County,11,4530,2190,2340
Oregon,Klamath County,12,4792,2341,2451
Oregon,Klamath County,13,5093,2456,2637
Oregon,Klamath County,14,4271,2179,2092
Oregon,Klamath County,15,3195,1587,1608
Oregon,Klamath County,16,2233,1086,1147
Oregon,Klamath County,17,1541,723,818
Oregon,Klamath County,18,1330,494,836
Oregon,Lake County,0,7838,4161,3677
Oregon,Lake County,1,333,171,162
Oregon,Lake County,2,428,212,216
Oregon,Lake County,3,424,215,209
Oregon,Lake County,4,429,215,214
Oregon,Lake County,5,343,198,145
Oregon,Lake County,6,384,217,167
Oregon,Lake County,7,391,222,169
Oregon,Lake County,8,441,233,208
Oregon,Lake County,9,462,272,190
Oregon,Lake County,10,509,287,222
Oregon,Lake County,11,598,335,263
Oregon,Lake County,12,649,313,336
Oregon,Lake County,13,648,342,306
Oregon,Lake County,14,614,314,300
Oregon,Lake County,15,457,242,215
Oregon,Lake County,16,309,176,133
Oregon,Lake County,17,229,112,117
Oregon,Lake County,18,190,85,105
Oregon,Lane County,0,358337,175938,182399
Oregon,Lane County,1,17550,8992,8558
Oregon,Lane County,2,18714,9510,9204
Oregon,Lane County,3,19744,10074,9670
Oregon,Lane County,4,24086,12179,11907
Oregon,Lane County,5,35448,17776,17672
Oregon,Lane County,6,21956,11419,10537
Oregon,Lane County,7,22662,11367,11295
Oregon,Lane County,8,21129,10655,10474
Oregon,Lane County,9,20148,10110,10038
Oregon,Lane County,10,20392,10213,10179
Oregon,Lane County,11,23192,11146,12046
Oregon,Lane County,12,24960,11719,13241
Oregon,Lane County,13,26022,12359,13663
Oregon,Lane County,14,21577,10486,11091
Oregon,Lane County,15,15049,7094,7955
Oregon,Lane County,16,10103,4652,5451
Oregon,Lane County,17,7181,3137,4044
Oregon,Lane County,18,8424,3050,5374
Oregon,Lincoln County,0,46406,22569,23837
Oregon,Lincoln County,1,2304,1217,1087
Oregon,Lincoln County,2,2189,1092,1097
Oregon,Lincoln County,3,2113,1110,1003
Oregon,Lincoln County,4,2161,1139,1022
Oregon,Lincoln County,5,2161,1140,1021
Oregon,Lincoln County,6,2190,1096,1094
Oregon,Lincoln County,7,2463,1230,1233
Oregon,Lincoln County,8,2279,1129,1150
Oregon,Lincoln County,9,2380,1243,1137
Oregon,Lincoln County,10,2459,1158,1301
Oregon,Lincoln County,11,3259,1526,1733
Oregon,Lincoln County,12,4133,1921,2212
Oregon,Lincoln County,13,4768,2205,2563
Oregon,Lincoln County,14,4189,1991,2198
Oregon,Lincoln County,15,3068,1425,1643
Oregon,Lincoln County,16,1943,943,1000
Oregon,Lincoln County,17,1208,566,642
Oregon,Lincoln County,18,1139,438,701
Oregon,Linn County,0,119356,59055,60301
Oregon,Linn County,1,7367,3856,3511
Oregon,Linn County,2,7699,4037,3662
Oregon,Linn County,3,7701,3928,3773
Oregon,Linn County,4,7414,3728,3686
Oregon,Linn County,5,7282,3688,3594
Oregon,Linn County,6,7682,3821,3861
Oregon,Linn County,7,7462,3666,3796
Oregon,Linn County,8,7126,3532,3594
Oregon,Linn County,9,7131,3568,3563
Oregon,Linn County,10,6977,3473,3504
Oregon,Linn County,11,8226,4067,4159
Oregon,Linn County,12,8423,4112,4311
Oregon,Linn County,13,8218,4083,4135
Oregon,Linn County,14,6855,3325,3530
Oregon,Linn County,15,5216,2505,2711
Oregon,Linn County,16,3572,1623,1949
Oregon,Linn County,17,2456,1068,1388
Oregon,Linn County,18,2549,975,1574
Oregon,Malheur County,0,30359,16559,13800
Oregon,Malheur County,1,2138,1109,1029
Oregon,Malheur County,2,2191,1122,1069
Oregon,Malheur County,3,2080,1054,1026
Oregon,Malheur County,4,2060,1068,992
Oregon,Malheur County,5,2164,1322,842
Oregon,Malheur County,6,1958,1196,762
Oregon,Malheur County,7,2006,1181,825
Oregon,Malheur County,8,1858,1125,733
Oregon,Malheur County,9,1859,1118,741
Oregon,Malheur County,10,1774,1061,713
Oregon,Malheur County,11,1875,1019,856
Oregon,Malheur County,12,1839,1000,839
Oregon,Malheur County,13,1768,902,866
Oregon,Malheur County,14,1454,736,718
Oregon,Malheur County,15,1141,555,586
Oregon,Malheur County,16,916,437,479
Oregon,Malheur County,17,599,272,327
Oregon,Malheur County,18,679,282,397
Oregon,Marion County,0,326110,162586,163524
Oregon,Marion County,1,22244,11521,10723
Oregon,Marion County,2,23815,12189,11626
Oregon,Marion County,3,22904,11641,11263
Oregon,Marion County,4,22965,11909,11056
Oregon,Marion County,5,22618,11576,11042
Oregon,Marion County,6,21896,11235,10661
Oregon,Marion County,7,22143,11340,10803
Oregon,Marion County,8,20575,10571,10004
Oregon,Marion County,9,20226,10410,9816
Oregon,Marion County,10,19360,9907,9453
Oregon,Marion County,11,20694,10306,10388
Oregon,Marion County,12,20596,9998,10598
Oregon,Marion County,13,19105,9065,10040
Oregon,Marion County,14,15807,7545,8262
Oregon,Marion County,15,11254,5151,6103
Oregon,Marion County,16,7798,3554,4244
Oregon,Marion County,17,5646,2379,3267
Oregon,Marion County,18,6464,2289,4175
Oregon,Morrow County,0,11187,5733,5454
Oregon,Morrow County,1,788,413,375
Oregon,Morrow County,2,872,455,417
Oregon,Morrow County,3,901,468,433
Oregon,Morrow County,4,881,461,420
Oregon,Morrow County,5,679,379,300
Oregon,Morrow County,6,556,257,299
Oregon,Morrow County,7,624,322,302
Oregon,Morrow County,8,641,333,308
Oregon,Morrow County,9,700,352,348
Oregon,Morrow County,10,659,342,317
Oregon,Morrow County,11,701,363,338
Oregon,Morrow County,12,839,417,422
Oregon,Morrow County,13,729,344,385
Oregon,Morrow County,14,552,297,255
Oregon,Morrow County,15,420,199,221
Oregon,Morrow County,16,300,151,149
Oregon,Morrow County,17,203,111,92
Oregon,Morrow County,18,142,69,73
Oregon,Multnomah County,0,776712,384018,392694
Oregon,Multnomah County,1,46029,23465,22564
Oregon,Multnomah County,2,43752,22346,21406
Oregon,Multnomah County,3,40491,20686,19805
Oregon,Multnomah County,4,39251,19800,19451
Oregon,Multnomah County,5,50153,24670,25483
Oregon,Multnomah County,6,70142,34372,35770
Oregon,Multnomah County,7,73815,36700,37115
Oregon,Multnomah County,8,64915,32918,31997
Oregon,Multnomah County,9,59635,30926,28709
Oregon,Multnomah County,10,51237,26429,24808
Oregon,Multnomah County,11,49486,24838,24648
Oregon,Multnomah County,12,49004,24085,24919
Oregon,Multnomah County,13,46197,22424,23773
Oregon,Multnomah County,14,34503,16554,17949
Oregon,Multnomah County,15,21162,9743,11419
Oregon,Multnomah County,16,13712,5868,7844
Oregon,Multnomah County,17,10121,3960,6161
Oregon,Multnomah County,18,13107,4234,8873
Oregon,Polk County,0,77916,37623,40293
Oregon,Polk County,1,4504,2174,2330
Oregon,Polk County,2,5085,2562,2523
Oregon,Polk County,3,5204,2672,2532
Oregon,Polk County,4,6228,3013,3215
Oregon,Polk County,5,7203,3453,3750
Oregon,Polk County,6,4141,2105,2036
Oregon,Polk County,7,4509,2191,2318
Oregon,Polk County,8,4364,2138,2226
Oregon,Polk County,9,4404,2155,2249
Oregon,Polk County,10,4360,2159,2201
Oregon,Polk County,11,4800,2349,2451
Oregon,Polk County,12,4886,2259,2627
Oregon,Polk County,13,4938,2306,2632
Oregon,Polk County,14,4379,2125,2254
Oregon,Polk County,15,3170,1516,1654
Oregon,Polk County,16,2252,1039,1213
Oregon,Polk County,17,1715,742,973
Oregon,Polk County,18,1774,665,1109
Oregon,Sherman County,0,1710,849,861
Oregon,Sherman County,1,61,22,39
Oregon,Sherman County,2,98,45,53
Oregon,Sherman County,3,94,49,45
Oregon,Sherman County,4,83,40,43
Oregon,Sherman County,5,82,37,45
Oregon,Sherman County,6,76,35,41
Oregon,Sherman County,7,83,36,47
Oregon,Sherman County,8,91,51,40
Oregon,Sherman County,9,86,56,30
Oregon,Sherman County,10,88,41,47
Oregon,Sherman County,11,150,69,81
Oregon,Sherman County,12,156,84,72
Oregon,Sherman County,13,138,74,64
Oregon,Sherman County,14,121,65,56
Oregon,Sherman County,15,103,47,56
Oregon,Sherman County,16,78,37,41
Oregon,Sherman County,17,55,29,26
Oregon,Sherman County,18,67,32,35
Oregon,Tillamook County,0,25342,12768,12574
Oregon,Tillamook County,1,1364,712,652
Oregon,Tillamook County,2,1394,717,677
Oregon,Tillamook County,3,1261,647,614
Oregon,Tillamook County,4,1322,743,579
Oregon,Tillamook County,5,1212,628,584
Oregon,Tillamook County,6,1274,697,577
Oregon,Tillamook County,7,1343,676,667
Oregon,Tillamook County,8,1252,657,595
Oregon,Tillamook County,9,1343,697,646
Oregon,Tillamook County,10,1441,741,700
Oregon,Tillamook County,11,1736,864,872
Oregon,Tillamook County,12,2122,991,1131
Oregon,Tillamook County,13,2349,1157,1192
Oregon,Tillamook County,14,2051,992,1059
Oregon,Tillamook County,15,1537,747,790
Oregon,Tillamook County,16,1034,515,519
Oregon,Tillamook County,17,698,328,370
Oregon,Tillamook County,18,609,259,350
Oregon,Umatilla County,0,76705,40103,36602
Oregon,Umatilla County,1,5507,2846,2661
Oregon,Umatilla County,2,5653,2874,2779
Oregon,Umatilla County,3,5424,2732,2692
Oregon,Umatilla County,4,5069,2657,2412
Oregon,Umatilla County,5,5366,3019,2347
Oregon,Umatilla County,6,5168,2943,2225
Oregon,Umatilla County,7,5045,2747,2298
Oregon,Umatilla County,8,4810,2638,2172
Oregon,Umatilla County,9,4842,2612,2230
Oregon,Umatilla County,10,4656,2491,2165
Oregon,Umatilla County,11,4911,2589,2322
Oregon,Umatilla County,12,4914,2518,2396
Oregon,Umatilla County,13,4516,2297,2219
Oregon,Umatilla County,14,3660,1819,1841
Oregon,Umatilla County,15,2565,1262,1303
Oregon,Umatilla County,16,1910,932,978
Oregon,Umatilla County,17,1259,563,696
Oregon,Umatilla County,18,1430,564,866
Oregon,Union County,0,25691,12612,13079
Oregon,Union County,1,1544,752,792
Oregon,Union County,2,1599,834,765
Oregon,Union County,3,1587,799,788
Oregon,Union County,4,1768,888,880
Oregon,Union County,5,2331,1139,1192
Oregon,Union County,6,1390,708,682
Oregon,Union County,7,1528,773,755
Oregon,Union County,8,1311,686,625
Oregon,Union County,9,1272,597,675
Oregon,Union County,10,1276,650,626
Oregon,Union County,11,1588,736,852
Oregon,Union County,12,1894,900,994
Oregon,Union County,13,1820,933,887
Oregon,Union County,14,1539,776,763
Oregon,Union County,15,1137,550,587
Oregon,Union County,16,787,397,390
Oregon,Union County,17,628,248,380
Oregon,Union County,18,692,246,446
Oregon,Wallowa County,0,6820,3338,3482
Oregon,Wallowa County,1,344,181,163
Oregon,Wallowa County,2,380,200,180
Oregon,Wallowa County,3,342,164,178
Oregon,Wallowa County,4,288,139,149
Oregon,Wallowa County,5,217,106,111
Oregon,Wallowa County,6,311,144,167
Oregon,Wallowa County,7,356,174,182
Oregon,Wallowa County,8,326,174,152
Oregon,Wallowa County,9,271,131,140
Oregon,Wallowa County,10,342,154,188
Oregon,Wallowa County,11,503,220,283
Oregon,Wallowa County,12,633,305,328
Oregon,Wallowa County,13,685,334,351
Oregon,Wallowa County,14,577,297,280
Oregon,Wallowa County,15,460,235,225
Oregon,Wallowa County,16,312,165,147
Oregon,Wallowa County,17,237,120,117
Oregon,Wallowa County,18,236,95,141
Oregon,Wasco County,0,25515,12650,12865
Oregon,Wasco County,1,1551,792,759
Oregon,Wasco County,2,1613,837,776
Oregon,Wasco County,3,1595,809,786
Oregon,Wasco County,4,1511,793,718
Oregon,Wasco County,5,1546,807,739
Oregon,Wasco County,6,1537,751,786
Oregon,Wasco County,7,1520,769,751
Oregon,Wasco County,8,1395,671,724
Oregon,Wasco County,9,1372,684,688
Oregon,Wasco County,10,1354,686,668
Oregon,Wasco County,11,1697,826,871
Oregon,Wasco County,12,1885,906,979
Oregon,Wasco County,13,1866,969,897
Oregon,Wasco County,14,1667,825,842
Oregon,Wasco County,15,1196,616,580
Oregon,Wasco County,16,836,408,428
Oregon,Wasco County,17,615,244,371
Oregon,Wasco County,18,759,257,502
Oregon,Washington County,0,562998,277424,285574
Oregon,Washington County,1,36974,18873,18101
Oregon,Washington County,2,38675,19749,18926
Oregon,Washington County,3,38695,19829,18866
Oregon,Washington County,4,35141,18111,17030
Oregon,Washington County,5,34276,17076,17200
Oregon,Washington County,6,40823,20451,20372
Oregon,Washington County,7,44801,22476,22325
Oregon,Washington County,8,42449,21261,21188
Oregon,Washington County,9,42165,21251,20914
Oregon,Washington County,10,38637,19456,19181
Oregon,Washington County,11,37798,18664,19134
Oregon,Washington County,12,35441,17271,18170
Oregon,Washington County,13,30358,14244,16114
Oregon,Washington County,14,23845,10973,12872
Oregon,Washington County,15,15688,7080,8608
Oregon,Washington County,16,10321,4434,5887
Oregon,Washington County,17,7396,3043,4353
Oregon,Washington County,18,9515,3182,6333
Oregon,Wheeler County,0,1375,698,677
Oregon,Wheeler County,1,57,36,21
Oregon,Wheeler County,2,47,24,23
Oregon,Wheeler County,3,64,37,27
Oregon,Wheeler County,4,74,41,33
Oregon,Wheeler County,5,46,29,17
Oregon,Wheeler County,6,49,24,25
Oregon,Wheeler County,7,55,28,27
Oregon,Wheeler County,8,65,34,31
Oregon,Wheeler County,9,58,33,25
Oregon,Wheeler County,10,59,26,33
Oregon,Wheeler County,11,98,44,54
Oregon,Wheeler County,12,107,51,56
Oregon,Wheeler County,13,140,67,73
Oregon,Wheeler County,14,124,56,68
Oregon,Wheeler County,15,130,76,54
Oregon,Wheeler County,16,95,42,53
Oregon,Wheeler County,17,60,27,33
Oregon,Wheeler County,18,47,23,24
Oregon,Yamhill County,0,101758,50800,50958
Oregon,Yamhill County,1,5771,2958,2813
Oregon,Yamhill County,2,6725,3487,3238
Oregon,Yamhill County,3,6921,3547,3374
Oregon,Yamhill County,4,7890,3852,4038
Oregon,Yamhill County,5,7475,3768,3707
Oregon,Yamhill County,6,5919,3147,2772
Oregon,Yamhill County,7,6275,3263,3012
Oregon,Yamhill County,8,6402,3276,3126
Oregon,Yamhill County,9,6266,3265,3001
Oregon,Yamhill County,10,6281,3256,3025
Oregon,Yamhill County,11,6729,3353,3376
Oregon,Yamhill County,12,6892,3385,3507
Oregon,Yamhill County,13,6337,3056,3281
Oregon,Yamhill County,14,5175,2524,2651
Oregon,Yamhill County,15,3819,1811,2008
Oregon,Yamhill County,16,2521,1150,1371
Oregon,Yamhill County,17,2012,860,1152
Oregon,Yamhill County,18,2348,842,1506
Pennsylvania,Adams County,0,101714,50115,51599
Pennsylvania,Adams County,1,5159,2715,2444
Pennsylvania,Adams County,2,5700,2881,2819
Pennsylvania,Adams County,3,6225,3164,3061
Pennsylvania,Adams County,4,6960,3467,3493
Pennsylvania,Adams County,5,6876,3498,3378
Pennsylvania,Adams County,6,5322,2727,2595
Pennsylvania,Adams County,7,5314,2699,2615
Pennsylvania,Adams County,8,5283,2647,2636
Pennsylvania,Adams County,9,6301,3127,3174
Pennsylvania,Adams County,10,7313,3580,3733
Pennsylvania,Adams County,11,7950,3968,3982
Pennsylvania,Adams County,12,7681,3760,3921
Pennsylvania,Adams County,13,7045,3459,3586
Pennsylvania,Adams County,14,6009,2864,3145
Pennsylvania,Adams County,15,4478,2137,2341
Pennsylvania,Adams County,16,3169,1492,1677
Pennsylvania,Adams County,17,2352,1013,1339
Pennsylvania,Adams County,18,2577,917,1660
Pennsylvania,Allegheny County,0,1231255,593416,637839
Pennsylvania,Allegheny County,1,64859,33045,31814
Pennsylvania,Allegheny County,2,63115,32253,30862
Pennsylvania,Allegheny County,3,65433,33363,32070
Pennsylvania,Allegheny County,4,74080,37415,36665
Pennsylvania,Allegheny County,5,80945,40320,40625
Pennsylvania,Allegheny County,6,99314,50054,49260
Pennsylvania,Allegheny County,7,84581,43085,41496
Pennsylvania,Allegheny County,8,69980,35076,34904
Pennsylvania,Allegheny County,9,70787,35203,35584
Pennsylvania,Allegheny County,10,76910,37392,39518
Pennsylvania,Allegheny County,11,89016,42701,46315
Pennsylvania,Allegheny County,12,95163,45601,49562
Pennsylvania,Allegheny County,13,83275,39665,43610
Pennsylvania,Allegheny County,14,63445,29295,34150
Pennsylvania,Allegheny County,15,46741,20211,26530
Pennsylvania,Allegheny County,16,36102,14946,21156
Pennsylvania,Allegheny County,17,30297,11818,18479
Pennsylvania,Allegheny County,18,37212,11973,25239
Pennsylvania,Armstrong County,0,67785,33589,34196
Pennsylvania,Armstrong County,1,3401,1748,1653
Pennsylvania,Armstrong County,2,3678,1876,1802
Pennsylvania,Armstrong County,3,3775,1903,1872
Pennsylvania,Armstrong County,4,3821,2023,1798
Pennsylvania,Armstrong County,5,3658,1856,1802
Pennsylvania,Armstrong County,6,3463,1829,1634
Pennsylvania,Armstrong County,7,3592,1760,1832
Pennsylvania,Armstrong County,8,3773,1889,1884
Pennsylvania,Armstrong County,9,4143,2086,2057
Pennsylvania,Armstrong County,10,4720,2381,2339
Pennsylvania,Armstrong County,11,5464,2776,2688
Pennsylvania,Armstrong County,12,5749,2955,2794
Pennsylvania,Armstrong County,13,4905,2471,2434
Pennsylvania,Armstrong County,14,4198,2049,2149
Pennsylvania,Armstrong County,15,3166,1469,1697
Pennsylvania,Armstrong County,16,2467,1075,1392
Pennsylvania,Armstrong County,17,1809,728,1081
Pennsylvania,Armstrong County,18,2003,715,1288
Pennsylvania,Beaver County,0,169392,82005,87387
Pennsylvania,Beaver County,1,8687,4436,4251
Pennsylvania,Beaver County,2,9201,4745,4456
Pennsylvania,Beaver County,3,9479,4840,4639
Pennsylvania,Beaver County,4,9646,4987,4659
Pennsylvania,Beaver County,5,9839,4994,4845
Pennsylvania,Beaver County,6,9416,4766,4650
Pennsylvania,Beaver County,7,9790,4941,4849
Pennsylvania,Beaver County,8,9109,4516,4593
Pennsylvania,Beaver County,9,9751,4790,4961
Pennsylvania,Beaver County,10,11091,5406,5685
Pennsylvania,Beaver County,11,13604,6621,6983
Pennsylvania,Beaver County,12,14156,6878,7278
Pennsylvania,Beaver County,13,12271,5873,6398
Pennsylvania,Beaver County,14,9867,4711,5156
Pennsylvania,Beaver County,15,7376,3310,4066
Pennsylvania,Beaver County,16,6000,2470,3530
Pennsylvania,Beaver County,17,4869,1987,2882
Pennsylvania,Beaver County,18,5240,1734,3506
Pennsylvania,Bedford County,0,48946,24408,24538
Pennsylvania,Bedford County,1,2470,1211,1259
Pennsylvania,Bedford County,2,2682,1384,1298
Pennsylvania,Bedford County,3,3029,1589,1440
Pennsylvania,Bedford County,4,2924,1556,1368
Pennsylvania,Bedford County,5,2587,1353,1234
Pennsylvania,Bedford County,6,2401,1244,1157
Pennsylvania,Bedford County,7,2436,1242,1194
Pennsylvania,Bedford County,8,2606,1300,1306
Pennsylvania,Bedford County,9,3163,1578,1585
Pennsylvania,Bedford County,10,3428,1759,1669
Pennsylvania,Bedford County,11,3860,1956,1904
Pennsylvania,Bedford County,12,3931,1992,1939
Pennsylvania,Bedford County,13,3419,1678,1741
Pennsylvania,Bedford County,14,2906,1449,1457
Pennsylvania,Bedford County,15,2485,1178,1307
Pennsylvania,Bedford County,16,1943,870,1073
Pennsylvania,Bedford County,17,1338,592,746
Pennsylvania,Bedford County,18,1338,477,861
Pennsylvania,Berks County,0,413691,203372,210319
Pennsylvania,Berks County,1,24331,12361,11970
Pennsylvania,Berks County,2,25801,13220,12581
Pennsylvania,Berks County,3,27435,13981,13454
Pennsylvania,Berks County,4,29599,15150,14449
Pennsylvania,Berks County,5,28288,14422,13866
Pennsylvania,Berks County,6,25176,12636,12540
Pennsylvania,Berks County,7,23961,11844,12117
Pennsylvania,Berks County,8,23001,11347,11654
Pennsylvania,Berks County,9,26148,12916,13232
Pennsylvania,Berks County,10,28724,14061,14663
Pennsylvania,Berks County,11,31408,15624,15784
Pennsylvania,Berks County,12,29181,14576,14605
Pennsylvania,Berks County,13,24893,12334,12559
Pennsylvania,Berks County,14,20877,9983,10894
Pennsylvania,Berks County,15,14646,6703,7943
Pennsylvania,Berks County,16,11066,4950,6116
Pennsylvania,Berks County,17,8983,3751,5232
Pennsylvania,Berks County,18,10173,3513,6660
Pennsylvania,Blair County,0,125955,61404,64551
Pennsylvania,Blair County,1,6958,3498,3460
Pennsylvania,Blair County,2,7167,3735,3432
Pennsylvania,Blair County,3,7409,3841,3568
Pennsylvania,Blair County,4,7493,3843,3650
Pennsylvania,Blair County,5,8062,4231,3831
Pennsylvania,Blair County,6,7218,3636,3582
Pennsylvania,Blair County,7,7084,3551,3533
Pennsylvania,Blair County,8,7072,3502,3570
Pennsylvania,Blair County,9,7585,3779,3806
Pennsylvania,Blair County,10,8079,4023,4056
Pennsylvania,Blair County,11,9011,4447,4564
Pennsylvania,Blair County,12,9612,4731,4881
Pennsylvania,Blair County,13,8845,4239,4606
Pennsylvania,Blair County,14,7306,3450,3856
Pennsylvania,Blair County,15,5578,2546,3032
Pennsylvania,Blair County,16,4213,1806,2407
Pennsylvania,Blair County,17,3436,1316,2120
Pennsylvania,Blair County,18,3827,1230,2597
Pennsylvania,Bradford County,0,61784,30591,31193
Pennsylvania,Bradford County,1,3683,1841,1842
Pennsylvania,Bradford County,2,3801,1935,1866
Pennsylvania,Bradford County,3,3806,1951,1855
Pennsylvania,Bradford County,4,3664,1899,1765
Pennsylvania,Bradford County,5,3305,1700,1605
Pennsylvania,Bradford County,6,3280,1655,1625
Pennsylvania,Bradford County,7,3246,1588,1658
Pennsylvania,Bradford County,8,3085,1531,1554
Pennsylvania,Bradford County,9,3574,1769,1805
Pennsylvania,Bradford County,10,4151,2087,2064
Pennsylvania,Bradford County,11,4932,2452,2480
Pennsylvania,Bradford County,12,4923,2483,2440
Pennsylvania,Bradford County,13,4246,2084,2162
Pennsylvania,Bradford County,14,3811,1894,1917
Pennsylvania,Bradford County,15,3022,1473,1549
Pennsylvania,Bradford County,16,2188,1010,1178
Pennsylvania,Bradford County,17,1488,685,803
Pennsylvania,Bradford County,18,1579,554,1025
Pennsylvania,Bucks County,0,626685,307325,319360
Pennsylvania,Bucks County,1,30876,15736,15140
Pennsylvania,Bucks County,2,36190,18413,17777
Pennsylvania,Bucks County,3,40712,21073,19639
Pennsylvania,Bucks County,4,40643,21080,19563
Pennsylvania,Bucks County,5,35640,18165,17475
Pennsylvania,Bucks County,6,33927,17370,16557
Pennsylvania,Bucks County,7,34567,17058,17509
Pennsylvania,Bucks County,8,34263,17034,17229
Pennsylvania,Bucks County,9,40190,19655,20535
Pennsylvania,Bucks County,10,47068,22926,24142
Pennsylvania,Bucks County,11,54202,26524,27678
Pennsylvania,Bucks County,12,51759,25699,26060
Pennsylvania,Bucks County,13,42128,20808,21320
Pennsylvania,Bucks County,14,33396,15943,17453
Pennsylvania,Bucks County,15,24026,11231,12795
Pennsylvania,Bucks County,16,17311,7658,9653
Pennsylvania,Bucks County,17,13738,5650,8088
Pennsylvania,Bucks County,18,16049,5302,10747
Pennsylvania,Butler County,0,185943,91768,94175
Pennsylvania,Butler County,1,9225,4679,4546
Pennsylvania,Butler County,2,10549,5369,5180
Pennsylvania,Butler County,3,11493,5841,5652
Pennsylvania,Butler County,4,13036,6712,6324
Pennsylvania,Butler County,5,10822,5487,5335
Pennsylvania,Butler County,6,10432,5339,5093
Pennsylvania,Butler County,7,10254,5255,4999
Pennsylvania,Butler County,8,10380,5193,5187
Pennsylvania,Butler County,9,12052,6035,6017
Pennsylvania,Butler County,10,13783,6818,6965
Pennsylvania,Butler County,11,14953,7462,7491
Pennsylvania,Butler County,12,14826,7463,7363
Pennsylvania,Butler County,13,12571,6270,6301
Pennsylvania,Butler County,14,9920,4804,5116
Pennsylvania,Butler County,15,7216,3386,3830
Pennsylvania,Butler County,16,5319,2338,2981
Pennsylvania,Butler County,17,4166,1688,2478
Pennsylvania,Butler County,18,4946,1629,3317
Pennsylvania,Cambria County,0,137732,67722,70010
Pennsylvania,Cambria County,1,6797,3514,3283
Pennsylvania,Cambria County,2,7304,3684,3620
Pennsylvania,Cambria County,3,7782,3993,3789
Pennsylvania,Cambria County,4,8644,4439,4205
Pennsylvania,Cambria County,5,8848,4592,4256
Pennsylvania,Cambria County,6,7208,3708,3500
Pennsylvania,Cambria County,7,7163,3690,3473
Pennsylvania,Cambria County,8,7409,3771,3638
Pennsylvania,Cambria County,9,8108,4137,3971
Pennsylvania,Cambria County,10,8662,4386,4276
Pennsylvania,Cambria County,11,10014,5074,4940
Pennsylvania,Cambria County,12,11236,5594,5642
Pennsylvania,Cambria County,13,10490,5187,5303
Pennsylvania,Cambria County,14,8290,4069,4221
Pennsylvania,Cambria County,15,6210,2833,3377
Pennsylvania,Cambria County,16,4855,2036,2819
Pennsylvania,Cambria County,17,3971,1517,2454
Pennsylvania,Cambria County,18,4741,1498,3243
Pennsylvania,Cameron County,0,4805,2380,2425
Pennsylvania,Cameron County,1,221,115,106
Pennsylvania,Cameron County,2,212,112,100
Pennsylvania,Cameron County,3,241,129,112
Pennsylvania,Cameron County,4,260,116,144
Pennsylvania,Cameron County,5,240,120,120
Pennsylvania,Cameron County,6,207,114,93
Pennsylvania,Cameron County,7,229,118,111
Pennsylvania,Cameron County,8,207,103,104
Pennsylvania,Cameron County,9,274,148,126
Pennsylvania,Cameron County,10,316,162,154
Pennsylvania,Cameron County,11,407,207,200
Pennsylvania,Cameron County,12,439,207,232
Pennsylvania,Cameron County,13,408,209,199
Pennsylvania,Cameron County,14,384,205,179
Pennsylvania,Cameron County,15,281,145,136
Pennsylvania,Cameron County,16,153,57,96
Pennsylvania,Cameron County,17,152,63,89
Pennsylvania,Cameron County,18,174,50,124
Pennsylvania,Carbon County,0,64441,31903,32538
Pennsylvania,Carbon County,1,2994,1506,1488
Pennsylvania,Carbon County,2,3559,1784,1775
Pennsylvania,Carbon County,3,3801,1933,1868
Pennsylvania,Carbon County,4,3566,1871,1695
Pennsylvania,Carbon County,5,3228,1670,1558
Pennsylvania,Carbon County,6,3417,1732,1685
Pennsylvania,Carbon County,7,3620,1827,1793
Pennsylvania,Carbon County,8,3476,1792,1684
Pennsylvania,Carbon County,9,4154,2076,2078
Pennsylvania,Carbon County,10,4733,2345,2388
Pennsylvania,Carbon County,11,5148,2630,2518
Pennsylvania,Carbon County,12,5395,2669,2726
Pennsylvania,Carbon County,13,4685,2339,2346
Pennsylvania,Carbon County,14,4045,2010,2035
Pennsylvania,Carbon County,15,3112,1509,1603
Pennsylvania,Carbon County,16,2223,1000,1223
Pennsylvania,Carbon County,17,1620,676,944
Pennsylvania,Carbon County,18,1665,534,1131
Pennsylvania,Centre County,0,158742,83222,75520
Pennsylvania,Centre County,1,6526,3373,3153
Pennsylvania,Centre County,2,6785,3487,3298
Pennsylvania,Centre County,3,6876,3413,3463
Pennsylvania,Centre County,4,15669,7887,7782
Pennsylvania,Centre County,5,29932,16784,13148
Pennsylvania,Centre County,6,12377,7001,5376
Pennsylvania,Centre County,7,9200,5267,3933
Pennsylvania,Centre County,8,8131,4470,3661
Pennsylvania,Centre County,9,8374,4568,3806
Pennsylvania,Centre County,10,8781,4638,4143
Pennsylvania,Centre County,11,9299,4773,4526
Pennsylvania,Centre County,12,9072,4710,4362
Pennsylvania,Centre County,13,7961,3971,3990
Pennsylvania,Centre County,14,6319,3094,3225
Pennsylvania,Centre County,15,4574,2131,2443
Pennsylvania,Centre County,16,3545,1589,1956
Pennsylvania,Centre County,17,2566,1102,1464
Pennsylvania,Centre County,18,2755,964,1791
Pennsylvania,Chester County,0,512784,252250,260534
Pennsylvania,Chester County,1,29298,15036,14262
Pennsylvania,Chester County,2,33574,17137,16437
Pennsylvania,Chester County,3,35987,18354,17633
Pennsylvania,Chester County,4,36491,18555,17936
Pennsylvania,Chester County,5,31482,15945,15537
Pennsylvania,Chester County,6,29169,14870,14299
Pennsylvania,Chester County,7,29102,14569,14533
Pennsylvania,Chester County,8,30213,15039,15174
Pennsylvania,Chester County,9,34285,16924,17361
Pennsylvania,Chester County,10,37880,18585,19295
Pennsylvania,Chester County,11,40996,20147,20849
Pennsylvania,Chester County,12,38165,18823,19342
Pennsylvania,Chester County,13,31547,15338,16209
Pennsylvania,Chester County,14,24632,11775,12857
Pennsylvania,Chester County,15,17581,8170,9411
Pennsylvania,Chester County,16,12131,5444,6687
Pennsylvania,Chester County,17,9279,3909,5370
Pennsylvania,Chester County,18,10972,3630,7342
Pennsylvania,Clarion County,0,38821,18956,19865
Pennsylvania,Clarion County,1,1953,1030,923
Pennsylvania,Clarion County,2,2015,1011,1004
Pennsylvania,Clarion County,3,2029,1000,1029
Pennsylvania,Clarion County,4,2838,1369,1469
Pennsylvania,Clarion County,5,4084,1917,2167
Pennsylvania,Clarion County,6,2240,1169,1071
Pennsylvania,Clarion County,7,1935,986,949
Pennsylvania,Clarion County,8,1845,917,928
Pennsylvania,Clarion County,9,2284,1129,1155
Pennsylvania,Clarion County,10,2398,1187,1211
Pennsylvania,Clarion County,11,2738,1419,1319
Pennsylvania,Clarion County,12,2837,1397,1440
Pennsylvania,Clarion County,13,2643,1325,1318
Pennsylvania,Clarion County,14,2097,1004,1093
Pennsylvania,Clarion County,15,1711,779,932
Pennsylvania,Clarion County,16,1335,584,751
Pennsylvania,Clarion County,17,946,388,558
Pennsylvania,Clarion County,18,893,345,548
Pennsylvania,Clearfield County,0,81191,42463,38728
Pennsylvania,Clearfield County,1,3782,1937,1845
Pennsylvania,Clearfield County,2,4171,2139,2032
Pennsylvania,Clearfield County,3,4372,2250,2122
Pennsylvania,Clearfield County,4,4457,2344,2113
Pennsylvania,Clearfield County,5,5022,2924,2098
Pennsylvania,Clearfield County,6,4872,2907,1965
Pennsylvania,Clearfield County,7,4727,2749,1978
Pennsylvania,Clearfield County,8,4822,2705,2117
Pennsylvania,Clearfield County,9,5560,3069,2491
Pennsylvania,Clearfield County,10,6008,3312,2696
Pennsylvania,Clearfield County,11,6443,3419,3024
Pennsylvania,Clearfield County,12,6146,3166,2980
Pennsylvania,Clearfield County,13,5485,2786,2699
Pennsylvania,Clearfield County,14,4630,2316,2314
Pennsylvania,Clearfield County,15,3647,1685,1962
Pennsylvania,Clearfield County,16,2773,1197,1576
Pennsylvania,Clearfield County,17,2009,839,1170
Pennsylvania,Clearfield County,18,2265,719,1546
Pennsylvania,Clinton County,0,39745,19456,20289
Pennsylvania,Clinton County,1,2192,1101,1091
Pennsylvania,Clinton County,2,2253,1157,1096
Pennsylvania,Clinton County,3,2263,1126,1137
Pennsylvania,Clinton County,4,3308,1604,1704
Pennsylvania,Clinton County,5,4412,2043,2369
Pennsylvania,Clinton County,6,2167,1261,906
Pennsylvania,Clinton County,7,2075,1039,1036
Pennsylvania,Clinton County,8,1982,990,992
Pennsylvania,Clinton County,9,2296,1160,1136
Pennsylvania,Clinton County,10,2249,1124,1125
Pennsylvania,Clinton County,11,2616,1313,1303
Pennsylvania,Clinton County,12,2751,1338,1413
Pennsylvania,Clinton County,13,2332,1143,1189
Pennsylvania,Clinton County,14,2076,997,1079
Pennsylvania,Clinton County,15,1621,770,851
Pennsylvania,Clinton County,16,1273,568,705
Pennsylvania,Clinton County,17,926,386,540
Pennsylvania,Clinton County,18,953,336,617
Pennsylvania,Columbia County,0,67122,32404,34718
Pennsylvania,Columbia County,1,3088,1586,1502
Pennsylvania,Columbia County,2,3388,1734,1654
Pennsylvania,Columbia County,3,3504,1814,1690
Pennsylvania,Columbia County,4,5780,2669,3111
Pennsylvania,Columbia County,5,7526,3464,4062
Pennsylvania,Columbia County,6,3660,1955,1705
Pennsylvania,Columbia County,7,3404,1705,1699
Pennsylvania,Columbia County,8,3282,1657,1625
Pennsylvania,Columbia County,9,3855,1935,1920
Pennsylvania,Columbia County,10,4214,2162,2052
Pennsylvania,Columbia County,11,4652,2231,2421
Pennsylvania,Columbia County,12,4860,2353,2507
Pennsylvania,Columbia County,13,4382,2157,2225
Pennsylvania,Columbia County,14,3685,1740,1945
Pennsylvania,Columbia County,15,2652,1237,1415
Pennsylvania,Columbia County,16,2031,858,1173
Pennsylvania,Columbia County,17,1478,605,873
Pennsylvania,Columbia County,18,1681,542,1139
Pennsylvania,Crawford County,0,87175,42626,44549
Pennsylvania,Crawford County,1,4766,2444,2322
Pennsylvania,Crawford County,2,5097,2638,2459
Pennsylvania,Crawford County,3,5416,2750,2666
Pennsylvania,Crawford County,4,6068,3098,2970
Pennsylvania,Crawford County,5,5646,2791,2855
Pennsylvania,Crawford County,6,4663,2312,2351
Pennsylvania,Crawford County,7,4713,2295,2418
Pennsylvania,Crawford County,8,4437,2161,2276
Pennsylvania,Crawford County,9,5259,2496,2763
Pennsylvania,Crawford County,10,5777,2846,2931
Pennsylvania,Crawford County,11,6379,3055,3324
Pennsylvania,Crawford County,12,6715,3314,3401
Pennsylvania,Crawford County,13,6251,3056,3195
Pennsylvania,Crawford County,14,5332,2587,2745
Pennsylvania,Crawford County,15,3977,1917,2060
Pennsylvania,Crawford County,16,2703,1280,1423
Pennsylvania,Crawford County,17,2070,906,1164
Pennsylvania,Crawford County,18,1906,680,1226
Pennsylvania,Cumberland County,0,243762,120519,123243
Pennsylvania,Cumberland County,1,12857,6541,6316
Pennsylvania,Cumberland County,2,13892,7124,6768
Pennsylvania,Cumberland County,3,14063,7141,6922
Pennsylvania,Cumberland County,4,16642,8201,8441
Pennsylvania,Cumberland County,5,16624,8563,8061
Pennsylvania,Cumberland County,6,16129,8551,7578
Pennsylvania,Cumberland County,7,15463,8065,7398
Pennsylvania,Cumberland County,8,14103,7283,6820
Pennsylvania,Cumberland County,9,15673,8070,7603
Pennsylvania,Cumberland County,10,16302,8298,8004
Pennsylvania,Cumberland County,11,17775,8829,8946
Pennsylvania,Cumberland County,12,17178,8379,8799
Pennsylvania,Cumberland County,13,15506,7485,8021
Pennsylvania,Cumberland County,14,13124,6282,6842
Pennsylvania,Cumberland County,15,9528,4319,5209
Pennsylvania,Cumberland County,16,6972,2978,3994
Pennsylvania,Cumberland County,17,5567,2268,3299
Pennsylvania,Cumberland County,18,6364,2142,4222
Pennsylvania,Dauphin County,0,271453,131500,139953
Pennsylvania,Dauphin County,1,16806,8517,8289
Pennsylvania,Dauphin County,2,16689,8506,8183
Pennsylvania,Dauphin County,3,16973,8627,8346
Pennsylvania,Dauphin County,4,16522,8550,7972
Pennsylvania,Dauphin County,5,16860,8347,8513
Pennsylvania,Dauphin County,6,18666,9210,9456
Pennsylvania,Dauphin County,7,18161,8977,9184
Pennsylvania,Dauphin County,8,15682,7677,8005
Pennsylvania,Dauphin County,9,17109,8521,8588
Pennsylvania,Dauphin County,10,17962,8746,9216
Pennsylvania,Dauphin County,11,20349,9838,10511
Pennsylvania,Dauphin County,12,20412,9742,10670
Pennsylvania,Dauphin County,13,17758,8552,9206
Pennsylvania,Dauphin County,14,13920,6515,7405
Pennsylvania,Dauphin County,15,9365,4268,5097
Pennsylvania,Dauphin County,16,6861,2848,4013
Pennsylvania,Dauphin County,17,5499,2209,3290
Pennsylvania,Dauphin County,18,5859,1850,4009
Pennsylvania,Delaware County,0,562960,270321,292639
Pennsylvania,Delaware County,1,33741,17175,16566
Pennsylvania,Delaware County,2,34290,17473,16817
Pennsylvania,Delaware County,3,35528,18008,17520
Pennsylvania,Delaware County,4,40854,20962,19892
Pennsylvania,Delaware County,5,39849,20125,19724
Pennsylvania,Delaware County,6,36665,18110,18555
Pennsylvania,Delaware County,7,35241,17150,18091
Pennsylvania,Delaware County,8,32737,15766,16971
Pennsylvania,Delaware County,9,33919,16296,17623
Pennsylvania,Delaware County,10,37463,18024,19439
Pennsylvania,Delaware County,11,41874,20045,21829
Pennsylvania,Delaware County,12,41839,19890,21949
Pennsylvania,Delaware County,13,34257,16249,18008
Pennsylvania,Delaware County,14,25777,11905,13872
Pennsylvania,Delaware County,15,18242,8008,10234
Pennsylvania,Delaware County,16,13684,5706,7978
Pennsylvania,Delaware County,17,12064,4694,7370
Pennsylvania,Delaware County,18,14936,4735,10201
Pennsylvania,Elk County,0,31194,15624,15570
Pennsylvania,Elk County,1,1521,800,721
Pennsylvania,Elk County,2,1628,842,786
Pennsylvania,Elk County,3,1850,938,912
Pennsylvania,Elk County,4,1843,952,891
Pennsylvania,Elk County,5,1574,817,757
Pennsylvania,Elk County,6,1421,789,632
Pennsylvania,Elk County,7,1541,807,734
Pennsylvania,Elk County,8,1497,709,788
Pennsylvania,Elk County,9,1956,1005,951
Pennsylvania,Elk County,10,2426,1209,1217
Pennsylvania,Elk County,11,2619,1367,1252
Pennsylvania,Elk County,12,2704,1418,1286
Pennsylvania,Elk County,13,2234,1147,1087
Pennsylvania,Elk County,14,1861,918,943
Pennsylvania,Elk County,15,1440,693,747
Pennsylvania,Elk County,16,1195,546,649
Pennsylvania,Elk County,17,918,378,540
Pennsylvania,Elk County,18,966,289,677
Pennsylvania,Erie County,0,278443,137351,141092
Pennsylvania,Erie County,1,16044,8144,7900
Pennsylvania,Erie County,2,16793,8587,8206
Pennsylvania,Erie County,3,17147,8927,8220
Pennsylvania,Erie County,4,20001,10198,9803
Pennsylvania,Erie County,5,20492,10410,10082
Pennsylvania,Erie County,6,19260,9843,9417
Pennsylvania,Erie County,7,16775,8553,8222
Pennsylvania,Erie County,8,15126,7574,7552
Pennsylvania,Erie County,9,16345,8125,8220
Pennsylvania,Erie County,10,17668,8853,8815
Pennsylvania,Erie County,11,19747,9784,9963
Pennsylvania,Erie County,12,20750,10256,10494
Pennsylvania,Erie County,13,18370,8957,9413
Pennsylvania,Erie County,14,13744,6664,7080
Pennsylvania,Erie County,15,10114,4688,5426
Pennsylvania,Erie County,16,7418,3237,4181
Pennsylvania,Erie County,17,5618,2282,3336
Pennsylvania,Erie County,18,7031,2269,4762
Pennsylvania,Fayette County,0,134086,66103,67983
Pennsylvania,Fayette County,1,6679,3397,3282
Pennsylvania,Fayette County,2,6951,3575,3376
Pennsylvania,Fayette County,3,7632,3849,3783
Pennsylvania,Fayette County,4,7475,3796,3679
Pennsylvania,Fayette County,5,7735,4077,3658
Pennsylvania,Fayette County,6,7885,4299,3586
Pennsylvania,Fayette County,7,7400,3802,3598
Pennsylvania,Fayette County,8,7467,3778,3689
Pennsylvania,Fayette County,9,8630,4319,4311
Pennsylvania,Fayette County,10,9289,4730,4559
Pennsylvania,Fayette County,11,9999,4923,5076
Pennsylvania,Fayette County,12,10816,5365,5451
Pennsylvania,Fayette County,13,10057,4958,5099
Pennsylvania,Fayette County,14,8090,3908,4182
Pennsylvania,Fayette County,15,6058,2807,3251
Pennsylvania,Fayette County,16,4462,1912,2550
Pennsylvania,Fayette County,17,3416,1333,2083
Pennsylvania,Fayette County,18,4045,1275,2770
Pennsylvania,Forest County,0,7518,5041,2477
Pennsylvania,Forest County,1,112,60,52
Pennsylvania,Forest County,2,102,48,54
Pennsylvania,Forest County,3,115,55,60
Pennsylvania,Forest County,4,368,303,65
Pennsylvania,Forest County,5,683,583,100
Pennsylvania,Forest County,6,710,614,96
Pennsylvania,Forest County,7,605,490,115
Pennsylvania,Forest County,8,465,359,106
Pennsylvania,Forest County,9,491,335,156
Pennsylvania,Forest County,10,531,359,172
Pennsylvania,Forest County,11,583,360,223
Pennsylvania,Forest County,12,602,343,259
Pennsylvania,Forest County,13,546,305,241
Pennsylvania,Forest County,14,528,268,260
Pennsylvania,Forest County,15,462,245,217
Pennsylvania,Forest County,16,309,155,154
Pennsylvania,Forest County,17,177,96,81
Pennsylvania,Forest County,18,129,63,66
Pennsylvania,Franklin County,0,152892,74971,77921
Pennsylvania,Franklin County,1,9288,4771,4517
Pennsylvania,Franklin County,2,9901,5102,4799
Pennsylvania,Franklin County,3,9667,4906,4761
Pennsylvania,Franklin County,4,9636,4992,4644
Pennsylvania,Franklin County,5,8587,4258,4329
Pennsylvania,Franklin County,6,8869,4328,4541
Pennsylvania,Franklin County,7,9059,4495,4564
Pennsylvania,Franklin County,8,8667,4285,4382
Pennsylvania,Franklin County,9,9997,5049,4948
Pennsylvania,Franklin County,10,10165,5094,5071
Pennsylvania,Franklin County,11,11020,5507,5513
Pennsylvania,Franklin County,12,10685,5227,5458
Pennsylvania,Franklin County,13,9541,4550,4991
Pennsylvania,Franklin County,14,8471,4075,4396
Pennsylvania,Franklin County,15,6756,3123,3633
Pennsylvania,Franklin County,16,4831,2246,2585
Pennsylvania,Franklin County,17,3761,1601,2160
Pennsylvania,Franklin County,18,3991,1362,2629
Pennsylvania,Fulton County,0,14632,7376,7256
Pennsylvania,Fulton County,1,764,390,374
Pennsylvania,Fulton County,2,861,443,418
Pennsylvania,Fulton County,3,905,450,455
Pennsylvania,Fulton County,4,922,480,442
Pennsylvania,Fulton County,5,767,400,367
Pennsylvania,Fulton County,6,750,380,370
Pennsylvania,Fulton County,7,779,398,381
Pennsylvania,Fulton County,8,802,411,391
Pennsylvania,Fulton County,9,992,517,475
Pennsylvania,Fulton County,10,1056,546,510
Pennsylvania,Fulton County,11,1096,568,528
Pennsylvania,Fulton County,12,1093,552,541
Pennsylvania,Fulton County,13,956,454,502
Pennsylvania,Fulton County,14,927,465,462
Pennsylvania,Fulton County,15,789,388,401
Pennsylvania,Fulton County,16,560,265,295
Pennsylvania,Fulton County,17,331,154,177
Pennsylvania,Fulton County,18,282,115,167
Pennsylvania,Greene County,0,37843,19637,18206
Pennsylvania,Greene County,1,1852,963,889
Pennsylvania,Greene County,2,1997,1054,943
Pennsylvania,Greene County,3,2090,1072,1018
Pennsylvania,Greene County,4,2404,1252,1152
Pennsylvania,Greene County,5,2702,1433,1269
Pennsylvania,Greene County,6,2374,1369,1005
Pennsylvania,Greene County,7,2202,1252,950
Pennsylvania,Greene County,8,2329,1325,1004
Pennsylvania,Greene County,9,2570,1380,1190
Pennsylvania,Greene County,10,2588,1390,1198
Pennsylvania,Greene County,11,2731,1446,1285
Pennsylvania,Greene County,12,2860,1432,1428
Pennsylvania,Greene County,13,2688,1373,1315
Pennsylvania,Greene County,14,2194,1080,1114
Pennsylvania,Greene County,15,1529,750,779
Pennsylvania,Greene County,16,1072,480,592
Pennsylvania,Greene County,17,827,335,492
Pennsylvania,Greene County,18,834,251,583
Pennsylvania,Huntingdon County,0,45750,24302,21448
Pennsylvania,Huntingdon County,1,2079,1092,987
Pennsylvania,Huntingdon County,2,2449,1229,1220
Pennsylvania,Huntingdon County,3,2510,1235,1275
Pennsylvania,Huntingdon County,4,2895,1466,1429
Pennsylvania,Huntingdon County,5,3069,1708,1361
Pennsylvania,Huntingdon County,6,2832,1732,1100
Pennsylvania,Huntingdon County,7,2792,1729,1063
Pennsylvania,Huntingdon County,8,2698,1592,1106
Pennsylvania,Huntingdon County,9,3006,1739,1267
Pennsylvania,Huntingdon County,10,3136,1785,1351
Pennsylvania,Huntingdon County,11,3404,1854,1550
Pennsylvania,Huntingdon County,12,3292,1693,1599
Pennsylvania,Huntingdon County,13,3023,1501,1522
Pennsylvania,Huntingdon County,14,2777,1444,1333
Pennsylvania,Huntingdon County,15,2104,984,1120
Pennsylvania,Huntingdon County,16,1543,729,814
Pennsylvania,Huntingdon County,17,1077,444,633
Pennsylvania,Huntingdon County,18,1064,346,718
Pennsylvania,Indiana County,0,87706,43919,43787
Pennsylvania,Indiana County,1,4379,2208,2171
Pennsylvania,Indiana County,2,4323,2230,2093
Pennsylvania,Indiana County,3,4563,2342,2221
Pennsylvania,Indiana County,4,7476,3655,3821
Pennsylvania,Indiana County,5,10491,5483,5008
Pennsylvania,Indiana County,6,4796,2724,2072
Pennsylvania,Indiana County,7,4537,2381,2156
Pennsylvania,Indiana County,8,4197,2165,2032
Pennsylvania,Indiana County,9,4612,2359,2253
Pennsylvania,Indiana County,10,5123,2575,2548
Pennsylvania,Indiana County,11,5961,2985,2976
Pennsylvania,Indiana County,12,6373,3227,3146
Pennsylvania,Indiana County,13,5845,2924,2921
Pennsylvania,Indiana County,14,4659,2315,2344
Pennsylvania,Indiana County,15,3525,1668,1857
Pennsylvania,Indiana County,16,2706,1231,1475
Pennsylvania,Indiana County,17,1913,778,1135
Pennsylvania,Indiana County,18,2227,669,1558
Pennsylvania,Jefferson County,0,44638,22208,22430
Pennsylvania,Jefferson County,1,2566,1350,1216
Pennsylvania,Jefferson County,2,2547,1306,1241
Pennsylvania,Jefferson County,3,2693,1387,1306
Pennsylvania,Jefferson County,4,2672,1359,1313
Pennsylvania,Jefferson County,5,2550,1304,1246
Pennsylvania,Jefferson County,6,2468,1305,1163
Pennsylvania,Jefferson County,7,2493,1264,1229
Pennsylvania,Jefferson County,8,2325,1196,1129
Pennsylvania,Jefferson County,9,2669,1352,1317
Pennsylvania,Jefferson County,10,2943,1475,1468
Pennsylvania,Jefferson County,11,3345,1697,1648
Pennsylvania,Jefferson County,12,3608,1817,1791
Pennsylvania,Jefferson County,13,3086,1519,1567
Pennsylvania,Jefferson County,14,2516,1267,1249
Pennsylvania,Jefferson County,15,2003,942,1061
Pennsylvania,Jefferson County,16,1641,744,897
Pennsylvania,Jefferson County,17,1214,494,720
Pennsylvania,Jefferson County,18,1299,430,869
Pennsylvania,Juniata County,0,24796,12369,12427
Pennsylvania,Juniata County,1,1365,686,679
Pennsylvania,Juniata County,2,1550,802,748
Pennsylvania,Juniata County,3,1685,876,809
Pennsylvania,Juniata County,4,1468,736,732
Pennsylvania,Juniata County,5,1335,681,654
Pennsylvania,Juniata County,6,1356,678,678
Pennsylvania,Juniata County,7,1349,698,651
Pennsylvania,Juniata County,8,1371,690,681
Pennsylvania,Juniata County,9,1536,790,746
Pennsylvania,Juniata County,10,1649,841,808
Pennsylvania,Juniata County,11,1844,943,901
Pennsylvania,Juniata County,12,1821,905,916
Pennsylvania,Juniata County,13,1549,786,763
Pennsylvania,Juniata County,14,1482,762,720
Pennsylvania,Juniata County,15,1172,570,602
Pennsylvania,Juniata County,16,894,418,476
Pennsylvania,Juniata County,17,696,294,402
Pennsylvania,Juniata County,18,674,213,461
Pennsylvania,Lackawanna County,0,212719,102785,109934
Pennsylvania,Lackawanna County,1,11093,5606,5487
Pennsylvania,Lackawanna County,2,11821,6092,5729
Pennsylvania,Lackawanna County,3,12101,6189,5912
Pennsylvania,Lackawanna County,4,13611,6846,6765
Pennsylvania,Lackawanna County,5,14259,7061,7198
Pennsylvania,Lackawanna County,6,13731,6928,6803
Pennsylvania,Lackawanna County,7,12485,6281,6204
Pennsylvania,Lackawanna County,8,11472,5649,5823
Pennsylvania,Lackawanna County,9,12771,6364,6407
Pennsylvania,Lackawanna County,10,13966,6908,7058
Pennsylvania,Lackawanna County,11,15567,7577,7990
Pennsylvania,Lackawanna County,12,15694,7673,8021
Pennsylvania,Lackawanna County,13,14241,6936,7305
Pennsylvania,Lackawanna County,14,12024,5718,6306
Pennsylvania,Lackawanna County,15,8974,4121,4853
Pennsylvania,Lackawanna County,16,6818,2905,3913
Pennsylvania,Lackawanna County,17,5338,1920,3418
Pennsylvania,Lackawanna County,18,6753,2011,4742
Pennsylvania,Lancaster County,0,533320,260847,272473
Pennsylvania,Lancaster County,1,35061,18032,17029
Pennsylvania,Lancaster County,2,35803,18324,17479
Pennsylvania,Lancaster County,3,36110,18387,17723
Pennsylvania,Lancaster County,4,36496,18459,18037
Pennsylvania,Lancaster County,5,35118,17616,17502
Pennsylvania,Lancaster County,6,35261,17533,17728
Pennsylvania,Lancaster County,7,32203,16059,16144
Pennsylvania,Lancaster County,8,29801,14705,15096
Pennsylvania,Lancaster County,9,31312,15509,15803
Pennsylvania,Lancaster County,10,33250,16400,16850
Pennsylvania,Lancaster County,11,37508,18286,19222
Pennsylvania,Lancaster County,12,36553,17881,18672
Pennsylvania,Lancaster County,13,31459,15122,16337
Pennsylvania,Lancaster County,14,26237,12530,13707
Pennsylvania,Lancaster County,15,19705,9181,10524
Pennsylvania,Lancaster County,16,14889,6656,8233
Pennsylvania,Lancaster County,17,12190,5106,7084
Pennsylvania,Lancaster County,18,14364,5061,9303
Pennsylvania,Lawrence County,0,88771,42917,45854
Pennsylvania,Lawrence County,1,4753,2357,2396
Pennsylvania,Lawrence County,2,4829,2391,2438
Pennsylvania,Lawrence County,3,5213,2619,2594
Pennsylvania,Lawrence County,4,5569,2905,2664
Pennsylvania,Lawrence County,5,5345,2698,2647
Pennsylvania,Lawrence County,6,4599,2403,2196
Pennsylvania,Lawrence County,7,4640,2247,2393
Pennsylvania,Lawrence County,8,4667,2316,2351
Pennsylvania,Lawrence County,9,5318,2639,2679
Pennsylvania,Lawrence County,10,5701,2860,2841
Pennsylvania,Lawrence County,11,6583,3167,3416
Pennsylvania,Lawrence County,12,7280,3587,3693
Pennsylvania,Lawrence County,13,6577,3182,3395
Pennsylvania,Lawrence County,14,5145,2411,2734
Pennsylvania,Lawrence County,15,3837,1790,2047
Pennsylvania,Lawrence County,16,3160,1333,1827
Pennsylvania,Lawrence County,17,2538,1010,1528
Pennsylvania,Lawrence County,18,3017,1002,2015
Pennsylvania,Lebanon County,0,136359,66970,69389
Pennsylvania,Lebanon County,1,8500,4410,4090
Pennsylvania,Lebanon County,2,8693,4514,4179
Pennsylvania,Lebanon County,3,8778,4522,4256
Pennsylvania,Lebanon County,4,8574,4423,4151
Pennsylvania,Lebanon County,5,8326,4186,4140
Pennsylvania,Lebanon County,6,7600,3785,3815
Pennsylvania,Lebanon County,7,7953,3946,4007
Pennsylvania,Lebanon County,8,7678,3837,3841
Pennsylvania,Lebanon County,9,8381,4227,4154
Pennsylvania,Lebanon County,10,8766,4349,4417
Pennsylvania,Lebanon County,11,9788,4858,4930
Pennsylvania,Lebanon County,12,9602,4683,4919
Pennsylvania,Lebanon County,13,8695,4283,4412
Pennsylvania,Lebanon County,14,7453,3587,3866
Pennsylvania,Lebanon County,15,5848,2703,3145
Pennsylvania,Lebanon County,16,4303,1949,2354
Pennsylvania,Lebanon County,17,3451,1395,2056
Pennsylvania,Lebanon County,18,3970,1313,2657
Pennsylvania,Lehigh County,0,357823,174210,183613
Pennsylvania,Lehigh County,1,21189,10834,10355
Pennsylvania,Lehigh County,2,22383,11560,10823
Pennsylvania,Lehigh County,3,23434,11955,11479
Pennsylvania,Lehigh County,4,23633,11944,11689
Pennsylvania,Lehigh County,5,23211,11481,11730
Pennsylvania,Lehigh County,6,22654,11292,11362
Pennsylvania,Lehigh County,7,22951,11332,11619
Pennsylvania,Lehigh County,8,21644,10822,10822
Pennsylvania,Lehigh County,9,22690,11298,11392
Pennsylvania,Lehigh County,10,24179,11834,12345
Pennsylvania,Lehigh County,11,26283,12904,13379
Pennsylvania,Lehigh County,12,25308,12301,13007
Pennsylvania,Lehigh County,13,20991,10173,10818
Pennsylvania,Lehigh County,14,17654,8287,9367
Pennsylvania,Lehigh County,15,12849,5807,7042
Pennsylvania,Lehigh County,16,9604,4192,5412
Pennsylvania,Lehigh County,17,7943,3175,4768
Pennsylvania,Lehigh County,18,9223,3019,6204
Pennsylvania,Luzerne County,0,318829,157038,161791
Pennsylvania,Luzerne County,1,15972,8198,7774
Pennsylvania,Luzerne County,2,16990,8704,8286
Pennsylvania,Luzerne County,3,17998,9240,8758
Pennsylvania,Luzerne County,4,19803,10141,9662
Pennsylvania,Luzerne County,5,21151,10993,10158
Pennsylvania,Luzerne County,6,19819,10518,9301
Pennsylvania,Luzerne County,7,18339,9542,8797
Pennsylvania,Luzerne County,8,17351,8802,8549
Pennsylvania,Luzerne County,9,20177,10197,9980
Pennsylvania,Luzerne County,10,22357,11435,10922
Pennsylvania,Luzerne County,11,23819,11980,11839
Pennsylvania,Luzerne County,12,23463,11622,11841
Pennsylvania,Luzerne County,13,21166,10314,10852
Pennsylvania,Luzerne County,14,18292,8731,9561
Pennsylvania,Luzerne County,15,13550,6267,7283
Pennsylvania,Luzerne County,16,10244,4339,5905
Pennsylvania,Luzerne County,17,8435,3151,5284
Pennsylvania,Luzerne County,18,9903,2864,7039
Pennsylvania,Lycoming County,0,116508,57313,59195
Pennsylvania,Lycoming County,1,6574,3439,3135
Pennsylvania,Lycoming County,2,6673,3384,3289
Pennsylvania,Lycoming County,3,6724,3371,3353
Pennsylvania,Lycoming County,4,7549,4022,3527
Pennsylvania,Lycoming County,5,8229,4403,3826
Pennsylvania,Lycoming County,6,7926,4138,3788
Pennsylvania,Lycoming County,7,6912,3378,3534
Pennsylvania,Lycoming County,8,6155,3069,3086
Pennsylvania,Lycoming County,9,6782,3255,3527
Pennsylvania,Lycoming County,10,7494,3602,3892
Pennsylvania,Lycoming County,11,8497,4130,4367
Pennsylvania,Lycoming County,12,8855,4377,4478
Pennsylvania,Lycoming County,13,7714,3843,3871
Pennsylvania,Lycoming County,14,6270,3027,3243
Pennsylvania,Lycoming County,15,4668,2102,2566
Pennsylvania,Lycoming County,16,3469,1507,1962
Pennsylvania,Lycoming County,17,2842,1172,1670
Pennsylvania,Lycoming County,18,3175,1094,2081
Pennsylvania,McKean County,0,42554,21797,20757
Pennsylvania,McKean County,1,2083,1050,1033
Pennsylvania,McKean County,2,2359,1210,1149
Pennsylvania,McKean County,3,2507,1331,1176
Pennsylvania,McKean County,4,2818,1460,1358
Pennsylvania,McKean County,5,2747,1463,1284
Pennsylvania,McKean County,6,2433,1362,1071
Pennsylvania,McKean County,7,2483,1440,1043
Pennsylvania,McKean County,8,2441,1318,1123
Pennsylvania,McKean County,9,2789,1472,1317
Pennsylvania,McKean County,10,2885,1555,1330
Pennsylvania,McKean County,11,3094,1576,1518
Pennsylvania,McKean County,12,3324,1662,1662
Pennsylvania,McKean County,13,2857,1457,1400
Pennsylvania,McKean County,14,2338,1127,1211
Pennsylvania,McKean County,15,1783,867,916
Pennsylvania,McKean County,16,1418,617,801
Pennsylvania,McKean County,17,1072,431,641
Pennsylvania,McKean County,18,1123,399,724
Pennsylvania,Mercer County,0,114884,56541,58343
Pennsylvania,Mercer County,1,5650,2888,2762
Pennsylvania,Mercer County,2,6128,3045,3083
Pennsylvania,Mercer County,3,6875,3479,3396
Pennsylvania,Mercer County,4,8215,4456,3759
Pennsylvania,Mercer County,5,7918,4109,3809
Pennsylvania,Mercer County,6,5835,2986,2849
Pennsylvania,Mercer County,7,5943,3033,2910
Pennsylvania,Mercer County,8,5866,2975,2891
Pennsylvania,Mercer County,9,6715,3353,3362
Pennsylvania,Mercer County,10,7515,3812,3703
Pennsylvania,Mercer County,11,8414,4223,4191
Pennsylvania,Mercer County,12,8965,4409,4556
Pennsylvania,Mercer County,13,8045,3947,4098
Pennsylvania,Mercer County,14,6572,3142,3430
Pennsylvania,Mercer County,15,5127,2304,2823
Pennsylvania,Mercer County,16,3991,1790,2201
Pennsylvania,Mercer County,17,3167,1248,1919
Pennsylvania,Mercer County,18,3943,1342,2601
Pennsylvania,Mifflin County,0,46552,22879,23673
Pennsylvania,Mifflin County,1,2778,1435,1343
Pennsylvania,Mifflin County,2,2931,1487,1444
Pennsylvania,Mifflin County,3,3003,1577,1426
Pennsylvania,Mifflin County,4,2748,1428,1320
Pennsylvania,Mifflin County,5,2493,1258,1235
Pennsylvania,Mifflin County,6,2500,1280,1220
Pennsylvania,Mifflin County,7,2507,1244,1263
Pennsylvania,Mifflin County,8,2366,1181,1185
Pennsylvania,Mifflin County,9,2864,1399,1465
Pennsylvania,Mifflin County,10,3168,1579,1589
Pennsylvania,Mifflin County,11,3401,1682,1719
Pennsylvania,Mifflin County,12,3260,1636,1624
Pennsylvania,Mifflin County,13,3082,1497,1585
Pennsylvania,Mifflin County,14,2759,1265,1494
Pennsylvania,Mifflin County,15,2329,1130,1199
Pennsylvania,Mifflin County,16,1713,791,922
Pennsylvania,Mifflin County,17,1298,537,761
Pennsylvania,Mifflin County,18,1352,473,879
Pennsylvania,Monroe County,0,166314,82109,84205
Pennsylvania,Monroe County,1,7469,3725,3744
Pennsylvania,Monroe County,2,9043,4600,4443
Pennsylvania,Monroe County,3,11139,5696,5443
Pennsylvania,Monroe County,4,13480,6913,6567
Pennsylvania,Monroe County,5,12272,6357,5915
Pennsylvania,Monroe County,6,9072,4837,4235
Pennsylvania,Monroe County,7,7872,3972,3900
Pennsylvania,Monroe County,8,8498,3932,4566
Pennsylvania,Monroe County,9,10395,4831,5564
Pennsylvania,Monroe County,10,12793,6190,6603
Pennsylvania,Monroe County,11,14629,7292,7337
Pennsylvania,Monroe County,12,13602,6705,6897
Pennsylvania,Monroe County,13,10983,5535,5448
Pennsylvania,Monroe County,14,8927,4408,4519
Pennsylvania,Monroe County,15,6302,2978,3324
Pennsylvania,Monroe County,16,4346,1979,2367
Pennsylvania,Monroe County,17,2839,1226,1613
Pennsylvania,Monroe County,18,2653,933,1720
Pennsylvania,Montgomery County,0,816857,397160,419697
Pennsylvania,Montgomery County,1,45813,23526,22287
Pennsylvania,Montgomery County,2,49718,25599,24119
Pennsylvania,Montgomery County,3,51861,26308,25553
Pennsylvania,Montgomery County,4,51899,26291,25608
Pennsylvania,Montgomery County,5,45932,23020,22912
Pennsylvania,Montgomery County,6,49442,24887,24555
Pennsylvania,Montgomery County,7,52371,26519,25852
Pennsylvania,Montgomery County,8,49168,24289,24879
Pennsylvania,Montgomery County,9,53506,26537,26969
Pennsylvania,Montgomery County,10,58247,28574,29673
Pennsylvania,Montgomery County,11,63630,30792,32838
Pennsylvania,Montgomery County,12,60806,29615,31191
Pennsylvania,Montgomery County,13,50617,24209,26408
Pennsylvania,Montgomery County,14,40621,19109,21512
Pennsylvania,Montgomery County,15,29702,13472,16230
Pennsylvania,Montgomery County,16,22156,9468,12688
Pennsylvania,Montgomery County,17,18359,7330,11029
Pennsylvania,Montgomery County,18,23009,7615,15394
Pennsylvania,Montour County,0,18641,8903,9738
Pennsylvania,Montour County,1,1093,552,541
Pennsylvania,Montour County,2,1043,547,496
Pennsylvania,Montour County,3,1057,550,507
Pennsylvania,Montour County,4,1038,558,480
Pennsylvania,Montour County,5,945,441,504
Pennsylvania,Montour County,6,1205,577,628
Pennsylvania,Montour County,7,1186,605,581
Pennsylvania,Montour County,8,979,459,520
Pennsylvania,Montour County,9,1028,518,510
Pennsylvania,Montour County,10,1200,586,614
Pennsylvania,Montour County,11,1448,710,738
Pennsylvania,Montour County,12,1484,701,783
Pennsylvania,Montour County,13,1266,609,657
Pennsylvania,Montour County,14,1063,500,563
Pennsylvania,Montour County,15,752,354,398
Pennsylvania,Montour County,16,680,274,406
Pennsylvania,Montour County,17,551,200,351
Pennsylvania,Montour County,18,623,162,461
Pennsylvania,Northampton County,0,300654,147481,153173
Pennsylvania,Northampton County,1,15152,7810,7342
Pennsylvania,Northampton County,2,17008,8702,8306
Pennsylvania,Northampton County,3,18618,9575,9043
Pennsylvania,Northampton County,4,20908,10856,10052
Pennsylvania,Northampton County,5,20641,10852,9789
Pennsylvania,Northampton County,6,17579,9085,8494
Pennsylvania,Northampton County,7,16931,8378,8553
Pennsylvania,Northampton County,8,16784,8174,8610
Pennsylvania,Northampton County,9,19019,9367,9652
Pennsylvania,Northampton County,10,21061,10424,10637
Pennsylvania,Northampton County,11,22916,11322,11594
Pennsylvania,Northampton County,12,22711,11107,11604
Pennsylvania,Northampton County,13,19106,9246,9860
Pennsylvania,Northampton County,14,16162,7702,8460
Pennsylvania,Northampton County,15,11744,5445,6299
Pennsylvania,Northampton County,16,8520,3746,4774
Pennsylvania,Northampton County,17,6990,2779,4211
Pennsylvania,Northampton County,18,8804,2911,5893
Pennsylvania,Northumberland County,0,93944,47194,46750
Pennsylvania,Northumberland County,1,4999,2558,2441
Pennsylvania,Northumberland County,2,5255,2716,2539
Pennsylvania,Northumberland County,3,5244,2666,2578
Pennsylvania,Northumberland County,4,4980,2695,2285
Pennsylvania,Northumberland County,5,5330,2861,2469
Pennsylvania,Northumberland County,6,5764,3131,2633
Pennsylvania,Northumberland County,7,5558,2945,2613
Pennsylvania,Northumberland County,8,5234,2809,2425
Pennsylvania,Northumberland County,9,5855,3023,2832
Pennsylvania,Northumberland County,10,6284,3293,2991
Pennsylvania,Northumberland County,11,7101,3615,3486
Pennsylvania,Northumberland County,12,7241,3582,3659
Pennsylvania,Northumberland County,13,6605,3304,3301
Pennsylvania,Northumberland County,14,5657,2717,2940
Pennsylvania,Northumberland County,15,4203,1940,2263
Pennsylvania,Northumberland County,16,3290,1458,1832
Pennsylvania,Northumberland County,17,2465,991,1474
Pennsylvania,Northumberland County,18,2879,890,1989
Pennsylvania,Perry County,0,45634,22941,22693
Pennsylvania,Perry County,1,2691,1402,1289
Pennsylvania,Perry County,2,2709,1430,1279
Pennsylvania,Perry County,3,2787,1437,1350
Pennsylvania,Perry County,4,2881,1560,1321
Pennsylvania,Perry County,5,2615,1303,1312
Pennsylvania,Perry County,6,2515,1289,1226
Pennsylvania,Perry County,7,2572,1295,1277
Pennsylvania,Perry County,8,2607,1279,1328
Pennsylvania,Perry County,9,3032,1543,1489
Pennsylvania,Perry County,10,3370,1703,1667
Pennsylvania,Perry County,11,3585,1827,1758
Pennsylvania,Perry County,12,3689,1805,1884
Pennsylvania,Perry County,13,3336,1705,1631
Pennsylvania,Perry County,14,2647,1369,1278
Pennsylvania,Perry County,15,1821,885,936
Pennsylvania,Perry County,16,1183,525,658
Pennsylvania,Perry County,17,821,339,482
Pennsylvania,Perry County,18,773,245,528
Pennsylvania,Philadelphia County,0,1560297,737777,822520
Pennsylvania,Philadelphia County,1,110126,56000,54126
Pennsylvania,Philadelphia County,2,94935,48381,46554
Pennsylvania,Philadelphia County,3,88307,44830,43477
Pennsylvania,Philadelphia County,4,100175,49989,50186
Pennsylvania,Philadelphia County,5,130084,63063,67021
Pennsylvania,Philadelphia County,6,156346,75012,81334
Pennsylvania,Philadelphia County,7,126741,61020,65721
Pennsylvania,Philadelphia County,8,98668,47335,51333
Pennsylvania,Philadelphia County,9,92102,44111,47991
Pennsylvania,Philadelphia County,10,92844,44342,48502
Pennsylvania,Philadelphia County,11,97354,45994,51360
Pennsylvania,Philadelphia County,12,96109,44272,51837
Pennsylvania,Philadelphia County,13,81191,36417,44774
Pennsylvania,Philadelphia County,14,62944,27190,35754
Pennsylvania,Philadelphia County,15,44630,18509,26121
Pennsylvania,Philadelphia County,16,33327,13209,20118
Pennsylvania,Philadelphia County,17,25506,9314,16192
Pennsylvania,Philadelphia County,18,28908,8789,20119
Pennsylvania,Pike County,0,56191,28205,27986
Pennsylvania,Pike County,1,2123,1062,1061
Pennsylvania,Pike County,2,2899,1504,1395
Pennsylvania,Pike County,3,3615,1857,1758
Pennsylvania,Pike County,4,3862,2073,1789
Pennsylvania,Pike County,5,3177,1705,1472
Pennsylvania,Pike County,6,2399,1241,1158
Pennsylvania,Pike County,7,2449,1256,1193
Pennsylvania,Pike County,8,2768,1409,1359
Pennsylvania,Pike County,9,3358,1599,1759
Pennsylvania,Pike County,10,4348,2129,2219
Pennsylvania,Pike County,11,5043,2508,2535
Pennsylvania,Pike County,12,4609,2340,2269
Pennsylvania,Pike County,13,4110,2033,2077
Pennsylvania,Pike County,14,3797,1857,1940
Pennsylvania,Pike County,15,3186,1527,1659
Pennsylvania,Pike County,16,2035,1048,987
Pennsylvania,Pike County,17,1336,615,721
Pennsylvania,Pike County,18,1077,442,635
Pennsylvania,Potter County,0,17206,8610,8596
Pennsylvania,Potter County,1,961,480,481
Pennsylvania,Potter County,2,950,502,448
Pennsylvania,Potter County,3,1082,552,530
Pennsylvania,Potter County,4,985,526,459
Pennsylvania,Potter County,5,922,490,432
Pennsylvania,Potter County,6,828,426,402
Pennsylvania,Potter County,7,847,445,402
Pennsylvania,Potter County,8,844,429,415
Pennsylvania,Potter County,9,911,461,450
Pennsylvania,Potter County,10,1101,558,543
Pennsylvania,Potter County,11,1333,650,683
Pennsylvania,Potter County,12,1365,713,652
Pennsylvania,Potter County,13,1326,645,681
Pennsylvania,Potter County,14,1180,569,611
Pennsylvania,Potter County,15,926,460,466
Pennsylvania,Potter County,16,676,339,337
Pennsylvania,Potter County,17,474,190,284
Pennsylvania,Potter County,18,495,175,320
Pennsylvania,Schuylkill County,0,145797,74544,71253
Pennsylvania,Schuylkill County,1,6914,3606,3308
Pennsylvania,Schuylkill County,2,8033,4146,3887
Pennsylvania,Schuylkill County,3,8468,4391,4077
Pennsylvania,Schuylkill County,4,7751,3999,3752
Pennsylvania,Schuylkill County,5,8130,4473,3657
Pennsylvania,Schuylkill County,6,8389,4707,3682
Pennsylvania,Schuylkill County,7,8696,4824,3872
Pennsylvania,Schuylkill County,8,8558,4710,3848
Pennsylvania,Schuylkill County,9,9732,5200,4532
Pennsylvania,Schuylkill County,10,10705,5719,4986
Pennsylvania,Schuylkill County,11,11052,5752,5300
Pennsylvania,Schuylkill County,12,11210,5714,5496
Pennsylvania,Schuylkill County,13,9972,4995,4977
Pennsylvania,Schuylkill County,14,8641,4260,4381
Pennsylvania,Schuylkill County,15,6353,2915,3438
Pennsylvania,Schuylkill County,16,4821,2189,2632
Pennsylvania,Schuylkill County,17,3942,1511,2431
Pennsylvania,Schuylkill County,18,4430,1433,2997
Pennsylvania,Snyder County,0,40323,19914,20409
Pennsylvania,Snyder County,1,2249,1187,1062
Pennsylvania,Snyder County,2,2484,1318,1166
Pennsylvania,Snyder County,3,2585,1314,1271
Pennsylvania,Snyder County,4,3206,1636,1570
Pennsylvania,Snyder County,5,3152,1549,1603
Pennsylvania,Snyder County,6,2380,1219,1161
Pennsylvania,Snyder County,7,2161,1104,1057
Pennsylvania,Snyder County,8,2121,1018,1103
Pennsylvania,Snyder County,9,2443,1244,1199
Pennsylvania,Snyder County,10,2641,1329,1312
Pennsylvania,Snyder County,11,2857,1407,1450
Pennsylvania,Snyder County,12,2859,1444,1415
Pennsylvania,Snyder County,13,2473,1223,1250
Pennsylvania,Snyder County,14,2064,971,1093
Pennsylvania,Snyder County,15,1631,759,872
Pennsylvania,Snyder County,16,1227,551,676
Pennsylvania,Snyder County,17,863,359,504
Pennsylvania,Snyder County,18,927,282,645
Pennsylvania,Somerset County,0,76218,39554,36664
Pennsylvania,Somerset County,1,3391,1672,1719
Pennsylvania,Somerset County,2,3729,1905,1824
Pennsylvania,Somerset County,3,4209,2100,2109
Pennsylvania,Somerset County,4,4061,2125,1936
Pennsylvania,Somerset County,5,4260,2458,1802
Pennsylvania,Somerset County,6,4240,2485,1755
Pennsylvania,Somerset County,7,4370,2527,1843
Pennsylvania,Somerset County,8,4343,2430,1913
Pennsylvania,Somerset County,9,5032,2775,2257
Pennsylvania,Somerset County,10,5271,2879,2392
Pennsylvania,Somerset County,11,5933,3122,2811
Pennsylvania,Somerset County,12,6161,3180,2981
Pennsylvania,Somerset County,13,5697,2947,2750
Pennsylvania,Somerset County,14,4656,2357,2299
Pennsylvania,Somerset County,15,3515,1691,1824
Pennsylvania,Somerset County,16,2757,1225,1532
Pennsylvania,Somerset County,17,2069,812,1257
Pennsylvania,Somerset County,18,2524,864,1660
Pennsylvania,Sullivan County,0,6339,3317,3022
Pennsylvania,Sullivan County,1,218,117,101
Pennsylvania,Sullivan County,2,192,96,96
Pennsylvania,Sullivan County,3,181,94,87
Pennsylvania,Sullivan County,4,388,256,132
Pennsylvania,Sullivan County,5,414,255,159
Pennsylvania,Sullivan County,6,299,161,138
Pennsylvania,Sullivan County,7,259,136,123
Pennsylvania,Sullivan County,8,278,153,125
Pennsylvania,Sullivan County,9,321,173,148
Pennsylvania,Sullivan County,10,367,190,177
Pennsylvania,Sullivan County,11,550,267,283
Pennsylvania,Sullivan County,12,628,317,311
Pennsylvania,Sullivan County,13,537,309,228
Pennsylvania,Sullivan County,14,528,254,274
Pennsylvania,Sullivan County,15,417,201,216
Pennsylvania,Sullivan County,16,322,167,155
Pennsylvania,Sullivan County,17,245,104,141
Pennsylvania,Sullivan County,18,195,67,128
Pennsylvania,Susquehanna County,0,41920,21131,20789
Pennsylvania,Susquehanna County,1,2032,1057,975
Pennsylvania,Susquehanna County,2,2230,1119,1111
Pennsylvania,Susquehanna County,3,2404,1239,1165
Pennsylvania,Susquehanna County,4,2438,1297,1141
Pennsylvania,Susquehanna County,5,2316,1225,1091
Pennsylvania,Susquehanna County,6,2064,1054,1010
Pennsylvania,Susquehanna County,7,2105,1090,1015
Pennsylvania,Susquehanna County,8,2051,1028,1023
Pennsylvania,Susquehanna County,9,2416,1247,1169
Pennsylvania,Susquehanna County,10,2878,1425,1453
Pennsylvania,Susquehanna County,11,3630,1872,1758
Pennsylvania,Susquehanna County,12,3777,1959,1818
Pennsylvania,Susquehanna County,13,3187,1574,1613
Pennsylvania,Susquehanna County,14,2777,1386,1391
Pennsylvania,Susquehanna County,15,2135,1038,1097
Pennsylvania,Susquehanna County,16,1518,765,753
Pennsylvania,Susquehanna County,17,972,419,553
Pennsylvania,Susquehanna County,18,990,337,653
Pennsylvania,Tioga County,0,42274,20926,21348
Pennsylvania,Tioga County,1,2437,1292,1145
Pennsylvania,Tioga County,2,2205,1127,1078
Pennsylvania,Tioga County,3,2378,1200,1178
Pennsylvania,Tioga County,4,2923,1377,1546
Pennsylvania,Tioga County,5,2972,1454,1518
Pennsylvania,Tioga County,6,2499,1302,1197
Pennsylvania,Tioga County,7,2221,1108,1113
Pennsylvania,Tioga County,8,2059,1046,1013
Pennsylvania,Tioga County,9,2391,1203,1188
Pennsylvania,Tioga County,10,2658,1325,1333
Pennsylvania,Tioga County,11,3092,1513,1579
Pennsylvania,Tioga County,12,3283,1617,1666
Pennsylvania,Tioga County,13,2866,1450,1416
Pennsylvania,Tioga County,14,2559,1287,1272
Pennsylvania,Tioga County,15,2135,1030,1105
Pennsylvania,Tioga County,16,1557,738,819
Pennsylvania,Tioga County,17,1079,498,581
Pennsylvania,Tioga County,18,960,359,601
Pennsylvania,Union County,0,44874,24681,20193
Pennsylvania,Union County,1,1989,1020,969
Pennsylvania,Union County,2,2217,1104,1113
Pennsylvania,Union County,3,2478,1295,1183
Pennsylvania,Union County,4,3479,1720,1759
Pennsylvania,Union County,5,3869,2204,1665
Pennsylvania,Union County,6,3050,1887,1163
Pennsylvania,Union County,7,3141,2097,1044
Pennsylvania,Union County,8,2990,1968,1022
Pennsylvania,Union County,9,3058,1936,1122
Pennsylvania,Union County,10,2995,1766,1229
Pennsylvania,Union County,11,3046,1729,1317
Pennsylvania,Union County,12,2864,1505,1359
Pennsylvania,Union County,13,2481,1284,1197
Pennsylvania,Union County,14,2145,1043,1102
Pennsylvania,Union County,15,1632,772,860
Pennsylvania,Union County,16,1270,566,704
Pennsylvania,Union County,17,987,404,583
Pennsylvania,Union County,18,1183,381,802
Pennsylvania,Venango County,0,53529,26315,27214
Pennsylvania,Venango County,1,2853,1436,1417
Pennsylvania,Venango County,2,2938,1492,1446
Pennsylvania,Venango County,3,3049,1536,1513
Pennsylvania,Venango County,4,3086,1671,1415
Pennsylvania,Venango County,5,2866,1456,1410
Pennsylvania,Venango County,6,2708,1322,1386
Pennsylvania,Venango County,7,2761,1351,1410
Pennsylvania,Venango County,8,2822,1468,1354
Pennsylvania,Venango County,9,3084,1540,1544
Pennsylvania,Venango County,10,3405,1729,1676
Pennsylvania,Venango County,11,4328,2158,2170
Pennsylvania,Venango County,12,4711,2314,2397
Pennsylvania,Venango County,13,4254,2122,2132
Pennsylvania,Venango County,14,3351,1622,1729
Pennsylvania,Venango County,15,2525,1167,1358
Pennsylvania,Venango County,16,1856,849,1007
Pennsylvania,Venango County,17,1435,569,866
Pennsylvania,Venango County,18,1497,513,984
Pennsylvania,Warren County,0,40703,20420,20283
Pennsylvania,Warren County,1,1997,1047,950
Pennsylvania,Warren County,2,2124,1071,1053
Pennsylvania,Warren County,3,2381,1246,1135
Pennsylvania,Warren County,4,2320,1241,1079
Pennsylvania,Warren County,5,2191,1160,1031
Pennsylvania,Warren County,6,2000,1025,975
Pennsylvania,Warren County,7,2156,1104,1052
Pennsylvania,Warren County,8,2003,1026,977
Pennsylvania,Warren County,9,2411,1192,1219
Pennsylvania,Warren County,10,2815,1444,1371
Pennsylvania,Warren County,11,3244,1651,1593
Pennsylvania,Warren County,12,3523,1770,1753
Pennsylvania,Warren County,13,3118,1547,1571
Pennsylvania,Warren County,14,2601,1274,1327
Pennsylvania,Warren County,15,2042,1008,1034
Pennsylvania,Warren County,16,1477,693,784
Pennsylvania,Warren County,17,1106,480,626
Pennsylvania,Warren County,18,1194,441,753
Pennsylvania,Washington County,0,208187,101893,106294
Pennsylvania,Washington County,1,10398,5282,5116
Pennsylvania,Washington County,2,11178,5745,5433
Pennsylvania,Washington County,3,12026,6209,5817
Pennsylvania,Washington County,4,13050,6670,6380
Pennsylvania,Washington County,5,12755,6469,6286
Pennsylvania,Washington County,6,11104,5797,5307
Pennsylvania,Washington County,7,11244,5636,5608
Pennsylvania,Washington County,8,11525,5766,5759
Pennsylvania,Washington County,9,12876,6454,6422
Pennsylvania,Washington County,10,14386,7067,7319
Pennsylvania,Washington County,11,16180,7960,8220
Pennsylvania,Washington County,12,17043,8379,8664
Pennsylvania,Washington County,13,15019,7302,7717
Pennsylvania,Washington County,14,12400,6018,6382
Pennsylvania,Washington County,15,8966,4112,4854
Pennsylvania,Washington County,16,6898,3006,3892
Pennsylvania,Washington County,17,5051,1978,3073
Pennsylvania,Washington County,18,6088,2043,4045
Pennsylvania,Wayne County,0,51401,27277,24124
Pennsylvania,Wayne County,1,2088,1132,956
Pennsylvania,Wayne County,2,2293,1175,1118
Pennsylvania,Wayne County,3,2822,1455,1367
Pennsylvania,Wayne County,4,2902,1512,1390
Pennsylvania,Wayne County,5,2757,1537,1220
Pennsylvania,Wayne County,6,2695,1626,1069
Pennsylvania,Wayne County,7,2851,1694,1157
Pennsylvania,Wayne County,8,2738,1596,1142
Pennsylvania,Wayne County,9,3241,1867,1374
Pennsylvania,Wayne County,10,3688,1969,1719
Pennsylvania,Wayne County,11,4323,2284,2039
Pennsylvania,Wayne County,12,4312,2241,2071
Pennsylvania,Wayne County,13,4053,2030,2023
Pennsylvania,Wayne County,14,3710,1906,1804
Pennsylvania,Wayne County,15,2751,1423,1328
Pennsylvania,Wayne County,16,1821,858,963
Pennsylvania,Wayne County,17,1242,550,692
Pennsylvania,Wayne County,18,1114,422,692
Pennsylvania,Westmoreland County,0,359320,175361,183959
Pennsylvania,Westmoreland County,1,16528,8546,7982
Pennsylvania,Westmoreland County,2,18438,9354,9084
Pennsylvania,Westmoreland County,3,19760,10083,9677
Pennsylvania,Westmoreland County,4,21025,10936,10089
Pennsylvania,Westmoreland County,5,20414,10573,9841
Pennsylvania,Westmoreland County,6,17916,9229,8687
Pennsylvania,Westmoreland County,7,18754,9473,9281
Pennsylvania,Westmoreland County,8,18180,9118,9062
Pennsylvania,Westmoreland County,9,22102,11026,11076
Pennsylvania,Westmoreland County,10,25520,12638,12882
Pennsylvania,Westmoreland County,11,28726,14026,14700
Pennsylvania,Westmoreland County,12,30538,15088,15450
Pennsylvania,Westmoreland County,13,27180,13243,13937
Pennsylvania,Westmoreland County,14,22738,10772,11966
Pennsylvania,Westmoreland County,15,17059,7882,9177
Pennsylvania,Westmoreland County,16,12847,5549,7298
Pennsylvania,Westmoreland County,17,10265,4062,6203
Pennsylvania,Westmoreland County,18,11330,3763,7567
Pennsylvania,Wyoming County,0,28131,14176,13955
Pennsylvania,Wyoming County,1,1416,793,623
Pennsylvania,Wyoming County,2,1565,817,748
Pennsylvania,Wyoming County,3,1699,866,833
Pennsylvania,Wyoming County,4,1767,937,830
Pennsylvania,Wyoming County,5,1803,956,847
Pennsylvania,Wyoming County,6,1576,804,772
Pennsylvania,Wyoming County,7,1518,775,743
Pennsylvania,Wyoming County,8,1478,732,746
Pennsylvania,Wyoming County,9,1794,894,900
Pennsylvania,Wyoming County,10,1820,869,951
Pennsylvania,Wyoming County,11,2214,1138,1076
Pennsylvania,Wyoming County,12,2260,1103,1157
Pennsylvania,Wyoming County,13,2042,1024,1018
Pennsylvania,Wyoming County,14,1811,932,879
Pennsylvania,Wyoming County,15,1376,707,669
Pennsylvania,Wyoming County,16,822,398,424
Pennsylvania,Wyoming County,17,557,242,315
Pennsylvania,Wyoming County,18,613,189,424
Pennsylvania,York County,0,440755,218015,222740
Pennsylvania,York County,1,25175,12995,12180
Pennsylvania,York County,2,27672,14369,13303
Pennsylvania,York County,3,28647,14789,13858
Pennsylvania,York County,4,27959,14460,13499
Pennsylvania,York County,5,26429,13629,12800
Pennsylvania,York County,6,26171,13224,12947
Pennsylvania,York County,7,26879,13305,13574
Pennsylvania,York County,8,25644,12671,12973
Pennsylvania,York County,9,29624,14691,14933
Pennsylvania,York County,10,31547,15831,15716
Pennsylvania,York County,11,34351,16950,17401
Pennsylvania,York County,12,32775,16199,16576
Pennsylvania,York County,13,27740,13538,14202
Pennsylvania,York County,14,23278,11144,12134
Pennsylvania,York County,15,16713,7916,8797
Pennsylvania,York County,16,11878,5368,6510
Pennsylvania,York County,17,8783,3731,5052
Pennsylvania,York County,18,9490,3205,6285
Rhode Island,Bristol County,0,49060,23629,25431
Rhode Island,Bristol County,1,1972,1012,960
Rhode Island,Bristol County,2,2615,1334,1281
Rhode Island,Bristol County,3,3117,1548,1569
Rhode Island,Bristol County,4,3816,1903,1913
Rhode Island,Bristol County,5,3425,1813,1612
Rhode Island,Bristol County,6,2512,1287,1225
Rhode Island,Bristol County,7,2224,1077,1147
Rhode Island,Bristol County,8,2317,1105,1212
Rhode Island,Bristol County,9,2978,1433,1545
Rhode Island,Bristol County,10,3501,1669,1832
Rhode Island,Bristol County,11,4122,1917,2205
Rhode Island,Bristol County,12,3958,1934,2024
Rhode Island,Bristol County,13,3294,1604,1690
Rhode Island,Bristol County,14,2803,1301,1502
Rhode Island,Bristol County,15,1920,913,1007
Rhode Island,Bristol County,16,1508,642,866
Rhode Island,Bristol County,17,1240,503,737
Rhode Island,Bristol County,18,1738,634,1104
Rhode Island,Kent County,0,165128,79737,85391
Rhode Island,Kent County,1,8013,4143,3870
Rhode Island,Kent County,2,8374,4354,4020
Rhode Island,Kent County,3,9535,4973,4562
Rhode Island,Kent County,4,9268,4783,4485
Rhode Island,Kent County,5,9222,4720,4502
Rhode Island,Kent County,6,10263,5142,5121
Rhode Island,Kent County,7,10328,5195,5133
Rhode Island,Kent County,8,9665,4785,4880
Rhode Island,Kent County,9,10839,5338,5501
Rhode Island,Kent County,10,12438,5999,6439
Rhode Island,Kent County,11,13726,6495,7231
Rhode Island,Kent County,12,13585,6422,7163
Rhode Island,Kent County,13,11188,5336,5852
Rhode Island,Kent County,14,9299,4357,4942
Rhode Island,Kent County,15,6382,2851,3531
Rhode Island,Kent County,16,4488,1885,2603
Rhode Island,Kent County,17,3778,1500,2278
Rhode Island,Kent County,18,4737,1459,3278
Rhode Island,Newport County,0,82358,40455,41903
Rhode Island,Newport County,1,3655,1862,1793
Rhode Island,Newport County,2,4225,2169,2056
Rhode Island,Newport County,3,4450,2324,2126
Rhode Island,Newport County,4,5353,2669,2684
Rhode Island,Newport County,5,5175,2747,2428
Rhode Island,Newport County,6,5127,2694,2433
Rhode Island,Newport County,7,4649,2377,2272
Rhode Island,Newport County,8,4482,2317,2165
Rhode Island,Newport County,9,4923,2462,2461
Rhode Island,Newport County,10,5659,2746,2913
Rhode Island,Newport County,11,6397,3111,3286
Rhode Island,Newport County,12,6462,3084,3378
Rhode Island,Newport County,13,5923,2822,3101
Rhode Island,Newport County,14,5239,2531,2708
Rhode Island,Newport County,15,3705,1745,1960
Rhode Island,Newport County,16,2554,1134,1420
Rhode Island,Newport County,17,1962,828,1134
Rhode Island,Newport County,18,2418,833,1585
Rhode Island,Providence County,0,631974,306379,325595
Rhode Island,Providence County,1,36408,18662,17746
Rhode Island,Providence County,2,36551,18675,17876
Rhode Island,Providence County,3,37011,18933,18078
Rhode Island,Providence County,4,44723,22372,22351
Rhode Island,Providence County,5,51225,25487,25738
Rhode Island,Providence County,6,49351,25001,24350
Rhode Island,Providence County,7,43353,21859,21494
Rhode Island,Providence County,8,37945,18672,19273
Rhode Island,Providence County,9,39558,19276,20282
Rhode Island,Providence County,10,42791,20873,21918
Rhode Island,Providence County,11,44958,21724,23234
Rhode Island,Providence County,12,43133,20713,22420
Rhode Island,Providence County,13,35283,16747,18536
Rhode Island,Providence County,14,27601,12967,14634
Rhode Island,Providence County,15,19604,8800,10804
Rhode Island,Providence County,16,14579,6147,8432
Rhode Island,Providence County,17,11902,4526,7376
Rhode Island,Providence County,18,15998,4945,11053
Rhode Island,Washington County,0,126653,61163,65490
Rhode Island,Washington County,1,4848,2408,2440
Rhode Island,Washington County,2,6037,2962,3075
Rhode Island,Washington County,3,7103,3668,3435
Rhode Island,Washington County,4,11410,5519,5891
Rhode Island,Washington County,5,12451,6318,6133
Rhode Island,Washington County,6,5471,2780,2691
Rhode Island,Washington County,7,5493,2781,2712
Rhode Island,Washington County,8,5711,2768,2943
Rhode Island,Washington County,9,6841,3307,3534
Rhode Island,Washington County,10,8696,4171,4525
Rhode Island,Washington County,11,10342,4979,5363
Rhode Island,Washington County,12,10296,4960,5336
Rhode Island,Washington County,13,9262,4437,4825
Rhode Island,Washington County,14,7691,3833,3858
Rhode Island,Washington County,15,5407,2516,2891
Rhode Island,Washington County,16,3474,1554,1920
Rhode Island,Washington County,17,2702,1102,1600
Rhode Island,Washington County,18,3418,1100,2318
South Carolina,Abbeville County,0,24965,12103,12862
South Carolina,Abbeville County,1,1358,685,673
South Carolina,Abbeville County,2,1483,790,693
South Carolina,Abbeville County,3,1556,799,757
South Carolina,Abbeville County,4,1710,880,830
South Carolina,Abbeville County,5,1716,841,875
South Carolina,Abbeville County,6,1222,615,607
South Carolina,Abbeville County,7,1268,619,649
South Carolina,Abbeville County,8,1285,613,672
South Carolina,Abbeville County,9,1517,746,771
South Carolina,Abbeville County,10,1611,778,833
South Carolina,Abbeville County,11,1713,810,903
South Carolina,Abbeville County,12,1854,895,959
South Carolina,Abbeville County,13,1839,875,964
South Carolina,Abbeville County,14,1693,824,869
South Carolina,Abbeville County,15,1191,543,648
South Carolina,Abbeville County,16,864,383,481
South Carolina,Abbeville County,17,566,214,352
South Carolina,Abbeville County,18,519,193,326
South Carolina,Aiken County,0,164753,79944,84809
South Carolina,Aiken County,1,9402,4857,4545
South Carolina,Aiken County,2,10334,5282,5052
South Carolina,Aiken County,3,10473,5386,5087
South Carolina,Aiken County,4,9898,4997,4901
South Carolina,Aiken County,5,10539,5272,5267
South Carolina,Aiken County,6,10512,5235,5277
South Carolina,Aiken County,7,10185,4958,5227
South Carolina,Aiken County,8,9166,4553,4613
South Carolina,Aiken County,9,9772,4741,5031
South Carolina,Aiken County,10,10500,5029,5471
South Carolina,Aiken County,11,12010,5823,6187
South Carolina,Aiken County,12,12097,5794,6303
South Carolina,Aiken County,13,11004,5100,5904
South Carolina,Aiken County,14,9751,4640,5111
South Carolina,Aiken County,15,7453,3510,3943
South Carolina,Aiken County,16,4908,2225,2683
South Carolina,Aiken County,17,3523,1466,2057
South Carolina,Aiken County,18,3226,1076,2150
South Carolina,Allendale County,0,9695,5228,4467
South Carolina,Allendale County,1,497,256,241
South Carolina,Allendale County,2,515,266,249
South Carolina,Allendale County,3,563,306,257
South Carolina,Allendale County,4,510,285,225
South Carolina,Allendale County,5,720,430,290
South Carolina,Allendale County,6,723,490,233
South Carolina,Allendale County,7,659,421,238
South Carolina,Allendale County,8,554,322,232
South Carolina,Allendale County,9,649,356,293
South Carolina,Allendale County,10,690,395,295
South Carolina,Allendale County,11,657,347,310
South Carolina,Allendale County,12,693,337,356
South Carolina,Allendale County,13,687,330,357
South Carolina,Allendale County,14,616,278,338
South Carolina,Allendale County,15,387,184,203
South Carolina,Allendale County,16,231,101,130
South Carolina,Allendale County,17,185,68,117
South Carolina,Allendale County,18,159,56,103
South Carolina,Anderson County,0,192810,93118,99692
South Carolina,Anderson County,1,11492,5769,5723
South Carolina,Anderson County,2,12570,6332,6238
South Carolina,Anderson County,3,12918,6651,6267
South Carolina,Anderson County,4,12550,6492,6058
South Carolina,Anderson County,5,11853,5884,5969
South Carolina,Anderson County,6,11240,5488,5752
South Carolina,Anderson County,7,11041,5216,5825
South Carolina,Anderson County,8,11257,5450,5807
South Carolina,Anderson County,9,12688,6115,6573
South Carolina,Anderson County,10,12927,6386,6541
South Carolina,Anderson County,11,13939,6775,7164
South Carolina,Anderson County,12,13508,6472,7036
South Carolina,Anderson County,13,12008,5692,6316
South Carolina,Anderson County,14,10995,5153,5842
South Carolina,Anderson County,15,8351,3905,4446
South Carolina,Anderson County,16,5999,2653,3346
South Carolina,Anderson County,17,3957,1587,2370
South Carolina,Anderson County,18,3517,1098,2419
South Carolina,Bamberg County,0,15182,7312,7870
South Carolina,Bamberg County,1,776,388,388
South Carolina,Bamberg County,2,837,415,422
South Carolina,Bamberg County,3,863,443,420
South Carolina,Bamberg County,4,1370,719,651
South Carolina,Bamberg County,5,1447,746,701
South Carolina,Bamberg County,6,733,349,384
South Carolina,Bamberg County,7,703,348,355
South Carolina,Bamberg County,8,698,318,380
South Carolina,Bamberg County,9,807,381,426
South Carolina,Bamberg County,10,930,466,464
South Carolina,Bamberg County,11,1061,505,556
South Carolina,Bamberg County,12,1087,524,563
South Carolina,Bamberg County,13,1094,513,581
South Carolina,Bamberg County,14,926,424,502
South Carolina,Bamberg County,15,682,319,363
South Carolina,Bamberg County,16,475,202,273
South Carolina,Bamberg County,17,341,136,205
South Carolina,Bamberg County,18,352,116,236
South Carolina,Barnwell County,0,21959,10464,11495
South Carolina,Barnwell County,1,1533,761,772
South Carolina,Barnwell County,2,1485,752,733
South Carolina,Barnwell County,3,1577,796,781
South Carolina,Barnwell County,4,1445,750,695
South Carolina,Barnwell County,5,1445,748,697
South Carolina,Barnwell County,6,1206,585,621
South Carolina,Barnwell County,7,1201,558,643
South Carolina,Barnwell County,8,1217,569,648
South Carolina,Barnwell County,9,1286,612,674
South Carolina,Barnwell County,10,1367,637,730
South Carolina,Barnwell County,11,1624,765,859
South Carolina,Barnwell County,12,1626,727,899
South Carolina,Barnwell County,13,1449,686,763
South Carolina,Barnwell County,14,1254,604,650
South Carolina,Barnwell County,15,891,384,507
South Carolina,Barnwell County,16,532,235,297
South Carolina,Barnwell County,17,409,148,261
South Carolina,Barnwell County,18,412,147,265
South Carolina,Beaufort County,0,175852,86429,89423
South Carolina,Beaufort County,1,10133,5178,4955
South Carolina,Beaufort County,2,10273,5214,5059
South Carolina,Beaufort County,3,9371,4642,4729
South Carolina,Beaufort County,4,9771,5370,4401
South Carolina,Beaufort County,5,12358,7261,5097
South Carolina,Beaufort County,6,10823,5592,5231
South Carolina,Beaufort County,7,9955,4868,5087
South Carolina,Beaufort County,8,9192,4691,4501
South Carolina,Beaufort County,9,9349,4575,4774
South Carolina,Beaufort County,10,8913,4216,4697
South Carolina,Beaufort County,11,10084,4678,5406
South Carolina,Beaufort County,12,10746,4789,5957
South Carolina,Beaufort County,13,12437,5301,7136
South Carolina,Beaufort County,14,14549,6730,7819
South Carolina,Beaufort County,15,11692,5645,6047
South Carolina,Beaufort County,16,7485,3711,3774
South Carolina,Beaufort County,17,4644,2357,2287
South Carolina,Beaufort County,18,4077,1611,2466
South Carolina,Berkeley County,0,198205,98773,99432
South Carolina,Berkeley County,1,13468,6976,6492
South Carolina,Berkeley County,2,13950,7175,6775
South Carolina,Berkeley County,3,13404,6667,6737
South Carolina,Berkeley County,4,12748,7030,5718
South Carolina,Berkeley County,5,14994,8725,6269
South Carolina,Berkeley County,6,14602,7302,7300
South Carolina,Berkeley County,7,14431,7076,7355
South Carolina,Berkeley County,8,12932,6301,6631
South Carolina,Berkeley County,9,13177,6473,6704
South Carolina,Berkeley County,10,12921,6314,6607
South Carolina,Berkeley County,11,13700,6644,7056
South Carolina,Berkeley County,12,12660,5981,6679
South Carolina,Berkeley County,13,10911,5128,5783
South Carolina,Berkeley County,14,9303,4347,4956
South Carolina,Berkeley County,15,6596,3089,3507
South Carolina,Berkeley County,16,4057,1847,2210
South Carolina,Berkeley County,17,2363,1055,1308
South Carolina,Berkeley County,18,1988,643,1345
South Carolina,Calhoun County,0,14878,7251,7627
South Carolina,Calhoun County,1,780,447,333
South Carolina,Calhoun County,2,858,420,438
South Carolina,Calhoun County,3,882,429,453
South Carolina,Calhoun County,4,814,410,404
South Carolina,Calhoun County,5,863,467,396
South Carolina,Calhoun County,6,736,381,355
South Carolina,Calhoun County,7,770,375,395
South Carolina,Calhoun County,8,776,387,389
South Carolina,Calhoun County,9,884,411,473
South Carolina,Calhoun County,10,967,452,515
South Carolina,Calhoun County,11,1203,575,628
South Carolina,Calhoun County,12,1203,597,606
South Carolina,Calhoun County,13,1209,573,636
South Carolina,Calhoun County,14,1050,510,540
South Carolina,Calhoun County,15,791,360,431
South Carolina,Calhoun County,16,473,234,239
South Carolina,Calhoun County,17,305,121,184
South Carolina,Calhoun County,18,314,102,212
South Carolina,Charleston County,0,381015,184528,196487
South Carolina,Charleston County,1,23299,11882,11417
South Carolina,Charleston County,2,22169,11196,10973
South Carolina,Charleston County,3,20167,10313,9854
South Carolina,Charleston County,4,21072,10436,10636
South Carolina,Charleston County,5,28268,14545,13723
South Carolina,Charleston County,6,35325,17251,18074
South Carolina,Charleston County,7,30716,15199,15517
South Carolina,Charleston County,8,24067,12052,12015
South Carolina,Charleston County,9,22940,11434,11506
South Carolina,Charleston County,10,22817,11138,11679
South Carolina,Charleston County,11,26009,12387,13622
South Carolina,Charleston County,12,25467,11774,13693
South Carolina,Charleston County,13,23526,10806,12720
South Carolina,Charleston County,14,19920,9295,10625
South Carolina,Charleston County,15,13533,6154,7379
South Carolina,Charleston County,16,8673,3850,4823
South Carolina,Charleston County,17,6327,2609,3718
South Carolina,Charleston County,18,6720,2207,4513
South Carolina,Cherokee County,0,56024,27185,28839
South Carolina,Cherokee County,1,3529,1764,1765
South Carolina,Cherokee County,2,3795,1962,1833
South Carolina,Cherokee County,3,3818,1899,1919
South Carolina,Cherokee County,4,3685,1895,1790
South Carolina,Cherokee County,5,3885,1931,1954
South Carolina,Cherokee County,6,3553,1764,1789
South Carolina,Cherokee County,7,3151,1457,1694
South Carolina,Cherokee County,8,3260,1553,1707
South Carolina,Cherokee County,9,3855,1867,1988
South Carolina,Cherokee County,10,3873,1923,1950
South Carolina,Cherokee County,11,3877,1935,1942
South Carolina,Cherokee County,12,3744,1822,1922
South Carolina,Cherokee County,13,3467,1687,1780
South Carolina,Cherokee County,14,3057,1452,1605
South Carolina,Cherokee County,15,2156,1022,1134
South Carolina,Cherokee County,16,1403,623,780
South Carolina,Cherokee County,17,981,355,626
South Carolina,Cherokee County,18,935,274,661
South Carolina,Chester County,0,32337,15670,16667
South Carolina,Chester County,1,2033,1044,989
South Carolina,Chester County,2,2128,1094,1034
South Carolina,Chester County,3,2058,1056,1002
South Carolina,Chester County,4,1895,1002,893
South Carolina,Chester County,5,2035,1033,1002
South Carolina,Chester County,6,1890,921,969
South Carolina,Chester County,7,1739,772,967
South Carolina,Chester County,8,1670,800,870
South Carolina,Chester County,9,2095,999,1096
South Carolina,Chester County,10,2267,1125,1142
South Carolina,Chester County,11,2443,1211,1232
South Carolina,Chester County,12,2434,1157,1277
South Carolina,Chester County,13,2249,1062,1187
South Carolina,Chester County,14,1866,900,966
South Carolina,Chester County,15,1391,670,721
South Carolina,Chester County,16,924,400,524
South Carolina,Chester County,17,610,231,379
South Carolina,Chester County,18,610,193,417
South Carolina,Chesterfield County,0,46125,22445,23680
South Carolina,Chesterfield County,1,2677,1347,1330
South Carolina,Chesterfield County,2,2908,1426,1482
South Carolina,Chesterfield County,3,3097,1576,1521
South Carolina,Chesterfield County,4,2984,1508,1476
South Carolina,Chesterfield County,5,2978,1488,1490
South Carolina,Chesterfield County,6,2616,1348,1268
South Carolina,Chesterfield County,7,2540,1274,1266
South Carolina,Chesterfield County,8,2633,1261,1372
South Carolina,Chesterfield County,9,3081,1542,1539
South Carolina,Chesterfield County,10,3338,1611,1727
South Carolina,Chesterfield County,11,3533,1760,1773
South Carolina,Chesterfield County,12,3235,1567,1668
South Carolina,Chesterfield County,13,3143,1508,1635
South Carolina,Chesterfield County,14,2641,1233,1408
South Carolina,Chesterfield County,15,1918,881,1037
South Carolina,Chesterfield County,16,1286,578,708
South Carolina,Chesterfield County,17,847,336,511
South Carolina,Chesterfield County,18,670,201,469
South Carolina,Clarendon County,0,34113,16806,17307
South Carolina,Clarendon County,1,1736,885,851
South Carolina,Clarendon County,2,1930,931,999
South Carolina,Clarendon County,3,2036,1029,1007
South Carolina,Clarendon County,4,2116,1179,937
South Carolina,Clarendon County,5,2601,1564,1037
South Carolina,Clarendon County,6,1981,1025,956
South Carolina,Clarendon County,7,1782,890,892
South Carolina,Clarendon County,8,1671,819,852
South Carolina,Clarendon County,9,1882,951,931
South Carolina,Clarendon County,10,1979,900,1079
South Carolina,Clarendon County,11,2455,1181,1274
South Carolina,Clarendon County,12,2607,1160,1447
South Carolina,Clarendon County,13,2577,1186,1391
South Carolina,Clarendon County,14,2419,1121,1298
South Carolina,Clarendon County,15,1804,878,926
South Carolina,Clarendon County,16,1243,579,664
South Carolina,Clarendon County,17,737,337,400
South Carolina,Clarendon County,18,557,191,366
South Carolina,Colleton County,0,37771,18077,19694
South Carolina,Colleton County,1,2266,1107,1159
South Carolina,Colleton County,2,2504,1240,1264
South Carolina,Colleton County,3,2433,1257,1176
South Carolina,Colleton County,4,2300,1143,1157
South Carolina,Colleton County,5,2254,1141,1113
South Carolina,Colleton County,6,2117,1000,1117
South Carolina,Colleton County,7,1997,914,1083
South Carolina,Colleton County,8,1977,912,1065
South Carolina,Colleton County,9,2156,1018,1138
South Carolina,Colleton County,10,2466,1168,1298
South Carolina,Colleton County,11,2788,1334,1454
South Carolina,Colleton County,12,2746,1338,1408
South Carolina,Colleton County,13,2751,1304,1447
South Carolina,Colleton County,14,2449,1183,1266
South Carolina,Colleton County,15,1825,870,955
South Carolina,Colleton County,16,1269,537,732
South Carolina,Colleton County,17,713,331,382
South Carolina,Colleton County,18,760,280,480
South Carolina,Darlington County,0,67799,31985,35814
South Carolina,Darlington County,1,3955,1966,1989
South Carolina,Darlington County,2,4387,2218,2169
South Carolina,Darlington County,3,4565,2303,2262
South Carolina,Darlington County,4,4406,2204,2202
South Carolina,Darlington County,5,4610,2254,2356
South Carolina,Darlington County,6,3746,1764,1982
South Carolina,Darlington County,7,3610,1676,1934
South Carolina,Darlington County,8,3898,1808,2090
South Carolina,Darlington County,9,4340,2032,2308
South Carolina,Darlington County,10,4396,2129,2267
South Carolina,Darlington County,11,4876,2296,2580
South Carolina,Darlington County,12,5047,2323,2724
South Carolina,Darlington County,13,4760,2202,2558
South Carolina,Darlington County,14,3999,1862,2137
South Carolina,Darlington County,15,2848,1302,1546
South Carolina,Darlington County,16,1941,828,1113
South Carolina,Darlington County,17,1201,455,746
South Carolina,Darlington County,18,1214,363,851
South Carolina,Dillon County,0,31127,14709,16418
South Carolina,Dillon County,1,2207,1102,1105
South Carolina,Dillon County,2,2314,1199,1115
South Carolina,Dillon County,3,2202,1081,1121
South Carolina,Dillon County,4,1996,985,1011
South Carolina,Dillon County,5,2112,1047,1065
South Carolina,Dillon County,6,1851,912,939
South Carolina,Dillon County,7,1835,856,979
South Carolina,Dillon County,8,1894,922,972
South Carolina,Dillon County,9,1790,833,957
South Carolina,Dillon County,10,1942,921,1021
South Carolina,Dillon County,11,2163,978,1185
South Carolina,Dillon County,12,2184,1022,1162
South Carolina,Dillon County,13,1959,926,1033
South Carolina,Dillon County,14,1643,736,907
South Carolina,Dillon County,15,1169,506,663
South Carolina,Dillon County,16,796,354,442
South Carolina,Dillon County,17,512,170,342
South Carolina,Dillon County,18,558,159,399
South Carolina,Dorchester County,0,148469,72493,75976
South Carolina,Dorchester County,1,9602,4863,4739
South Carolina,Dorchester County,2,10642,5355,5287
South Carolina,Dorchester County,3,11058,5533,5525
South Carolina,Dorchester County,4,10074,5196,4878
South Carolina,Dorchester County,5,9519,4829,4690
South Carolina,Dorchester County,6,10178,5217,4961
South Carolina,Dorchester County,7,10419,5003,5416
South Carolina,Dorchester County,8,9706,4668,5038
South Carolina,Dorchester County,9,10422,5011,5411
South Carolina,Dorchester County,10,10648,5196,5452
South Carolina,Dorchester County,11,11125,5412,5713
South Carolina,Dorchester County,12,9566,4653,4913
South Carolina,Dorchester County,13,8182,3777,4405
South Carolina,Dorchester County,14,6784,3234,3550
South Carolina,Dorchester County,15,4401,2066,2335
South Carolina,Dorchester County,16,2840,1284,1556
South Carolina,Dorchester County,17,1759,744,1015
South Carolina,Dorchester County,18,1544,452,1092
South Carolina,Edgefield County,0,26553,14373,12180
South Carolina,Edgefield County,1,1175,602,573
South Carolina,Edgefield County,2,1412,701,711
South Carolina,Edgefield County,3,1613,837,776
South Carolina,Edgefield County,4,1559,851,708
South Carolina,Edgefield County,5,1796,1072,724
South Carolina,Edgefield County,6,1581,991,590
South Carolina,Edgefield County,7,1780,1119,661
South Carolina,Edgefield County,8,1743,1086,657
South Carolina,Edgefield County,9,1758,985,773
South Carolina,Edgefield County,10,1917,1084,833
South Carolina,Edgefield County,11,2091,1103,988
South Carolina,Edgefield County,12,2077,1089,988
South Carolina,Edgefield County,13,1837,928,909
South Carolina,Edgefield County,14,1611,809,802
South Carolina,Edgefield County,15,1062,518,544
South Carolina,Edgefield County,16,688,316,372
South Carolina,Edgefield County,17,432,168,264
South Carolina,Edgefield County,18,421,114,307
South Carolina,Fairfield County,0,22976,10980,11996
South Carolina,Fairfield County,1,1132,550,582
South Carolina,Fairfield County,2,1325,673,652
South Carolina,Fairfield County,3,1373,705,668
South Carolina,Fairfield County,4,1364,695,669
South Carolina,Fairfield County,5,1458,692,766
South Carolina,Fairfield County,6,1171,549,622
South Carolina,Fairfield County,7,1119,527,592
South Carolina,Fairfield County,8,1201,591,610
South Carolina,Fairfield County,9,1379,652,727
South Carolina,Fairfield County,10,1527,746,781
South Carolina,Fairfield County,11,1878,853,1025
South Carolina,Fairfield County,12,2033,963,1070
South Carolina,Fairfield County,13,1871,906,965
South Carolina,Fairfield County,14,1520,780,740
South Carolina,Fairfield County,15,1034,465,569
South Carolina,Fairfield County,16,728,317,411
South Carolina,Fairfield County,17,463,175,288
South Carolina,Fairfield County,18,400,141,259
South Carolina,Florence County,0,139231,65211,74020
South Carolina,Florence County,1,9027,4673,4354
South Carolina,Florence County,2,9539,4786,4753
South Carolina,Florence County,3,9547,4908,4639
South Carolina,Florence County,4,8716,4367,4349
South Carolina,Florence County,5,9956,4515,5441
South Carolina,Florence County,6,8834,4109,4725
South Carolina,Florence County,7,8630,4077,4553
South Carolina,Florence County,8,8570,3926,4644
South Carolina,Florence County,9,8896,4118,4778
South Carolina,Florence County,10,8995,4196,4799
South Carolina,Florence County,11,9442,4388,5054
South Carolina,Florence County,12,9414,4385,5029
South Carolina,Florence County,13,8846,4056,4790
South Carolina,Florence County,14,7447,3422,4025
South Carolina,Florence County,15,5187,2315,2872
South Carolina,Florence County,16,3642,1462,2180
South Carolina,Florence County,17,2295,852,1443
South Carolina,Florence County,18,2248,656,1592
South Carolina,Georgetown County,0,60773,28905,31868
South Carolina,Georgetown County,1,2979,1452,1527
South Carolina,Georgetown County,2,3339,1693,1646
South Carolina,Georgetown County,3,3643,1901,1742
South Carolina,Georgetown County,4,3445,1868,1577
South Carolina,Georgetown County,5,3183,1594,1589
South Carolina,Georgetown County,6,2779,1359,1420
South Carolina,Georgetown County,7,2820,1379,1441
South Carolina,Georgetown County,8,3105,1438,1667
South Carolina,Georgetown County,9,3315,1546,1769
South Carolina,Georgetown County,10,3585,1657,1928
South Carolina,Georgetown County,11,4184,1941,2243
South Carolina,Georgetown County,12,4637,2107,2530
South Carolina,Georgetown County,13,5137,2267,2870
South Carolina,Georgetown County,14,5222,2437,2785
South Carolina,Georgetown County,15,3940,1865,2075
South Carolina,Georgetown County,16,2604,1245,1359
South Carolina,Georgetown County,17,1523,722,801
South Carolina,Georgetown County,18,1333,434,899
South Carolina,Greenville County,0,482752,234668,248084
South Carolina,Greenville County,1,31059,15918,15141
South Carolina,Greenville County,2,32522,16671,15851
South Carolina,Greenville County,3,31246,15767,15479
South Carolina,Greenville County,4,30812,15546,15266
South Carolina,Greenville County,5,33065,16419,16646
South Carolina,Greenville County,6,33156,16433,16723
South Carolina,Greenville County,7,32339,15860,16479
South Carolina,Greenville County,8,31011,15338,15673
South Carolina,Greenville County,9,32895,16247,16648
South Carolina,Greenville County,10,32598,15907,16691
South Carolina,Greenville County,11,33791,16419,17372
South Carolina,Greenville County,12,31852,15268,16584
South Carolina,Greenville County,13,27574,12906,14668
South Carolina,Greenville County,14,23822,11103,12719
South Carolina,Greenville County,15,17328,7956,9372
South Carolina,Greenville County,16,11698,5089,6609
South Carolina,Greenville County,17,8001,3239,4762
South Carolina,Greenville County,18,7983,2582,5401
South Carolina,Greenwood County,0,69520,32521,36999
South Carolina,Greenwood County,1,4413,2197,2216
South Carolina,Greenwood County,2,4607,2325,2282
South Carolina,Greenwood County,3,4307,2206,2101
South Carolina,Greenwood County,4,4767,2266,2501
South Carolina,Greenwood County,5,4871,2211,2660
South Carolina,Greenwood County,6,4422,2058,2364
South Carolina,Greenwood County,7,4163,1884,2279
South Carolina,Greenwood County,8,4004,1921,2083
South Carolina,Greenwood County,9,4224,1980,2244
South Carolina,Greenwood County,10,4520,2130,2390
South Carolina,Greenwood County,11,4692,2266,2426
South Carolina,Greenwood County,12,4512,2083,2429
South Carolina,Greenwood County,13,4163,1955,2208
South Carolina,Greenwood County,14,3772,1738,2034
South Carolina,Greenwood County,15,2817,1278,1539
South Carolina,Greenwood County,16,2025,876,1149
South Carolina,Greenwood County,17,1625,626,999
South Carolina,Greenwood County,18,1616,521,1095
South Carolina,Hampton County,0,20405,10529,9876
South Carolina,Hampton County,1,1172,621,551
South Carolina,Hampton County,2,1264,668,596
South Carolina,Hampton County,3,1306,655,651
South Carolina,Hampton County,4,1290,678,612
South Carolina,Hampton County,5,1357,731,626
South Carolina,Hampton County,6,1237,721,516
South Carolina,Hampton County,7,1356,802,554
South Carolina,Hampton County,8,1315,723,592
South Carolina,Hampton County,9,1335,743,592
South Carolina,Hampton County,10,1362,683,679
South Carolina,Hampton County,11,1460,761,699
South Carolina,Hampton County,12,1422,697,725
South Carolina,Hampton County,13,1309,607,702
South Carolina,Hampton County,14,1153,549,604
South Carolina,Hampton County,15,841,404,437
South Carolina,Hampton County,16,533,228,305
South Carolina,Hampton County,17,394,161,233
South Carolina,Hampton County,18,299,97,202
South Carolina,Horry County,0,298832,144884,153948
South Carolina,Horry County,1,15531,7896,7635
South Carolina,Horry County,2,16315,8256,8059
South Carolina,Horry County,3,16247,8268,7979
South Carolina,Horry County,4,16043,8186,7857
South Carolina,Horry County,5,18203,9020,9183
South Carolina,Horry County,6,19277,9616,9661
South Carolina,Horry County,7,17583,8734,8849
South Carolina,Horry County,8,17093,8552,8541
South Carolina,Horry County,9,17974,8758,9216
South Carolina,Horry County,10,18326,8887,9439
South Carolina,Horry County,11,20695,9756,10939
South Carolina,Horry County,12,21096,9619,11477
South Carolina,Horry County,13,23142,10518,12624
South Carolina,Horry County,14,23410,11257,12153
South Carolina,Horry County,15,16336,7887,8449
South Carolina,Horry County,16,10413,5063,5350
South Carolina,Horry County,17,6147,2758,3389
South Carolina,Horry County,18,5001,1853,3148
South Carolina,Jasper County,0,27170,14032,13138
South Carolina,Jasper County,1,1623,822,801
South Carolina,Jasper County,2,1741,900,841
South Carolina,Jasper County,3,1580,810,770
South Carolina,Jasper County,4,1507,823,684
South Carolina,Jasper County,5,2075,1195,880
South Carolina,Jasper County,6,1984,1119,865
South Carolina,Jasper County,7,1778,1000,778
South Carolina,Jasper County,8,1616,904,712
South Carolina,Jasper County,9,1712,922,790
South Carolina,Jasper County,10,1729,909,820
South Carolina,Jasper County,11,1970,965,1005
South Carolina,Jasper County,12,1885,928,957
South Carolina,Jasper County,13,1775,795,980
South Carolina,Jasper County,14,1605,747,858
South Carolina,Jasper County,15,1097,530,567
South Carolina,Jasper County,16,679,323,356
South Carolina,Jasper County,17,396,186,210
South Carolina,Jasper County,18,418,154,264
South Carolina,Kershaw County,0,63161,30646,32515
South Carolina,Kershaw County,1,3739,1902,1837
South Carolina,Kershaw County,2,4239,2189,2050
South Carolina,Kershaw County,3,4320,2200,2120
South Carolina,Kershaw County,4,3954,2091,1863
South Carolina,Kershaw County,5,3644,1879,1765
South Carolina,Kershaw County,6,3575,1729,1846
South Carolina,Kershaw County,7,3711,1808,1903
South Carolina,Kershaw County,8,3691,1770,1921
South Carolina,Kershaw County,9,3914,1905,2009
South Carolina,Kershaw County,10,4169,1958,2211
South Carolina,Kershaw County,11,4764,2280,2484
South Carolina,Kershaw County,12,4778,2311,2467
South Carolina,Kershaw County,13,4302,2035,2267
South Carolina,Kershaw County,14,3658,1762,1896
South Carolina,Kershaw County,15,2592,1220,1372
South Carolina,Kershaw County,16,1765,754,1011
South Carolina,Kershaw County,17,1262,513,749
South Carolina,Kershaw County,18,1084,340,744
South Carolina,Lancaster County,0,83160,40809,42351
South Carolina,Lancaster County,1,4749,2437,2312
South Carolina,Lancaster County,2,5405,2741,2664
South Carolina,Lancaster County,3,5055,2551,2504
South Carolina,Lancaster County,4,4509,2304,2205
South Carolina,Lancaster County,5,4635,2413,2222
South Carolina,Lancaster County,6,4843,2481,2362
South Carolina,Lancaster County,7,5241,2579,2662
South Carolina,Lancaster County,8,5325,2699,2626
South Carolina,Lancaster County,9,5856,2993,2863
South Carolina,Lancaster County,10,5408,2775,2633
South Carolina,Lancaster County,11,5644,2739,2905
South Carolina,Lancaster County,12,5424,2614,2810
South Carolina,Lancaster County,13,5462,2506,2956
South Carolina,Lancaster County,14,5675,2556,3119
South Carolina,Lancaster County,15,4291,2030,2261
South Carolina,Lancaster County,16,2718,1223,1495
South Carolina,Lancaster County,17,1548,676,872
South Carolina,Lancaster County,18,1372,492,880
South Carolina,Laurens County,0,66533,32279,34254
South Carolina,Laurens County,1,3911,2032,1879
South Carolina,Laurens County,2,4244,2149,2095
South Carolina,Laurens County,3,4189,2132,2057
South Carolina,Laurens County,4,4380,2266,2114
South Carolina,Laurens County,5,4781,2411,2370
South Carolina,Laurens County,6,3849,1860,1989
South Carolina,Laurens County,7,3650,1724,1926
South Carolina,Laurens County,8,3547,1787,1760
South Carolina,Laurens County,9,4229,2073,2156
South Carolina,Laurens County,10,4446,2142,2304
South Carolina,Laurens County,11,4899,2345,2554
South Carolina,Laurens County,12,4831,2316,2515
South Carolina,Laurens County,13,4437,2157,2280
South Carolina,Laurens County,14,3805,1817,1988
South Carolina,Laurens County,15,2773,1290,1483
South Carolina,Laurens County,16,1799,834,965
South Carolina,Laurens County,17,1342,513,829
South Carolina,Laurens County,18,1421,431,990
South Carolina,Lee County,0,18343,9570,8773
South Carolina,Lee County,1,903,494,409
South Carolina,Lee County,2,1078,547,531
South Carolina,Lee County,3,1192,602,590
South Carolina,Lee County,4,1027,536,491
South Carolina,Lee County,5,1448,934,514
South Carolina,Lee County,6,1294,830,464
South Carolina,Lee County,7,1207,718,489
South Carolina,Lee County,8,1008,553,455
South Carolina,Lee County,9,1086,582,504
South Carolina,Lee County,10,1121,577,544
South Carolina,Lee County,11,1383,701,682
South Carolina,Lee County,12,1343,645,698
South Carolina,Lee County,13,1296,624,672
South Carolina,Lee County,14,1013,472,541
South Carolina,Lee County,15,748,329,419
South Carolina,Lee County,16,509,198,311
South Carolina,Lee County,17,358,126,232
South Carolina,Lee County,18,329,102,227
South Carolina,Lexington County,0,277888,135797,142091
South Carolina,Lexington County,1,17025,8708,8317
South Carolina,Lexington County,2,18584,9441,9143
South Carolina,Lexington County,3,18823,9621,9202
South Carolina,Lexington County,4,17165,8862,8303
South Carolina,Lexington County,5,17206,8717,8489
South Carolina,Lexington County,6,18208,9023,9185
South Carolina,Lexington County,7,18364,8901,9463
South Carolina,Lexington County,8,17590,8590,9000
South Carolina,Lexington County,9,19309,9459,9850
South Carolina,Lexington County,10,19118,9460,9658
South Carolina,Lexington County,11,20672,10138,10534
South Carolina,Lexington County,12,19459,9378,10081
South Carolina,Lexington County,13,16839,7938,8901
South Carolina,Lexington County,14,14251,6756,7495
South Carolina,Lexington County,15,10089,4744,5345
South Carolina,Lexington County,16,6507,2875,3632
South Carolina,Lexington County,17,4459,1826,2633
South Carolina,Lexington County,18,4220,1360,2860
South Carolina,McCormick County,0,9846,5424,4422
South Carolina,McCormick County,1,312,191,121
South Carolina,McCormick County,2,388,204,184
South Carolina,McCormick County,3,336,157,179
South Carolina,McCormick County,4,356,193,163
South Carolina,McCormick County,5,467,277,190
South Carolina,McCormick County,6,545,368,177
South Carolina,McCormick County,7,552,384,168
South Carolina,McCormick County,8,471,304,167
South Carolina,McCormick County,9,551,326,225
South Carolina,McCormick County,10,595,359,236
South Carolina,McCormick County,11,741,422,319
South Carolina,McCormick County,12,749,403,346
South Carolina,McCormick County,13,845,421,424
South Carolina,McCormick County,14,1070,485,585
South Carolina,McCormick County,15,855,431,424
South Carolina,McCormick County,16,539,264,275
South Carolina,McCormick County,17,283,149,134
South Carolina,McCormick County,18,191,86,105
South Carolina,Marion County,0,31933,14753,17180
South Carolina,Marion County,1,1963,982,981
South Carolina,Marion County,2,2148,1084,1064
South Carolina,Marion County,3,2114,1091,1023
South Carolina,Marion County,4,1979,1046,933
South Carolina,Marion County,5,2133,1052,1081
South Carolina,Marion County,6,1759,804,955
South Carolina,Marion County,7,1788,823,965
South Carolina,Marion County,8,1839,849,990
South Carolina,Marion County,9,1853,836,1017
South Carolina,Marion County,10,1940,878,1062
South Carolina,Marion County,11,2136,973,1163
South Carolina,Marion County,12,2424,1049,1375
South Carolina,Marion County,13,2407,1057,1350
South Carolina,Marion County,14,2020,904,1116
South Carolina,Marion County,15,1346,581,765
South Carolina,Marion County,16,927,392,535
South Carolina,Marion County,17,597,206,391
South Carolina,Marion County,18,560,146,414
South Carolina,Marlboro County,0,27924,14843,13081
South Carolina,Marlboro County,1,1498,761,737
South Carolina,Marlboro County,2,1633,797,836
South Carolina,Marlboro County,3,1593,838,755
South Carolina,Marlboro County,4,1603,845,758
South Carolina,Marlboro County,5,1852,1074,778
South Carolina,Marlboro County,6,1995,1270,725
South Carolina,Marlboro County,7,2032,1321,711
South Carolina,Marlboro County,8,1969,1192,777
South Carolina,Marlboro County,9,1862,1071,791
South Carolina,Marlboro County,10,1923,1031,892
South Carolina,Marlboro County,11,2019,1057,962
South Carolina,Marlboro County,12,1940,944,996
South Carolina,Marlboro County,13,1765,832,933
South Carolina,Marlboro County,14,1593,743,850
South Carolina,Marlboro County,15,1082,497,585
South Carolina,Marlboro County,16,693,296,397
South Carolina,Marlboro County,17,433,142,291
South Carolina,Marlboro County,18,439,132,307
South Carolina,Newberry County,0,37783,18377,19406
South Carolina,Newberry County,1,2200,1137,1063
South Carolina,Newberry County,2,2307,1116,1191
South Carolina,Newberry County,3,2383,1196,1187
South Carolina,Newberry County,4,2548,1355,1193
South Carolina,Newberry County,5,2634,1360,1274
South Carolina,Newberry County,6,2158,1110,1048
South Carolina,Newberry County,7,2091,1013,1078
South Carolina,Newberry County,8,1969,951,1018
South Carolina,Newberry County,9,2361,1150,1211
South Carolina,Newberry County,10,2334,1137,1197
South Carolina,Newberry County,11,2655,1289,1366
South Carolina,Newberry County,12,2728,1341,1387
South Carolina,Newberry County,13,2618,1238,1380
South Carolina,Newberry County,14,2328,1123,1205
South Carolina,Newberry County,15,1742,822,920
South Carolina,Newberry County,16,1144,514,630
South Carolina,Newberry County,17,740,283,457
South Carolina,Newberry County,18,843,242,601
South Carolina,Oconee County,0,75192,37183,38009
South Carolina,Oconee County,1,4051,2123,1928
South Carolina,Oconee County,2,4223,2159,2064
South Carolina,Oconee County,3,4346,2215,2131
South Carolina,Oconee County,4,4115,2138,1977
South Carolina,Oconee County,5,4606,2443,2163
South Carolina,Oconee County,6,4168,2173,1995
South Carolina,Oconee County,7,3958,1990,1968
South Carolina,Oconee County,8,3828,1929,1899
South Carolina,Oconee County,9,4449,2210,2239
South Carolina,Oconee County,10,4633,2274,2359
South Carolina,Oconee County,11,5238,2584,2654
South Carolina,Oconee County,12,5771,2738,3033
South Carolina,Oconee County,13,5574,2653,2921
South Carolina,Oconee County,14,5621,2748,2873
South Carolina,Oconee County,15,4368,2112,2256
South Carolina,Oconee County,16,2975,1397,1578
South Carolina,Oconee County,17,1879,841,1038
South Carolina,Oconee County,18,1389,456,933
South Carolina,Orangeburg County,0,90090,42271,47819
South Carolina,Orangeburg County,1,5670,2829,2841
South Carolina,Orangeburg County,2,5872,3049,2823
South Carolina,Orangeburg County,3,5535,2791,2744
South Carolina,Orangeburg County,4,6136,3071,3065
South Carolina,Orangeburg County,5,7318,3526,3792
South Carolina,Orangeburg County,6,5689,2628,3061
South Carolina,Orangeburg County,7,4936,2335,2601
South Carolina,Orangeburg County,8,4461,2103,2358
South Carolina,Orangeburg County,9,4928,2221,2707
South Carolina,Orangeburg County,10,5349,2461,2888
South Carolina,Orangeburg County,11,6458,3004,3454
South Carolina,Orangeburg County,12,6219,2868,3351
South Carolina,Orangeburg County,13,6101,2804,3297
South Carolina,Orangeburg County,14,5308,2458,2850
South Carolina,Orangeburg County,15,3878,1710,2168
South Carolina,Orangeburg County,16,2620,1136,1484
South Carolina,Orangeburg County,17,1819,717,1102
South Carolina,Orangeburg County,18,1793,560,1233
South Carolina,Pickens County,0,120368,59993,60375
South Carolina,Pickens County,1,5951,2985,2966
South Carolina,Pickens County,2,6637,3436,3201
South Carolina,Pickens County,3,6780,3444,3336
South Carolina,Pickens County,4,10747,5646,5101
South Carolina,Pickens County,5,15365,8179,7186
South Carolina,Pickens County,6,7378,3938,3440
South Carolina,Pickens County,7,6335,3247,3088
South Carolina,Pickens County,8,6362,3099,3263
South Carolina,Pickens County,9,6871,3445,3426
South Carolina,Pickens County,10,7260,3521,3739
South Carolina,Pickens County,11,8080,3975,4105
South Carolina,Pickens County,12,7506,3656,3850
South Carolina,Pickens County,13,6767,3245,3522
South Carolina,Pickens County,14,6119,2942,3177
South Carolina,Pickens County,15,4713,2254,2459
South Carolina,Pickens County,16,3208,1375,1833
South Carolina,Pickens County,17,2186,916,1270
South Carolina,Pickens County,18,2103,690,1413
South Carolina,Richland County,0,401566,194729,206837
South Carolina,Richland County,1,23842,12108,11734
South Carolina,Richland County,2,25010,12651,12359
South Carolina,Richland County,3,24520,12317,12203
South Carolina,Richland County,4,32489,16857,15632
South Carolina,Richland County,5,46221,24238,21983
South Carolina,Richland County,6,30758,15500,15258
South Carolina,Richland County,7,28562,13934,14628
South Carolina,Richland County,8,24906,11985,12921
South Carolina,Richland County,9,24977,12026,12951
South Carolina,Richland County,10,24183,11316,12867
South Carolina,Richland County,11,25574,11883,13691
South Carolina,Richland County,12,24190,11244,12946
South Carolina,Richland County,13,20829,9432,11397
South Carolina,Richland County,14,16697,7727,8970
South Carolina,Richland County,15,10959,4850,6109
South Carolina,Richland County,16,7228,2985,4243
South Carolina,Richland County,17,5260,2008,3252
South Carolina,Richland County,18,5361,1668,3693
South Carolina,Saluda County,0,20026,10098,9928
South Carolina,Saluda County,1,1257,673,584
South Carolina,Saluda County,2,1300,685,615
South Carolina,Saluda County,3,1171,621,550
South Carolina,Saluda County,4,1073,579,494
South Carolina,Saluda County,5,1233,650,583
South Carolina,Saluda County,6,1195,632,563
South Carolina,Saluda County,7,1288,690,598
South Carolina,Saluda County,8,1071,537,534
South Carolina,Saluda County,9,1293,668,625
South Carolina,Saluda County,10,1269,641,628
South Carolina,Saluda County,11,1462,710,752
South Carolina,Saluda County,12,1445,732,713
South Carolina,Saluda County,13,1305,652,653
South Carolina,Saluda County,14,1178,568,610
South Carolina,Saluda County,15,965,453,512
South Carolina,Saluda County,16,660,315,345
South Carolina,Saluda County,17,396,154,242
South Carolina,Saluda County,18,465,138,327
South Carolina,Spartanburg County,0,293542,142458,151084
South Carolina,Spartanburg County,1,18398,9398,9000
South Carolina,Spartanburg County,2,19518,9930,9588
South Carolina,Spartanburg County,3,19701,10085,9616
South Carolina,Spartanburg County,4,19974,10152,9822
South Carolina,Spartanburg County,5,20761,10271,10490
South Carolina,Spartanburg County,6,18924,9173,9751
South Carolina,Spartanburg County,7,17554,8677,8877
South Carolina,Spartanburg County,8,17230,8449,8781
South Carolina,Spartanburg County,9,19456,9550,9906
South Carolina,Spartanburg County,10,19980,9875,10105
South Carolina,Spartanburg County,11,20807,10211,10596
South Carolina,Spartanburg County,12,19384,9261,10123
South Carolina,Spartanburg County,13,17666,8254,9412
South Carolina,Spartanburg County,14,15219,7242,7977
South Carolina,Spartanburg County,15,11339,5099,6240
South Carolina,Spartanburg County,16,7815,3367,4448
South Carolina,Spartanburg County,17,5075,2023,3052
South Carolina,Spartanburg County,18,4741,1441,3300
South Carolina,Sumter County,0,107919,52064,55855
South Carolina,Sumter County,1,7612,3818,3794
South Carolina,Sumter County,2,7508,3772,3736
South Carolina,Sumter County,3,7126,3617,3509
South Carolina,Sumter County,4,7043,3593,3450
South Carolina,Sumter County,5,9190,4957,4233
South Carolina,Sumter County,6,7704,3852,3852
South Carolina,Sumter County,7,6799,3341,3458
South Carolina,Sumter County,8,6060,2925,3135
South Carolina,Sumter County,9,6110,2916,3194
South Carolina,Sumter County,10,6608,3108,3500
South Carolina,Sumter County,11,7322,3500,3822
South Carolina,Sumter County,12,7044,3246,3798
South Carolina,Sumter County,13,6141,2811,3330
South Carolina,Sumter County,14,5081,2298,2783
South Carolina,Sumter County,15,3864,1742,2122
South Carolina,Sumter County,16,2999,1252,1747
South Carolina,Sumter County,17,1900,751,1149
South Carolina,Sumter County,18,1808,565,1243
South Carolina,Union County,0,27876,13246,14630
South Carolina,Union County,1,1500,745,755
South Carolina,Union County,2,1681,858,823
South Carolina,Union County,3,1741,878,863
South Carolina,Union County,4,1741,939,802
South Carolina,Union County,5,1646,809,837
South Carolina,Union County,6,1483,692,791
South Carolina,Union County,7,1429,646,783
South Carolina,Union County,8,1583,771,812
South Carolina,Union County,9,1800,882,918
South Carolina,Union County,10,1844,894,950
South Carolina,Union County,11,2141,1006,1135
South Carolina,Union County,12,2204,1066,1138
South Carolina,Union County,13,1923,926,997
South Carolina,Union County,14,1731,776,955
South Carolina,Union County,15,1265,565,700
South Carolina,Union County,16,920,390,530
South Carolina,Union County,17,660,243,417
South Carolina,Union County,18,584,160,424
South Carolina,Williamsburg County,0,32695,15841,16854
South Carolina,Williamsburg County,1,1740,805,935
South Carolina,Williamsburg County,2,2005,1018,987
South Carolina,Williamsburg County,3,2114,1085,1029
South Carolina,Williamsburg County,4,1948,1004,944
South Carolina,Williamsburg County,5,2132,1100,1032
South Carolina,Williamsburg County,6,1953,1102,851
South Carolina,Williamsburg County,7,1877,1024,853
South Carolina,Williamsburg County,8,1907,997,910
South Carolina,Williamsburg County,9,1963,975,988
South Carolina,Williamsburg County,10,2082,1017,1065
South Carolina,Williamsburg County,11,2217,1058,1159
South Carolina,Williamsburg County,12,2502,1115,1387
South Carolina,Williamsburg County,13,2418,1104,1314
South Carolina,Williamsburg County,14,2095,981,1114
South Carolina,Williamsburg County,15,1463,665,798
South Carolina,Williamsburg County,16,929,365,564
South Carolina,Williamsburg County,17,705,243,462
South Carolina,Williamsburg County,18,645,183,462
South Carolina,York County,0,245346,118390,126956
South Carolina,York County,1,15344,7774,7570
South Carolina,York County,2,17285,8898,8387
South Carolina,York County,3,17671,8904,8767
South Carolina,York County,4,17042,8510,8532
South Carolina,York County,5,15272,7438,7834
South Carolina,York County,6,14771,7026,7745
South Carolina,York County,7,15383,7222,8161
South Carolina,York County,8,16074,7766,8308
South Carolina,York County,9,18161,8724,9437
South Carolina,York County,10,17787,8650,9137
South Carolina,York County,11,18071,8789,9282
South Carolina,York County,12,16379,7935,8444
South Carolina,York County,13,13954,6576,7378
South Carolina,York County,14,11840,5630,6210
South Carolina,York County,15,8339,3868,4471
South Carolina,York County,16,5352,2345,3007
South Carolina,York County,17,3436,1362,2074
South Carolina,York County,18,3185,973,2212
South Dakota,Aurora County,0,2745,1415,1330
South Dakota,Aurora County,1,178,95,83
South Dakota,Aurora County,2,207,112,95
South Dakota,Aurora County,3,193,111,82
South Dakota,Aurora County,4,206,113,93
South Dakota,Aurora County,5,124,56,68
South Dakota,Aurora County,6,140,84,56
South Dakota,Aurora County,7,155,77,78
South Dakota,Aurora County,8,135,67,68
South Dakota,Aurora County,9,141,73,68
South Dakota,Aurora County,10,153,84,69
South Dakota,Aurora County,11,192,103,89
South Dakota,Aurora County,12,203,99,104
South Dakota,Aurora County,13,177,94,83
South Dakota,Aurora County,14,153,76,77
South Dakota,Aurora County,15,103,52,51
South Dakota,Aurora County,16,118,55,63
South Dakota,Aurora County,17,88,37,51
South Dakota,Aurora County,18,79,27,52
South Dakota,Beadle County,0,18169,9219,8950
South Dakota,Beadle County,1,1521,776,745
South Dakota,Beadle County,2,1279,673,606
South Dakota,Beadle County,3,1149,632,517
South Dakota,Beadle County,4,1148,595,553
South Dakota,Beadle County,5,1066,581,485
South Dakota,Beadle County,6,1135,557,578
South Dakota,Beadle County,7,1115,601,514
South Dakota,Beadle County,8,945,490,455
South Dakota,Beadle County,9,846,439,407
South Dakota,Beadle County,10,1044,527,517
South Dakota,Beadle County,11,1360,700,660
South Dakota,Beadle County,12,1362,696,666
South Dakota,Beadle County,13,1165,613,552
South Dakota,Beadle County,14,852,443,409
South Dakota,Beadle County,15,623,300,323
South Dakota,Beadle County,16,514,231,283
South Dakota,Beadle County,17,468,184,284
South Dakota,Beadle County,18,577,181,396
South Dakota,Bennett County,0,3430,1639,1791
South Dakota,Bennett County,1,328,160,168
South Dakota,Bennett County,2,358,171,187
South Dakota,Bennett County,3,296,142,154
South Dakota,Bennett County,4,276,132,144
South Dakota,Bennett County,5,257,124,133
South Dakota,Bennett County,6,221,90,131
South Dakota,Bennett County,7,161,69,92
South Dakota,Bennett County,8,171,85,86
South Dakota,Bennett County,9,181,84,97
South Dakota,Bennett County,10,188,94,94
South Dakota,Bennett County,11,205,104,101
South Dakota,Bennett County,12,198,110,88
South Dakota,Bennett County,13,168,79,89
South Dakota,Bennett County,14,133,71,62
South Dakota,Bennett County,15,72,33,39
South Dakota,Bennett County,16,96,39,57
South Dakota,Bennett County,17,70,31,39
South Dakota,Bennett County,18,51,21,30
South Dakota,Bon Homme County,0,7023,4070,2953
South Dakota,Bon Homme County,1,319,151,168
South Dakota,Bon Homme County,2,394,179,215
South Dakota,Bon Homme County,3,345,165,180
South Dakota,Bon Homme County,4,455,247,208
South Dakota,Bon Homme County,5,446,345,101
South Dakota,Bon Homme County,6,464,352,112
South Dakota,Bon Homme County,7,468,321,147
South Dakota,Bon Homme County,8,408,292,116
South Dakota,Bon Homme County,9,410,282,128
South Dakota,Bon Homme County,10,450,278,172
South Dakota,Bon Homme County,11,540,317,223
South Dakota,Bon Homme County,12,486,290,196
South Dakota,Bon Homme County,13,435,226,209
South Dakota,Bon Homme County,14,372,196,176
South Dakota,Bon Homme County,15,265,132,133
South Dakota,Bon Homme County,16,212,98,114
South Dakota,Bon Homme County,17,249,94,155
South Dakota,Bon Homme County,18,305,105,200
South Dakota,Brookings County,0,33314,17004,16310
South Dakota,Brookings County,1,2023,1031,992
South Dakota,Brookings County,2,1840,909,931
South Dakota,Brookings County,3,1677,842,835
South Dakota,Brookings County,4,3714,1829,1885
South Dakota,Brookings County,5,6701,3514,3187
South Dakota,Brookings County,6,2271,1332,939
South Dakota,Brookings County,7,2033,1075,958
South Dakota,Brookings County,8,1668,884,784
South Dakota,Brookings County,9,1508,792,716
South Dakota,Brookings County,10,1494,765,729
South Dakota,Brookings County,11,1647,849,798
South Dakota,Brookings County,12,1694,835,859
South Dakota,Brookings County,13,1562,776,786
South Dakota,Brookings County,14,1088,538,550
South Dakota,Brookings County,15,791,377,414
South Dakota,Brookings County,16,614,278,336
South Dakota,Brookings County,17,453,191,262
South Dakota,Brookings County,18,536,187,349
South Dakota,Brown County,0,38408,18918,19490
South Dakota,Brown County,1,2609,1351,1258
South Dakota,Brown County,2,2645,1369,1276
South Dakota,Brown County,3,2421,1214,1207
South Dakota,Brown County,4,2564,1252,1312
South Dakota,Brown County,5,2734,1322,1412
South Dakota,Brown County,6,2665,1440,1225
South Dakota,Brown County,7,2511,1303,1208
South Dakota,Brown County,8,2086,1063,1023
South Dakota,Brown County,9,2117,1081,1036
South Dakota,Brown County,10,2159,1139,1020
South Dakota,Brown County,11,2735,1357,1378
South Dakota,Brown County,12,2668,1292,1376
South Dakota,Brown County,13,2343,1134,1209
South Dakota,Brown County,14,1724,843,881
South Dakota,Brown County,15,1255,572,683
South Dakota,Brown County,16,1120,478,642
South Dakota,Brown County,17,869,324,545
South Dakota,Brown County,18,1183,384,799
South Dakota,Brule County,0,5309,2596,2713
South Dakota,Brule County,1,373,166,207
South Dakota,Brule County,2,398,193,205
South Dakota,Brule County,3,341,174,167
South Dakota,Brule County,4,372,187,185
South Dakota,Brule County,5,280,140,140
South Dakota,Brule County,6,255,126,129
South Dakota,Brule County,7,297,154,143
South Dakota,Brule County,8,280,142,138
South Dakota,Brule County,9,297,137,160
South Dakota,Brule County,10,319,158,161
South Dakota,Brule County,11,394,192,202
South Dakota,Brule County,12,421,223,198
South Dakota,Brule County,13,366,203,163
South Dakota,Brule County,14,209,108,101
South Dakota,Brule County,15,203,84,119
South Dakota,Brule County,16,190,93,97
South Dakota,Brule County,17,133,56,77
South Dakota,Brule County,18,181,60,121
South Dakota,Buffalo County,0,2077,1035,1042
South Dakota,Buffalo County,1,276,143,133
South Dakota,Buffalo County,2,234,107,127
South Dakota,Buffalo County,3,217,110,107
South Dakota,Buffalo County,4,179,91,88
South Dakota,Buffalo County,5,143,77,66
South Dakota,Buffalo County,6,145,68,77
South Dakota,Buffalo County,7,144,75,69
South Dakota,Buffalo County,8,119,69,50
South Dakota,Buffalo County,9,102,51,51
South Dakota,Buffalo County,10,102,49,53
South Dakota,Buffalo County,11,88,35,53
South Dakota,Buffalo County,12,102,54,48
South Dakota,Buffalo County,13,77,41,36
South Dakota,Buffalo County,14,54,23,31
South Dakota,Buffalo County,15,43,16,27
South Dakota,Buffalo County,16,32,18,14
South Dakota,Buffalo County,17,9,3,6
South Dakota,Buffalo County,18,11,5,6
South Dakota,Butte County,0,10298,5183,5115
South Dakota,Butte County,1,647,329,318
South Dakota,Butte County,2,746,398,348
South Dakota,Butte County,3,700,371,329
South Dakota,Butte County,4,593,313,280
South Dakota,Butte County,5,585,296,289
South Dakota,Butte County,6,550,285,265
South Dakota,Butte County,7,629,317,312
South Dakota,Butte County,8,522,275,247
South Dakota,Butte County,9,496,232,264
South Dakota,Butte County,10,575,289,286
South Dakota,Butte County,11,776,375,401
South Dakota,Butte County,12,831,399,432
South Dakota,Butte County,13,746,384,362
South Dakota,Butte County,14,624,327,297
South Dakota,Butte County,15,456,239,217
South Dakota,Butte County,16,337,169,168
South Dakota,Butte County,17,220,90,130
South Dakota,Butte County,18,265,95,170
South Dakota,Campbell County,0,1386,714,672
South Dakota,Campbell County,1,52,32,20
South Dakota,Campbell County,2,50,17,33
South Dakota,Campbell County,3,75,39,36
South Dakota,Campbell County,4,86,48,38
South Dakota,Campbell County,5,66,34,32
South Dakota,Campbell County,6,48,24,24
South Dakota,Campbell County,7,56,26,30
South Dakota,Campbell County,8,62,33,29
South Dakota,Campbell County,9,43,22,21
South Dakota,Campbell County,10,86,43,43
South Dakota,Campbell County,11,162,89,73
South Dakota,Campbell County,12,149,80,69
South Dakota,Campbell County,13,108,66,42
South Dakota,Campbell County,14,83,42,41
South Dakota,Campbell County,15,71,37,34
South Dakota,Campbell County,16,78,34,44
South Dakota,Campbell County,17,70,35,35
South Dakota,Campbell County,18,41,13,28
South Dakota,Charles Mix County,0,9287,4639,4648
South Dakota,Charles Mix County,1,800,440,360
South Dakota,Charles Mix County,2,786,374,412
South Dakota,Charles Mix County,3,719,362,357
South Dakota,Charles Mix County,4,697,348,349
South Dakota,Charles Mix County,5,521,274,247
South Dakota,Charles Mix County,6,464,240,224
South Dakota,Charles Mix County,7,486,256,230
South Dakota,Charles Mix County,8,457,226,231
South Dakota,Charles Mix County,9,432,205,227
South Dakota,Charles Mix County,10,501,265,236
South Dakota,Charles Mix County,11,604,297,307
South Dakota,Charles Mix County,12,633,319,314
South Dakota,Charles Mix County,13,520,265,255
South Dakota,Charles Mix County,14,439,217,222
South Dakota,Charles Mix County,15,384,184,200
South Dakota,Charles Mix County,16,309,148,161
South Dakota,Charles Mix County,17,270,123,147
South Dakota,Charles Mix County,18,265,96,169
South Dakota,Clark County,0,3645,1849,1796
South Dakota,Clark County,1,304,150,154
South Dakota,Clark County,2,233,121,112
South Dakota,Clark County,3,198,102,96
South Dakota,Clark County,4,209,113,96
South Dakota,Clark County,5,192,102,90
South Dakota,Clark County,6,206,105,101
South Dakota,Clark County,7,198,109,89
South Dakota,Clark County,8,179,100,79
South Dakota,Clark County,9,168,88,80
South Dakota,Clark County,10,182,89,93
South Dakota,Clark County,11,263,138,125
South Dakota,Clark County,12,276,153,123
South Dakota,Clark County,13,292,149,143
South Dakota,Clark County,14,198,99,99
South Dakota,Clark County,15,159,76,83
South Dakota,Clark County,16,139,66,73
South Dakota,Clark County,17,107,43,64
South Dakota,Clark County,18,142,46,96
South Dakota,Clay County,0,13932,6865,7067
South Dakota,Clay County,1,794,413,381
South Dakota,Clay County,2,683,359,324
South Dakota,Clay County,3,665,313,352
South Dakota,Clay County,4,1634,717,917
South Dakota,Clay County,5,3129,1542,1587
South Dakota,Clay County,6,968,520,448
South Dakota,Clay County,7,769,400,369
South Dakota,Clay County,8,622,312,310
South Dakota,Clay County,9,555,289,266
South Dakota,Clay County,10,603,293,310
South Dakota,Clay County,11,633,304,329
South Dakota,Clay County,12,673,354,319
South Dakota,Clay County,13,647,339,308
South Dakota,Clay County,14,491,270,221
South Dakota,Clay County,15,346,175,171
South Dakota,Clay County,16,265,113,152
South Dakota,Clay County,17,202,79,123
South Dakota,Clay County,18,253,73,180
South Dakota,Codington County,0,27938,13988,13950
South Dakota,Codington County,1,1966,973,993
South Dakota,Codington County,2,1960,1000,960
South Dakota,Codington County,3,1798,927,871
South Dakota,Codington County,4,1670,876,794
South Dakota,Codington County,5,2006,1036,970
South Dakota,Codington County,6,1762,951,811
South Dakota,Codington County,7,1777,899,878
South Dakota,Codington County,8,1677,866,811
South Dakota,Codington County,9,1569,826,743
South Dakota,Codington County,10,1694,875,819
South Dakota,Codington County,11,2008,969,1039
South Dakota,Codington County,12,2006,995,1011
South Dakota,Codington County,13,1706,895,811
South Dakota,Codington County,14,1234,598,636
South Dakota,Codington County,15,976,461,515
South Dakota,Codington County,16,805,342,463
South Dakota,Codington County,17,600,243,357
South Dakota,Codington County,18,724,256,468
South Dakota,Corson County,0,4182,2145,2037
South Dakota,Corson County,1,392,203,189
South Dakota,Corson County,2,418,216,202
South Dakota,Corson County,3,429,223,206
South Dakota,Corson County,4,329,162,167
South Dakota,Corson County,5,285,144,141
South Dakota,Corson County,6,246,118,128
South Dakota,Corson County,7,262,140,122
South Dakota,Corson County,8,229,114,115
South Dakota,Corson County,9,197,111,86
South Dakota,Corson County,10,247,129,118
South Dakota,Corson County,11,258,135,123
South Dakota,Corson County,12,259,130,129
South Dakota,Corson County,13,192,98,94
South Dakota,Corson County,14,147,80,67
South Dakota,Corson County,15,107,56,51
South Dakota,Corson County,16,78,35,43
South Dakota,Corson County,17,61,27,34
South Dakota,Corson County,18,46,24,22
South Dakota,Custer County,0,8445,4199,4246
South Dakota,Custer County,1,331,171,160
South Dakota,Custer County,2,353,183,170
South Dakota,Custer County,3,385,199,186
South Dakota,Custer County,4,498,293,205
South Dakota,Custer County,5,264,129,135
South Dakota,Custer County,6,292,150,142
South Dakota,Custer County,7,383,201,182
South Dakota,Custer County,8,350,171,179
South Dakota,Custer County,9,402,185,217
South Dakota,Custer County,10,511,253,258
South Dakota,Custer County,11,718,321,397
South Dakota,Custer County,12,858,389,469
South Dakota,Custer County,13,938,477,461
South Dakota,Custer County,14,798,415,383
South Dakota,Custer County,15,575,301,274
South Dakota,Custer County,16,346,180,166
South Dakota,Custer County,17,214,107,107
South Dakota,Custer County,18,229,74,155
South Dakota,Davison County,0,19885,9924,9961
South Dakota,Davison County,1,1243,632,611
South Dakota,Davison County,2,1374,730,644
South Dakota,Davison County,3,1190,608,582
South Dakota,Davison County,4,1352,708,644
South Dakota,Davison County,5,1502,820,682
South Dakota,Davison County,6,1294,687,607
South Dakota,Davison County,7,1224,653,571
South Dakota,Davison County,8,1134,580,554
South Dakota,Davison County,9,1029,538,491
South Dakota,Davison County,10,1080,561,519
South Dakota,Davison County,11,1401,699,702
South Dakota,Davison County,12,1385,675,710
South Dakota,Davison County,13,1222,616,606
South Dakota,Davison County,14,879,420,459
South Dakota,Davison County,15,700,316,384
South Dakota,Davison County,16,606,269,337
South Dakota,Davison County,17,519,211,308
South Dakota,Davison County,18,751,201,550
South Dakota,Day County,0,5588,2840,2748
South Dakota,Day County,1,319,155,164
South Dakota,Day County,2,341,181,160
South Dakota,Day County,3,337,171,166
South Dakota,Day County,4,341,187,154
South Dakota,Day County,5,249,134,115
South Dakota,Day County,6,262,126,136
South Dakota,Day County,7,274,158,116
South Dakota,Day County,8,255,133,122
South Dakota,Day County,9,251,142,109
South Dakota,Day County,10,276,130,146
South Dakota,Day County,11,420,211,209
South Dakota,Day County,12,450,236,214
South Dakota,Day County,13,450,241,209
South Dakota,Day County,14,407,197,210
South Dakota,Day County,15,285,148,137
South Dakota,Day County,16,227,127,100
South Dakota,Day County,17,215,86,129
South Dakota,Day County,18,229,77,152
South Dakota,Deuel County,0,4312,2223,2089
South Dakota,Deuel County,1,239,120,119
South Dakota,Deuel County,2,302,160,142
South Dakota,Deuel County,3,280,153,127
South Dakota,Deuel County,4,264,142,122
South Dakota,Deuel County,5,201,97,104
South Dakota,Deuel County,6,182,99,83
South Dakota,Deuel County,7,232,131,101
South Dakota,Deuel County,8,230,119,111
South Dakota,Deuel County,9,245,124,121
South Dakota,Deuel County,10,258,126,132
South Dakota,Deuel County,11,341,172,169
South Dakota,Deuel County,12,331,188,143
South Dakota,Deuel County,13,303,153,150
South Dakota,Deuel County,14,273,139,134
South Dakota,Deuel County,15,186,95,91
South Dakota,Deuel County,16,160,75,85
South Dakota,Deuel County,17,142,65,77
South Dakota,Deuel County,18,143,65,78
South Dakota,Dewey County,0,5662,2739,2923
South Dakota,Dewey County,1,665,328,337
South Dakota,Dewey County,2,533,272,261
South Dakota,Dewey County,3,515,247,268
South Dakota,Dewey County,4,437,206,231
South Dakota,Dewey County,5,409,196,213
South Dakota,Dewey County,6,341,164,177
South Dakota,Dewey County,7,365,191,174
South Dakota,Dewey County,8,303,142,161
South Dakota,Dewey County,9,281,118,163
South Dakota,Dewey County,10,324,164,160
South Dakota,Dewey County,11,394,198,196
South Dakota,Dewey County,12,306,151,155
South Dakota,Dewey County,13,224,112,112
South Dakota,Dewey County,14,183,88,95
South Dakota,Dewey County,15,130,60,70
South Dakota,Dewey County,16,105,45,60
South Dakota,Dewey County,17,82,29,53
South Dakota,Dewey County,18,65,28,37
South Dakota,Douglas County,0,2973,1476,1497
South Dakota,Douglas County,1,186,89,97
South Dakota,Douglas County,2,176,81,95
South Dakota,Douglas County,3,201,92,109
South Dakota,Douglas County,4,183,95,88
South Dakota,Douglas County,5,144,81,63
South Dakota,Douglas County,6,134,75,59
South Dakota,Douglas County,7,129,73,56
South Dakota,Douglas County,8,121,65,56
South Dakota,Douglas County,9,132,59,73
South Dakota,Douglas County,10,157,81,76
South Dakota,Douglas County,11,224,111,113
South Dakota,Douglas County,12,258,139,119
South Dakota,Douglas County,13,192,104,88
South Dakota,Douglas County,14,183,89,94
South Dakota,Douglas County,15,140,73,67
South Dakota,Douglas County,16,127,68,59
South Dakota,Douglas County,17,100,37,63
South Dakota,Douglas County,18,186,64,122
South Dakota,Edmunds County,0,3983,2032,1951
South Dakota,Edmunds County,1,219,123,96
South Dakota,Edmunds County,2,252,141,111
South Dakota,Edmunds County,3,263,132,131
South Dakota,Edmunds County,4,261,131,130
South Dakota,Edmunds County,5,198,108,90
South Dakota,Edmunds County,6,169,82,87
South Dakota,Edmunds County,7,190,99,91
South Dakota,Edmunds County,8,199,104,95
South Dakota,Edmunds County,9,199,112,87
South Dakota,Edmunds County,10,239,103,136
South Dakota,Edmunds County,11,333,175,158
South Dakota,Edmunds County,12,319,173,146
South Dakota,Edmunds County,13,290,142,148
South Dakota,Edmunds County,14,224,116,108
South Dakota,Edmunds County,15,192,96,96
South Dakota,Edmunds County,16,141,74,67
South Dakota,Edmunds County,17,132,58,74
South Dakota,Edmunds County,18,163,63,100
South Dakota,Fall River County,0,6845,3471,3374
South Dakota,Fall River County,1,226,142,84
South Dakota,Fall River County,2,342,181,161
South Dakota,Fall River County,3,403,208,195
South Dakota,Fall River County,4,406,230,176
South Dakota,Fall River County,5,284,150,134
South Dakota,Fall River County,6,275,129,146
South Dakota,Fall River County,7,301,155,146
South Dakota,Fall River County,8,312,143,169
South Dakota,Fall River County,9,337,157,180
South Dakota,Fall River County,10,396,216,180
South Dakota,Fall River County,11,509,267,242
South Dakota,Fall River County,12,583,286,297
South Dakota,Fall River County,13,685,342,343
South Dakota,Fall River County,14,588,311,277
South Dakota,Fall River County,15,416,209,207
South Dakota,Fall River County,16,339,171,168
South Dakota,Fall River County,17,220,94,126
South Dakota,Fall River County,18,223,80,143
South Dakota,Faulk County,0,2357,1190,1167
South Dakota,Faulk County,1,143,86,57
South Dakota,Faulk County,2,139,69,70
South Dakota,Faulk County,3,157,73,84
South Dakota,Faulk County,4,140,77,63
South Dakota,Faulk County,5,133,66,67
South Dakota,Faulk County,6,110,53,57
South Dakota,Faulk County,7,99,54,45
South Dakota,Faulk County,8,94,40,54
South Dakota,Faulk County,9,108,54,54
South Dakota,Faulk County,10,122,61,61
South Dakota,Faulk County,11,197,101,96
South Dakota,Faulk County,12,194,98,96
South Dakota,Faulk County,13,170,86,84
South Dakota,Faulk County,14,121,66,55
South Dakota,Faulk County,15,118,64,54
South Dakota,Faulk County,16,96,47,49
South Dakota,Faulk County,17,110,45,65
South Dakota,Faulk County,18,106,50,56
South Dakota,Grant County,0,7241,3710,3531
South Dakota,Grant County,1,412,215,197
South Dakota,Grant County,2,455,259,196
South Dakota,Grant County,3,455,227,228
South Dakota,Grant County,4,476,243,233
South Dakota,Grant County,5,373,208,165
South Dakota,Grant County,6,285,162,123
South Dakota,Grant County,7,366,179,187
South Dakota,Grant County,8,411,215,196
South Dakota,Grant County,9,402,228,174
South Dakota,Grant County,10,381,188,193
South Dakota,Grant County,11,645,333,312
South Dakota,Grant County,12,596,323,273
South Dakota,Grant County,13,539,280,259
South Dakota,Grant County,14,428,196,232
South Dakota,Grant County,15,322,157,165
South Dakota,Grant County,16,270,124,146
South Dakota,Grant County,17,195,82,113
South Dakota,Grant County,18,230,91,139
South Dakota,Gregory County,0,4217,2135,2082
South Dakota,Gregory County,1,240,108,132
South Dakota,Gregory County,2,266,138,128
South Dakota,Gregory County,3,286,161,125
South Dakota,Gregory County,4,255,141,114
South Dakota,Gregory County,5,191,112,79
South Dakota,Gregory County,6,152,74,78
South Dakota,Gregory County,7,209,116,93
South Dakota,Gregory County,8,209,111,98
South Dakota,Gregory County,9,220,115,105
South Dakota,Gregory County,10,217,116,101
South Dakota,Gregory County,11,296,153,143
South Dakota,Gregory County,12,336,168,168
South Dakota,Gregory County,13,322,171,151
South Dakota,Gregory County,14,275,142,133
South Dakota,Gregory County,15,213,103,110
South Dakota,Gregory County,16,178,72,106
South Dakota,Gregory County,17,156,65,91
South Dakota,Gregory County,18,196,69,127
South Dakota,Haakon County,0,1847,925,922
South Dakota,Haakon County,1,117,66,51
South Dakota,Haakon County,2,107,53,54
South Dakota,Haakon County,3,121,64,57
South Dakota,Haakon County,4,95,46,49
South Dakota,Haakon County,5,75,35,40
South Dakota,Haakon County,6,71,40,31
South Dakota,Haakon County,7,96,46,50
South Dakota,Haakon County,8,105,56,49
South Dakota,Haakon County,9,92,46,46
South Dakota,Haakon County,10,71,43,28
South Dakota,Haakon County,11,128,66,62
South Dakota,Haakon County,12,197,105,92
South Dakota,Haakon County,13,143,69,74
South Dakota,Haakon County,14,115,62,53
South Dakota,Haakon County,15,88,39,49
South Dakota,Haakon County,16,82,40,42
South Dakota,Haakon County,17,62,31,31
South Dakota,Haakon County,18,82,18,64
South Dakota,Hamlin County,0,5989,3008,2981
South Dakota,Hamlin County,1,568,265,303
South Dakota,Hamlin County,2,545,280,265
South Dakota,Hamlin County,3,485,252,233
South Dakota,Hamlin County,4,424,207,217
South Dakota,Hamlin County,5,310,164,146
South Dakota,Hamlin County,6,280,145,135
South Dakota,Hamlin County,7,337,173,164
South Dakota,Hamlin County,8,308,165,143
South Dakota,Hamlin County,9,312,169,143
South Dakota,Hamlin County,10,296,150,146
South Dakota,Hamlin County,11,390,194,196
South Dakota,Hamlin County,12,387,209,178
South Dakota,Hamlin County,13,299,162,137
South Dakota,Hamlin County,14,294,147,147
South Dakota,Hamlin County,15,256,128,128
South Dakota,Hamlin County,16,157,78,79
South Dakota,Hamlin County,17,152,70,82
South Dakota,Hamlin County,18,189,50,139
South Dakota,Hand County,0,3345,1689,1656
South Dakota,Hand County,1,173,107,66
South Dakota,Hand County,2,220,116,104
South Dakota,Hand County,3,172,75,97
South Dakota,Hand County,4,202,100,102
South Dakota,Hand County,5,172,99,73
South Dakota,Hand County,6,166,93,73
South Dakota,Hand County,7,168,96,72
South Dakota,Hand County,8,151,75,76
South Dakota,Hand County,9,119,55,64
South Dakota,Hand County,10,200,106,94
South Dakota,Hand County,11,270,148,122
South Dakota,Hand County,12,273,132,141
South Dakota,Hand County,13,239,125,114
South Dakota,Hand County,14,171,90,81
South Dakota,Hand County,15,157,76,81
South Dakota,Hand County,16,157,66,91
South Dakota,Hand County,17,152,66,86
South Dakota,Hand County,18,183,64,119
South Dakota,Hanson County,0,3419,1756,1663
South Dakota,Hanson County,1,332,172,160
South Dakota,Hanson County,2,318,157,161
South Dakota,Hanson County,3,296,166,130
South Dakota,Hanson County,4,268,124,144
South Dakota,Hanson County,5,144,80,64
South Dakota,Hanson County,6,128,64,64
South Dakota,Hanson County,7,199,97,102
South Dakota,Hanson County,8,201,106,95
South Dakota,Hanson County,9,207,108,99
South Dakota,Hanson County,10,207,101,106
South Dakota,Hanson County,11,203,108,95
South Dakota,Hanson County,12,200,106,94
South Dakota,Hanson County,13,250,111,139
South Dakota,Hanson County,14,201,109,92
South Dakota,Hanson County,15,143,79,64
South Dakota,Hanson County,16,57,31,26
South Dakota,Hanson County,17,37,23,14
South Dakota,Hanson County,18,28,14,14
South Dakota,Harding County,0,1250,648,602
South Dakota,Harding County,1,97,34,63
South Dakota,Harding County,2,60,22,38
South Dakota,Harding County,3,59,30,29
South Dakota,Harding County,4,84,49,35
South Dakota,Harding County,5,71,42,29
South Dakota,Harding County,6,81,51,30
South Dakota,Harding County,7,81,43,38
South Dakota,Harding County,8,55,30,25
South Dakota,Harding County,9,74,37,37
South Dakota,Harding County,10,70,38,32
South Dakota,Harding County,11,108,54,54
South Dakota,Harding County,12,116,68,48
South Dakota,Harding County,13,98,53,45
South Dakota,Harding County,14,64,34,30
South Dakota,Harding County,15,46,22,24
South Dakota,Harding County,16,38,19,19
South Dakota,Harding County,17,24,9,15
South Dakota,Harding County,18,24,13,11
South Dakota,Hughes County,0,17642,8649,8993
South Dakota,Hughes County,1,1229,652,577
South Dakota,Hughes County,2,1214,634,580
South Dakota,Hughes County,3,1061,548,513
South Dakota,Hughes County,4,1056,546,510
South Dakota,Hughes County,5,999,489,510
South Dakota,Hughes County,6,1187,563,624
South Dakota,Hughes County,7,1239,604,635
South Dakota,Hughes County,8,1017,495,522
South Dakota,Hughes County,9,1050,502,548
South Dakota,Hughes County,10,1102,509,593
South Dakota,Hughes County,11,1318,631,687
South Dakota,Hughes County,12,1342,651,691
South Dakota,Hughes County,13,1171,606,565
South Dakota,Hughes County,14,887,460,427
South Dakota,Hughes County,15,572,280,292
South Dakota,Hughes County,16,415,198,217
South Dakota,Hughes County,17,376,139,237
South Dakota,Hughes County,18,407,142,265
South Dakota,Hutchinson County,0,7200,3532,3668
South Dakota,Hutchinson County,1,490,237,253
South Dakota,Hutchinson County,2,426,210,216
South Dakota,Hutchinson County,3,461,227,234
South Dakota,Hutchinson County,4,489,232,257
South Dakota,Hutchinson County,5,324,173,151
South Dakota,Hutchinson County,6,293,150,143
South Dakota,Hutchinson County,7,334,168,166
South Dakota,Hutchinson County,8,368,187,181
South Dakota,Hutchinson County,9,399,212,187
South Dakota,Hutchinson County,10,365,190,175
South Dakota,Hutchinson County,11,501,263,238
South Dakota,Hutchinson County,12,545,288,257
South Dakota,Hutchinson County,13,497,256,241
South Dakota,Hutchinson County,14,360,186,174
South Dakota,Hutchinson County,15,318,152,166
South Dakota,Hutchinson County,16,312,130,182
South Dakota,Hutchinson County,17,299,124,175
South Dakota,Hutchinson County,18,419,147,272
South Dakota,Hyde County,0,1396,705,691
South Dakota,Hyde County,1,70,40,30
South Dakota,Hyde County,2,90,53,37
South Dakota,Hyde County,3,80,42,38
South Dakota,Hyde County,4,88,47,41
South Dakota,Hyde County,5,71,34,37
South Dakota,Hyde County,6,71,36,35
South Dakota,Hyde County,7,77,44,33
South Dakota,Hyde County,8,72,36,36
South Dakota,Hyde County,9,52,23,29
South Dakota,Hyde County,10,76,38,38
South Dakota,Hyde County,11,88,50,38
South Dakota,Hyde County,12,119,54,65
South Dakota,Hyde County,13,108,57,51
South Dakota,Hyde County,14,78,37,41
South Dakota,Hyde County,15,64,36,28
South Dakota,Hyde County,16,73,37,36
South Dakota,Hyde County,17,59,26,33
South Dakota,Hyde County,18,60,15,45
South Dakota,Jackson County,0,3274,1643,1631
South Dakota,Jackson County,1,358,184,174
South Dakota,Jackson County,2,295,148,147
South Dakota,Jackson County,3,284,136,148
South Dakota,Jackson County,4,279,147,132
South Dakota,Jackson County,5,223,112,111
South Dakota,Jackson County,6,184,91,93
South Dakota,Jackson County,7,181,85,96
South Dakota,Jackson County,8,143,81,62
South Dakota,Jackson County,9,159,69,90
South Dakota,Jackson County,10,193,96,97
South Dakota,Jackson County,11,203,106,97
South Dakota,Jackson County,12,183,91,92
South Dakota,Jackson County,13,152,75,77
South Dakota,Jackson County,14,130,69,61
South Dakota,Jackson County,15,90,46,44
South Dakota,Jackson County,16,89,50,39
South Dakota,Jackson County,17,56,29,27
South Dakota,Jackson County,18,72,28,44
South Dakota,Jerauld County,0,2007,1009,998
South Dakota,Jerauld County,1,135,77,58
South Dakota,Jerauld County,2,143,73,70
South Dakota,Jerauld County,3,135,70,65
South Dakota,Jerauld County,4,78,49,29
South Dakota,Jerauld County,5,59,32,27
South Dakota,Jerauld County,6,81,37,44
South Dakota,Jerauld County,7,121,61,60
South Dakota,Jerauld County,8,103,55,48
South Dakota,Jerauld County,9,94,57,37
South Dakota,Jerauld County,10,91,47,44
South Dakota,Jerauld County,11,131,63,68
South Dakota,Jerauld County,12,152,82,70
South Dakota,Jerauld County,13,185,92,93
South Dakota,Jerauld County,14,134,72,62
South Dakota,Jerauld County,15,100,43,57
South Dakota,Jerauld County,16,85,33,52
South Dakota,Jerauld County,17,76,32,44
South Dakota,Jerauld County,18,104,34,70
South Dakota,Jones County,0,975,449,526
South Dakota,Jones County,1,50,7,43
South Dakota,Jones County,2,66,29,37
South Dakota,Jones County,3,56,32,24
South Dakota,Jones County,4,57,20,37
South Dakota,Jones County,5,34,16,18
South Dakota,Jones County,6,51,24,27
South Dakota,Jones County,7,42,23,19
South Dakota,Jones County,8,41,20,21
South Dakota,Jones County,9,64,32,32
South Dakota,Jones County,10,50,22,28
South Dakota,Jones County,11,83,40,43
South Dakota,Jones County,12,88,44,44
South Dakota,Jones County,13,82,47,35
South Dakota,Jones County,14,56,32,24
South Dakota,Jones County,15,45,19,26
South Dakota,Jones County,16,48,20,28
South Dakota,Jones County,17,31,14,17
South Dakota,Jones County,18,31,8,23
South Dakota,Kingsbury County,0,5075,2570,2505
South Dakota,Kingsbury County,1,320,155,165
South Dakota,Kingsbury County,2,300,153,147
South Dakota,Kingsbury County,3,296,160,136
South Dakota,Kingsbury County,4,310,155,155
South Dakota,Kingsbury County,5,252,129,123
South Dakota,Kingsbury County,6,216,105,111
South Dakota,Kingsbury County,7,280,131,149
South Dakota,Kingsbury County,8,257,140,117
South Dakota,Kingsbury County,9,238,131,107
South Dakota,Kingsbury County,10,259,125,134
South Dakota,Kingsbury County,11,441,214,227
South Dakota,Kingsbury County,12,423,243,180
South Dakota,Kingsbury County,13,391,210,181
South Dakota,Kingsbury County,14,300,173,127
South Dakota,Kingsbury County,15,215,95,120
South Dakota,Kingsbury County,16,191,99,92
South Dakota,Kingsbury County,17,177,74,103
South Dakota,Kingsbury County,18,209,78,131
South Dakota,Lake County,0,12368,6393,5975
South Dakota,Lake County,1,682,363,319
South Dakota,Lake County,2,664,335,329
South Dakota,Lake County,3,673,368,305
South Dakota,Lake County,4,919,494,425
South Dakota,Lake County,5,883,497,386
South Dakota,Lake County,6,629,350,279
South Dakota,Lake County,7,644,342,302
South Dakota,Lake County,8,611,340,271
South Dakota,Lake County,9,526,262,264
South Dakota,Lake County,10,636,321,315
South Dakota,Lake County,11,929,457,472
South Dakota,Lake County,12,1043,485,558
South Dakota,Lake County,13,1084,560,524
South Dakota,Lake County,14,919,517,402
South Dakota,Lake County,15,551,294,257
South Dakota,Lake County,16,367,162,205
South Dakota,Lake County,17,272,124,148
South Dakota,Lake County,18,336,122,214
South Dakota,Lawrence County,0,24657,12321,12336
South Dakota,Lawrence County,1,1151,616,535
South Dakota,Lawrence County,2,1326,701,625
South Dakota,Lawrence County,3,1261,640,621
South Dakota,Lawrence County,4,1738,886,852
South Dakota,Lawrence County,5,2247,1114,1133
South Dakota,Lawrence County,6,1472,788,684
South Dakota,Lawrence County,7,1401,724,677
South Dakota,Lawrence County,8,1304,662,642
South Dakota,Lawrence County,9,1209,647,562
South Dakota,Lawrence County,10,1308,648,660
South Dakota,Lawrence County,11,1690,817,873
South Dakota,Lawrence County,12,1985,981,1004
South Dakota,Lawrence County,13,1994,1010,984
South Dakota,Lawrence County,14,1488,769,719
South Dakota,Lawrence County,15,1035,515,520
South Dakota,Lawrence County,16,776,348,428
South Dakota,Lawrence County,17,605,242,363
South Dakota,Lawrence County,18,667,213,454
South Dakota,Lincoln County,0,51548,25584,25964
South Dakota,Lincoln County,1,4275,2220,2055
South Dakota,Lincoln County,2,4692,2419,2273
South Dakota,Lincoln County,3,3972,2059,1913
South Dakota,Lincoln County,4,3071,1604,1467
South Dakota,Lincoln County,5,2591,1260,1331
South Dakota,Lincoln County,6,3623,1717,1906
South Dakota,Lincoln County,7,4441,2166,2275
South Dakota,Lincoln County,8,3986,1993,1993
South Dakota,Lincoln County,9,3669,1851,1818
South Dakota,Lincoln County,10,3089,1541,1548
South Dakota,Lincoln County,11,3127,1555,1572
South Dakota,Lincoln County,12,2981,1495,1486
South Dakota,Lincoln County,13,2684,1275,1409
South Dakota,Lincoln County,14,1923,935,988
South Dakota,Lincoln County,15,1246,620,626
South Dakota,Lincoln County,16,786,354,432
South Dakota,Lincoln County,17,633,258,375
South Dakota,Lincoln County,18,759,262,497
South Dakota,Lyman County,0,3877,2040,1837
South Dakota,Lyman County,1,323,151,172
South Dakota,Lyman County,2,315,176,139
South Dakota,Lyman County,3,293,160,133
South Dakota,Lyman County,4,287,166,121
South Dakota,Lyman County,5,228,135,93
South Dakota,Lyman County,6,230,118,112
South Dakota,Lyman County,7,234,117,117
South Dakota,Lyman County,8,205,106,99
South Dakota,Lyman County,9,189,114,75
South Dakota,Lyman County,10,204,102,102
South Dakota,Lyman County,11,264,132,132
South Dakota,Lyman County,12,293,157,136
South Dakota,Lyman County,13,223,127,96
South Dakota,Lyman County,14,170,86,84
South Dakota,Lyman County,15,159,66,93
South Dakota,Lyman County,16,122,66,56
South Dakota,Lyman County,17,85,37,48
South Dakota,Lyman County,18,53,24,29
South Dakota,McCook County,0,5649,2839,2810
South Dakota,McCook County,1,394,214,180
South Dakota,McCook County,2,436,223,213
South Dakota,McCook County,3,420,196,224
South Dakota,McCook County,4,337,170,167
South Dakota,McCook County,5,288,161,127
South Dakota,McCook County,6,258,144,114
South Dakota,McCook County,7,302,154,148
South Dakota,McCook County,8,318,168,150
South Dakota,McCook County,9,288,150,138
South Dakota,McCook County,10,332,188,144
South Dakota,McCook County,11,407,209,198
South Dakota,McCook County,12,410,218,192
South Dakota,McCook County,13,355,168,187
South Dakota,McCook County,14,277,137,140
South Dakota,McCook County,15,266,118,148
South Dakota,McCook County,16,191,83,108
South Dakota,McCook County,17,173,70,103
South Dakota,McCook County,18,197,68,129
South Dakota,McPherson County,0,2429,1180,1249
South Dakota,McPherson County,1,139,55,84
South Dakota,McPherson County,2,139,72,67
South Dakota,McPherson County,3,162,80,82
South Dakota,McPherson County,4,143,73,70
South Dakota,McPherson County,5,102,50,52
South Dakota,McPherson County,6,77,40,37
South Dakota,McPherson County,7,113,56,57
South Dakota,McPherson County,8,112,56,56
South Dakota,McPherson County,9,109,59,50
South Dakota,McPherson County,10,131,63,68
South Dakota,McPherson County,11,164,87,77
South Dakota,McPherson County,12,174,88,86
South Dakota,McPherson County,13,180,96,84
South Dakota,McPherson County,14,154,72,82
South Dakota,McPherson County,15,125,60,65
South Dakota,McPherson County,16,144,68,76
South Dakota,McPherson County,17,122,53,69
South Dakota,McPherson County,18,139,52,87
South Dakota,Marshall County,0,4683,2555,2128
South Dakota,Marshall County,1,290,171,119
South Dakota,Marshall County,2,270,140,130
South Dakota,Marshall County,3,267,148,119
South Dakota,Marshall County,4,281,157,124
South Dakota,Marshall County,5,281,157,124
South Dakota,Marshall County,6,298,202,96
South Dakota,Marshall County,7,271,156,115
South Dakota,Marshall County,8,225,142,83
South Dakota,Marshall County,9,232,141,91
South Dakota,Marshall County,10,270,138,132
South Dakota,Marshall County,11,348,174,174
South Dakota,Marshall County,12,351,187,164
South Dakota,Marshall County,13,370,207,163
South Dakota,Marshall County,14,292,145,147
South Dakota,Marshall County,15,204,107,97
South Dakota,Marshall County,16,161,82,79
South Dakota,Marshall County,17,127,60,67
South Dakota,Marshall County,18,145,41,104
South Dakota,Meade County,0,26951,14094,12857
South Dakota,Meade County,1,1701,894,807
South Dakota,Meade County,2,2010,1073,937
South Dakota,Meade County,3,1769,883,886
South Dakota,Meade County,4,1636,902,734
South Dakota,Meade County,5,2494,1592,902
South Dakota,Meade County,6,1942,1062,880
South Dakota,Meade County,7,1845,926,919
South Dakota,Meade County,8,1619,848,771
South Dakota,Meade County,9,1405,723,682
South Dakota,Meade County,10,1397,688,709
South Dakota,Meade County,11,1882,936,946
South Dakota,Meade County,12,1815,919,896
South Dakota,Meade County,13,1738,885,853
South Dakota,Meade County,14,1305,684,621
South Dakota,Meade County,15,866,432,434
South Dakota,Meade County,16,615,288,327
South Dakota,Meade County,17,477,205,272
South Dakota,Meade County,18,435,154,281
South Dakota,Mellette County,0,2100,1109,991
South Dakota,Mellette County,1,197,127,70
South Dakota,Mellette County,2,177,100,77
South Dakota,Mellette County,3,177,100,77
South Dakota,Mellette County,4,154,74,80
South Dakota,Mellette County,5,142,79,63
South Dakota,Mellette County,6,111,48,63
South Dakota,Mellette County,7,99,39,60
South Dakota,Mellette County,8,96,46,50
South Dakota,Mellette County,9,102,54,48
South Dakota,Mellette County,10,122,70,52
South Dakota,Mellette County,11,149,78,71
South Dakota,Mellette County,12,125,64,61
South Dakota,Mellette County,13,121,74,47
South Dakota,Mellette County,14,109,54,55
South Dakota,Mellette County,15,60,21,39
South Dakota,Mellette County,16,73,40,33
South Dakota,Mellette County,17,44,19,25
South Dakota,Mellette County,18,42,22,20
South Dakota,Miner County,0,2316,1166,1150
South Dakota,Miner County,1,130,55,75
South Dakota,Miner County,2,159,86,73
South Dakota,Miner County,3,171,84,87
South Dakota,Miner County,4,147,83,64
South Dakota,Miner County,5,106,58,48
South Dakota,Miner County,6,97,51,46
South Dakota,Miner County,7,103,56,47
South Dakota,Miner County,8,114,60,54
South Dakota,Miner County,9,101,47,54
South Dakota,Miner County,10,124,59,65
South Dakota,Miner County,11,202,107,95
South Dakota,Miner County,12,190,97,93
South Dakota,Miner County,13,167,104,63
South Dakota,Miner County,14,119,65,54
South Dakota,Miner County,15,109,48,61
South Dakota,Miner County,16,81,38,43
South Dakota,Miner County,17,94,38,56
South Dakota,Miner County,18,102,30,72
South Dakota,Minnehaha County,0,182882,91842,91040
South Dakota,Minnehaha County,1,14060,7330,6730
South Dakota,Minnehaha County,2,12926,6645,6281
South Dakota,Minnehaha County,3,11770,6067,5703
South Dakota,Minnehaha County,4,11774,6011,5763
South Dakota,Minnehaha County,5,12884,6519,6365
South Dakota,Minnehaha County,6,14701,7560,7141
South Dakota,Minnehaha County,7,14082,7317,6765
South Dakota,Minnehaha County,8,11765,6187,5578
South Dakota,Minnehaha County,9,10949,5575,5374
South Dakota,Minnehaha County,10,11127,5788,5339
South Dakota,Minnehaha County,11,12716,6324,6392
South Dakota,Minnehaha County,12,11791,5861,5930
South Dakota,Minnehaha County,13,10066,4974,5092
South Dakota,Minnehaha County,14,7602,3719,3883
South Dakota,Minnehaha County,15,4861,2239,2622
South Dakota,Minnehaha County,16,3506,1511,1995
South Dakota,Minnehaha County,17,2889,1133,1756
South Dakota,Minnehaha County,18,3413,1082,2331
South Dakota,Moody County,0,6367,3203,3164
South Dakota,Moody County,1,478,239,239
South Dakota,Moody County,2,455,229,226
South Dakota,Moody County,3,433,217,216
South Dakota,Moody County,4,398,211,187
South Dakota,Moody County,5,331,175,156
South Dakota,Moody County,6,314,159,155
South Dakota,Moody County,7,387,200,187
South Dakota,Moody County,8,327,176,151
South Dakota,Moody County,9,320,161,159
South Dakota,Moody County,10,399,196,203
South Dakota,Moody County,11,505,272,233
South Dakota,Moody County,12,504,255,249
South Dakota,Moody County,13,430,210,220
South Dakota,Moody County,14,324,171,153
South Dakota,Moody County,15,262,125,137
South Dakota,Moody County,16,207,94,113
South Dakota,Moody County,17,140,58,82
South Dakota,Moody County,18,153,55,98
South Dakota,Pennington County,0,108242,54371,53871
South Dakota,Pennington County,1,7547,3879,3668
South Dakota,Pennington County,2,7366,3814,3552
South Dakota,Pennington County,3,6835,3553,3282
South Dakota,Pennington County,4,6861,3691,3170
South Dakota,Pennington County,5,6976,3723,3253
South Dakota,Pennington County,6,7795,4031,3764
South Dakota,Pennington County,7,7403,3735,3668
South Dakota,Pennington County,8,6320,3230,3090
South Dakota,Pennington County,9,6026,2986,3040
South Dakota,Pennington County,10,5954,3028,2926
South Dakota,Pennington County,11,7517,3755,3762
South Dakota,Pennington County,12,7785,3770,4015
South Dakota,Pennington County,13,7173,3488,3685
South Dakota,Pennington County,14,5441,2788,2653
South Dakota,Pennington County,15,3847,1858,1989
South Dakota,Pennington County,16,2813,1266,1547
South Dakota,Pennington County,17,2191,955,1236
South Dakota,Pennington County,18,2392,821,1571
South Dakota,Perkins County,0,3033,1547,1486
South Dakota,Perkins County,1,159,84,75
South Dakota,Perkins County,2,170,89,81
South Dakota,Perkins County,3,187,99,88
South Dakota,Perkins County,4,206,110,96
South Dakota,Perkins County,5,142,74,68
South Dakota,Perkins County,6,110,58,52
South Dakota,Perkins County,7,178,100,78
South Dakota,Perkins County,8,140,66,74
South Dakota,Perkins County,9,151,80,71
South Dakota,Perkins County,10,175,85,90
South Dakota,Perkins County,11,223,108,115
South Dakota,Perkins County,12,266,134,132
South Dakota,Perkins County,13,229,123,106
South Dakota,Perkins County,14,180,88,92
South Dakota,Perkins County,15,160,92,68
South Dakota,Perkins County,16,106,56,50
South Dakota,Perkins County,17,110,52,58
South Dakota,Perkins County,18,141,49,92
South Dakota,Potter County,0,2340,1133,1207
South Dakota,Potter County,1,127,61,66
South Dakota,Potter County,2,143,73,70
South Dakota,Potter County,3,140,68,72
South Dakota,Potter County,4,119,56,63
South Dakota,Potter County,5,91,49,42
South Dakota,Potter County,6,84,46,38
South Dakota,Potter County,7,106,50,56
South Dakota,Potter County,8,103,53,50
South Dakota,Potter County,9,100,52,48
South Dakota,Potter County,10,118,52,66
South Dakota,Potter County,11,183,97,86
South Dakota,Potter County,12,174,94,80
South Dakota,Potter County,13,188,93,95
South Dakota,Potter County,14,182,82,100
South Dakota,Potter County,15,137,79,58
South Dakota,Potter County,16,112,45,67
South Dakota,Potter County,17,93,36,57
South Dakota,Potter County,18,140,47,93
South Dakota,Roberts County,0,10374,5182,5192
South Dakota,Roberts County,1,906,450,456
South Dakota,Roberts County,2,834,408,426
South Dakota,Roberts County,3,729,367,362
South Dakota,Roberts County,4,761,418,343
South Dakota,Roberts County,5,606,302,304
South Dakota,Roberts County,6,482,234,248
South Dakota,Roberts County,7,500,235,265
South Dakota,Roberts County,8,513,264,249
South Dakota,Roberts County,9,509,253,256
South Dakota,Roberts County,10,580,275,305
South Dakota,Roberts County,11,679,357,322
South Dakota,Roberts County,12,699,373,326
South Dakota,Roberts County,13,695,339,356
South Dakota,Roberts County,14,560,309,251
South Dakota,Roberts County,15,433,216,217
South Dakota,Roberts County,16,342,173,169
South Dakota,Roberts County,17,269,119,150
South Dakota,Roberts County,18,277,90,187
South Dakota,Sanborn County,0,2336,1213,1123
South Dakota,Sanborn County,1,149,74,75
South Dakota,Sanborn County,2,140,79,61
South Dakota,Sanborn County,3,147,74,73
South Dakota,Sanborn County,4,119,72,47
South Dakota,Sanborn County,5,131,70,61
South Dakota,Sanborn County,6,128,69,59
South Dakota,Sanborn County,7,149,79,70
South Dakota,Sanborn County,8,117,71,46
South Dakota,Sanborn County,9,108,59,49
South Dakota,Sanborn County,10,115,55,60
South Dakota,Sanborn County,11,195,85,110
South Dakota,Sanborn County,12,203,109,94
South Dakota,Sanborn County,13,193,108,85
South Dakota,Sanborn County,14,128,75,53
South Dakota,Sanborn County,15,83,39,44
South Dakota,Sanborn County,16,79,33,46
South Dakota,Sanborn County,17,70,35,35
South Dakota,Sanborn County,18,82,27,55
South Dakota,Shannon County,0,14218,6878,7340
South Dakota,Shannon County,1,1664,793,871
South Dakota,Shannon County,2,1557,795,762
South Dakota,Shannon County,3,1406,730,676
South Dakota,Shannon County,4,1246,611,635
South Dakota,Shannon County,5,1203,584,619
South Dakota,Shannon County,6,1175,587,588
South Dakota,Shannon County,7,888,388,500
South Dakota,Shannon County,8,731,369,362
South Dakota,Shannon County,9,760,369,391
South Dakota,Shannon County,10,776,384,392
South Dakota,Shannon County,11,733,385,348
South Dakota,Shannon County,12,621,291,330
South Dakota,Shannon County,13,493,203,290
South Dakota,Shannon County,14,352,159,193
South Dakota,Shannon County,15,250,79,171
South Dakota,Shannon County,16,169,68,101
South Dakota,Shannon County,17,110,55,55
South Dakota,Shannon County,18,84,28,56
South Dakota,Spink County,0,6598,3332,3266
South Dakota,Spink County,1,390,213,177
South Dakota,Spink County,2,446,224,222
South Dakota,Spink County,3,450,237,213
South Dakota,Spink County,4,453,247,206
South Dakota,Spink County,5,365,197,168
South Dakota,Spink County,6,333,193,140
South Dakota,Spink County,7,382,192,190
South Dakota,Spink County,8,291,143,148
South Dakota,Spink County,9,320,160,160
South Dakota,Spink County,10,363,173,190
South Dakota,Spink County,11,504,253,251
South Dakota,Spink County,12,547,278,269
South Dakota,Spink County,13,463,241,222
South Dakota,Spink County,14,342,182,160
South Dakota,Spink County,15,257,126,131
South Dakota,Spink County,16,247,107,140
South Dakota,Spink County,17,198,87,111
South Dakota,Spink County,18,247,79,168
South Dakota,Stanley County,0,2983,1545,1438
South Dakota,Stanley County,1,176,104,72
South Dakota,Stanley County,2,196,88,108
South Dakota,Stanley County,3,235,128,107
South Dakota,Stanley County,4,162,89,73
South Dakota,Stanley County,5,157,95,62
South Dakota,Stanley County,6,155,81,74
South Dakota,Stanley County,7,196,106,90
South Dakota,Stanley County,8,176,95,81
South Dakota,Stanley County,9,169,79,90
South Dakota,Stanley County,10,200,103,97
South Dakota,Stanley County,11,218,107,111
South Dakota,Stanley County,12,212,98,114
South Dakota,Stanley County,13,220,116,104
South Dakota,Stanley County,14,163,75,88
South Dakota,Stanley County,15,154,78,76
South Dakota,Stanley County,16,96,54,42
South Dakota,Stanley County,17,55,27,28
South Dakota,Stanley County,18,43,22,21
South Dakota,Sully County,0,1438,776,662
South Dakota,Sully County,1,71,40,31
South Dakota,Sully County,2,89,49,40
South Dakota,Sully County,3,95,49,46
South Dakota,Sully County,4,79,46,33
South Dakota,Sully County,5,72,46,26
South Dakota,Sully County,6,79,44,35
South Dakota,Sully County,7,78,38,40
South Dakota,Sully County,8,67,33,34
South Dakota,Sully County,9,69,38,31
South Dakota,Sully County,10,100,53,47
South Dakota,Sully County,11,113,60,53
South Dakota,Sully County,12,133,73,60
South Dakota,Sully County,13,123,77,46
South Dakota,Sully County,14,70,39,31
South Dakota,Sully County,15,63,32,31
South Dakota,Sully County,16,65,33,32
South Dakota,Sully County,17,41,15,26
South Dakota,Sully County,18,31,11,20
South Dakota,Todd County,0,9882,4807,5075
South Dakota,Todd County,1,1285,650,635
South Dakota,Todd County,2,1154,581,573
South Dakota,Todd County,3,1016,500,516
South Dakota,Todd County,4,828,429,399
South Dakota,Todd County,5,734,367,367
South Dakota,Todd County,6,715,343,372
South Dakota,Todd County,7,684,321,363
South Dakota,Todd County,8,512,231,281
South Dakota,Todd County,9,485,225,260
South Dakota,Todd County,10,451,205,246
South Dakota,Todd County,11,477,233,244
South Dakota,Todd County,12,456,218,238
South Dakota,Todd County,13,368,151,217
South Dakota,Todd County,14,289,143,146
South Dakota,Todd County,15,163,93,70
South Dakota,Todd County,16,102,46,56
South Dakota,Todd County,17,85,37,48
South Dakota,Todd County,18,78,34,44
South Dakota,Tripp County,0,5512,2726,2786
South Dakota,Tripp County,1,341,179,162
South Dakota,Tripp County,2,342,166,176
South Dakota,Tripp County,3,329,161,168
South Dakota,Tripp County,4,353,168,185
South Dakota,Tripp County,5,335,184,151
South Dakota,Tripp County,6,265,148,117
South Dakota,Tripp County,7,253,134,119
South Dakota,Tripp County,8,272,122,150
South Dakota,Tripp County,9,269,148,121
South Dakota,Tripp County,10,317,144,173
South Dakota,Tripp County,11,447,237,210
South Dakota,Tripp County,12,416,215,201
South Dakota,Tripp County,13,384,205,179
South Dakota,Tripp County,14,304,139,165
South Dakota,Tripp County,15,253,122,131
South Dakota,Tripp County,16,218,99,119
South Dakota,Tripp County,17,169,71,98
South Dakota,Tripp County,18,245,84,161
South Dakota,Turner County,0,8272,4173,4099
South Dakota,Turner County,1,495,268,227
South Dakota,Turner County,2,542,286,256
South Dakota,Turner County,3,566,309,257
South Dakota,Turner County,4,498,259,239
South Dakota,Turner County,5,348,172,176
South Dakota,Turner County,6,366,178,188
South Dakota,Turner County,7,475,249,226
South Dakota,Turner County,8,453,237,216
South Dakota,Turner County,9,460,236,224
South Dakota,Turner County,10,485,246,239
South Dakota,Turner County,11,663,345,318
South Dakota,Turner County,12,641,323,318
South Dakota,Turner County,13,582,313,269
South Dakota,Turner County,14,475,251,224
South Dakota,Turner County,15,370,153,217
South Dakota,Turner County,16,306,132,174
South Dakota,Turner County,17,233,104,129
South Dakota,Turner County,18,314,112,202
South Dakota,Union County,0,15029,7600,7429
South Dakota,Union County,1,912,495,417
South Dakota,Union County,2,1072,562,510
South Dakota,Union County,3,1128,562,566
South Dakota,Union County,4,1044,553,491
South Dakota,Union County,5,808,425,383
South Dakota,Union County,6,745,391,354
South Dakota,Union County,7,904,461,443
South Dakota,Union County,8,896,422,474
South Dakota,Union County,9,922,463,459
South Dakota,Union County,10,1009,535,474
South Dakota,Union County,11,1095,540,555
South Dakota,Union County,12,1080,550,530
South Dakota,Union County,13,1084,557,527
South Dakota,Union County,14,782,394,388
South Dakota,Union County,15,534,262,272
South Dakota,Union County,16,360,165,195
South Dakota,Union County,17,311,129,182
South Dakota,Union County,18,343,134,209
South Dakota,Walworth County,0,5511,2697,2814
South Dakota,Walworth County,1,330,156,174
South Dakota,Walworth County,2,337,152,185
South Dakota,Walworth County,3,354,200,154
South Dakota,Walworth County,4,315,161,154
South Dakota,Walworth County,5,266,140,126
South Dakota,Walworth County,6,295,148,147
South Dakota,Walworth County,7,287,151,136
South Dakota,Walworth County,8,264,147,117
South Dakota,Walworth County,9,240,121,119
South Dakota,Walworth County,10,297,138,159
South Dakota,Walworth County,11,394,201,193
South Dakota,Walworth County,12,398,205,193
South Dakota,Walworth County,13,397,193,204
South Dakota,Walworth County,14,358,176,182
South Dakota,Walworth County,15,268,128,140
South Dakota,Walworth County,16,264,114,150
South Dakota,Walworth County,17,192,80,112
South Dakota,Walworth County,18,255,86,169
South Dakota,Yankton County,0,22684,11766,10918
South Dakota,Yankton County,1,1317,676,641
South Dakota,Yankton County,2,1318,669,649
South Dakota,Yankton County,3,1284,668,616
South Dakota,Yankton County,4,1434,721,713
South Dakota,Yankton County,5,1448,740,708
South Dakota,Yankton County,6,1381,789,592
South Dakota,Yankton County,7,1493,896,597
South Dakota,Yankton County,8,1313,728,585
South Dakota,Yankton County,9,1320,743,577
South Dakota,Yankton County,10,1482,828,654
South Dakota,Yankton County,11,1725,913,812
South Dakota,Yankton County,12,1722,899,823
South Dakota,Yankton County,13,1470,753,717
South Dakota,Yankton County,14,1155,565,590
South Dakota,Yankton County,15,887,437,450
South Dakota,Yankton County,16,663,283,380
South Dakota,Yankton County,17,518,214,304
South Dakota,Yankton County,18,754,244,510
South Dakota,Ziebach County,0,2826,1440,1386
South Dakota,Ziebach County,1,177,82,95
South Dakota,Ziebach County,2,325,153,172
South Dakota,Ziebach County,3,337,171,166
South Dakota,Ziebach County,4,285,146,139
South Dakota,Ziebach County,5,221,125,96
South Dakota,Ziebach County,6,154,86,68
South Dakota,Ziebach County,7,189,121,68
South Dakota,Ziebach County,8,158,63,95
South Dakota,Ziebach County,9,174,90,84
South Dakota,Ziebach County,10,147,67,80
South Dakota,Ziebach County,11,220,110,110
South Dakota,Ziebach County,12,151,74,77
South Dakota,Ziebach County,13,99,56,43
South Dakota,Ziebach County,14,60,30,30
South Dakota,Ziebach County,15,47,25,22
South Dakota,Ziebach County,16,32,11,21
South Dakota,Ziebach County,17,34,21,13
South Dakota,Ziebach County,18,16,9,7
Tennessee,Anderson County,0,75528,36617,38911
Tennessee,Anderson County,1,3987,1966,2021
Tennessee,Anderson County,2,4447,2251,2196
Tennessee,Anderson County,3,4629,2341,2288
Tennessee,Anderson County,4,4306,2297,2009
Tennessee,Anderson County,5,4518,2301,2217
Tennessee,Anderson County,6,4121,2052,2069
Tennessee,Anderson County,7,4303,2144,2159
Tennessee,Anderson County,8,4315,2179,2136
Tennessee,Anderson County,9,4831,2345,2486
Tennessee,Anderson County,10,5007,2384,2623
Tennessee,Anderson County,11,5707,2769,2938
Tennessee,Anderson County,12,5727,2790,2937
Tennessee,Anderson County,13,5366,2580,2786
Tennessee,Anderson County,14,4571,2156,2415
Tennessee,Anderson County,15,3295,1576,1719
Tennessee,Anderson County,16,2376,1066,1310
Tennessee,Anderson County,17,1807,709,1098
Tennessee,Anderson County,18,2215,711,1504
Tennessee,Bedford County,0,46627,22899,23728
Tennessee,Bedford County,1,3142,1519,1623
Tennessee,Bedford County,2,3559,1797,1762
Tennessee,Bedford County,3,3512,1819,1693
Tennessee,Bedford County,4,3155,1610,1545
Tennessee,Bedford County,5,3036,1560,1476
Tennessee,Bedford County,6,2717,1340,1377
Tennessee,Bedford County,7,2928,1472,1456
Tennessee,Bedford County,8,2927,1465,1462
Tennessee,Bedford County,9,3198,1575,1623
Tennessee,Bedford County,10,2996,1510,1486
Tennessee,Bedford County,11,3199,1531,1668
Tennessee,Bedford County,12,2958,1466,1492
Tennessee,Bedford County,13,2598,1221,1377
Tennessee,Bedford County,14,2376,1086,1290
Tennessee,Bedford County,15,1767,843,924
Tennessee,Bedford County,16,1175,551,624
Tennessee,Bedford County,17,727,316,411
Tennessee,Bedford County,18,657,218,439
Tennessee,Benton County,0,16145,7989,8156
Tennessee,Benton County,1,826,452,374
Tennessee,Benton County,2,870,444,426
Tennessee,Benton County,3,897,464,433
Tennessee,Benton County,4,911,465,446
Tennessee,Benton County,5,850,439,411
Tennessee,Benton County,6,747,388,359
Tennessee,Benton County,7,814,399,415
Tennessee,Benton County,8,826,423,403
Tennessee,Benton County,9,1007,518,489
Tennessee,Benton County,10,1128,570,558
Tennessee,Benton County,11,1205,557,648
Tennessee,Benton County,12,1240,585,655
Tennessee,Benton County,13,1193,588,605
Tennessee,Benton County,14,1268,624,644
Tennessee,Benton County,15,951,468,483
Tennessee,Benton County,16,649,305,344
Tennessee,Benton County,17,405,167,238
Tennessee,Benton County,18,358,133,225
Tennessee,Bledsoe County,0,13931,7980,5951
Tennessee,Bledsoe County,1,549,283,266
Tennessee,Bledsoe County,2,628,328,300
Tennessee,Bledsoe County,3,725,366,359
Tennessee,Bledsoe County,4,799,464,335
Tennessee,Bledsoe County,5,803,478,325
Tennessee,Bledsoe County,6,797,529,268
Tennessee,Bledsoe County,7,891,595,296
Tennessee,Bledsoe County,8,994,644,350
Tennessee,Bledsoe County,9,1014,643,371
Tennessee,Bledsoe County,10,1087,662,425
Tennessee,Bledsoe County,11,1158,660,498
Tennessee,Bledsoe County,12,1047,594,453
Tennessee,Bledsoe County,13,908,489,419
Tennessee,Bledsoe County,14,902,450,452
Tennessee,Bledsoe County,15,670,348,322
Tennessee,Bledsoe County,16,447,229,218
Tennessee,Bledsoe County,17,301,127,174
Tennessee,Bledsoe County,18,211,91,120
Tennessee,Blount County,0,126339,61276,65063
Tennessee,Blount County,1,6426,3335,3091
Tennessee,Blount County,2,7227,3639,3588
Tennessee,Blount County,3,8010,4073,3937
Tennessee,Blount County,4,7800,3938,3862
Tennessee,Blount County,5,7672,3865,3807
Tennessee,Blount County,6,6894,3490,3404
Tennessee,Blount County,7,7055,3473,3582
Tennessee,Blount County,8,7183,3509,3674
Tennessee,Blount County,9,8504,4142,4362
Tennessee,Blount County,10,8909,4329,4580
Tennessee,Blount County,11,9692,4688,5004
Tennessee,Blount County,12,9116,4345,4771
Tennessee,Blount County,13,8562,4028,4534
Tennessee,Blount County,14,7932,3793,4139
Tennessee,Blount County,15,5944,2789,3155
Tennessee,Blount County,16,4092,1850,2242
Tennessee,Blount County,17,2677,1116,1561
Tennessee,Blount County,18,2644,874,1770
Tennessee,Bradley County,0,102975,50136,52839
Tennessee,Bradley County,1,5790,2955,2835
Tennessee,Bradley County,2,6432,3327,3105
Tennessee,Bradley County,3,6735,3402,3333
Tennessee,Bradley County,4,7062,3600,3462
Tennessee,Bradley County,5,7572,3723,3849
Tennessee,Bradley County,6,6654,3370,3284
Tennessee,Bradley County,7,6166,3016,3150
Tennessee,Bradley County,8,6373,3154,3219
Tennessee,Bradley County,9,6923,3425,3498
Tennessee,Bradley County,10,7043,3506,3537
Tennessee,Bradley County,11,7318,3560,3758
Tennessee,Bradley County,12,6789,3267,3522
Tennessee,Bradley County,13,5887,2796,3091
Tennessee,Bradley County,14,5514,2518,2996
Tennessee,Bradley County,15,4146,1883,2263
Tennessee,Bradley County,16,2981,1329,1652
Tennessee,Bradley County,17,1925,788,1137
Tennessee,Bradley County,18,1665,517,1148
Tennessee,Campbell County,0,39918,19442,20476
Tennessee,Campbell County,1,2092,1059,1033
Tennessee,Campbell County,2,2342,1214,1128
Tennessee,Campbell County,3,2506,1224,1282
Tennessee,Campbell County,4,2250,1178,1072
Tennessee,Campbell County,5,2393,1187,1206
Tennessee,Campbell County,6,2091,1036,1055
Tennessee,Campbell County,7,2134,1053,1081
Tennessee,Campbell County,8,2366,1181,1185
Tennessee,Campbell County,9,2771,1389,1382
Tennessee,Campbell County,10,2831,1425,1406
Tennessee,Campbell County,11,2883,1388,1495
Tennessee,Campbell County,12,2818,1372,1446
Tennessee,Campbell County,13,2742,1294,1448
Tennessee,Campbell County,14,2536,1189,1347
Tennessee,Campbell County,15,2092,985,1107
Tennessee,Campbell County,16,1452,683,769
Tennessee,Campbell County,17,921,363,558
Tennessee,Campbell County,18,698,222,476
Tennessee,Cannon County,0,13757,6846,6911
Tennessee,Cannon County,1,743,420,323
Tennessee,Cannon County,2,818,402,416
Tennessee,Cannon County,3,830,413,417
Tennessee,Cannon County,4,800,433,367
Tennessee,Cannon County,5,821,438,383
Tennessee,Cannon County,6,797,396,401
Tennessee,Cannon County,7,774,396,378
Tennessee,Cannon County,8,782,401,381
Tennessee,Cannon County,9,910,451,459
Tennessee,Cannon County,10,996,522,474
Tennessee,Cannon County,11,1084,560,524
Tennessee,Cannon County,12,992,453,539
Tennessee,Cannon County,13,918,436,482
Tennessee,Cannon County,14,782,384,398
Tennessee,Cannon County,15,634,302,332
Tennessee,Cannon County,16,473,222,251
Tennessee,Cannon County,17,307,124,183
Tennessee,Cannon County,18,296,93,203
Tennessee,Carroll County,0,28370,13793,14577
Tennessee,Carroll County,1,1707,899,808
Tennessee,Carroll County,2,1654,855,799
Tennessee,Carroll County,3,1690,864,826
Tennessee,Carroll County,4,1977,1034,943
Tennessee,Carroll County,5,1950,1028,922
Tennessee,Carroll County,6,1473,712,761
Tennessee,Carroll County,7,1424,711,713
Tennessee,Carroll County,8,1534,744,790
Tennessee,Carroll County,9,1692,813,879
Tennessee,Carroll County,10,1902,930,972
Tennessee,Carroll County,11,2026,1000,1026
Tennessee,Carroll County,12,1942,953,989
Tennessee,Carroll County,13,1817,835,982
Tennessee,Carroll County,14,1853,873,980
Tennessee,Carroll County,15,1359,608,751
Tennessee,Carroll County,16,986,443,543
Tennessee,Carroll County,17,709,287,422
Tennessee,Carroll County,18,675,204,471
Tennessee,Carter County,0,56886,27898,28988
Tennessee,Carter County,1,2805,1460,1345
Tennessee,Carter County,2,2989,1499,1490
Tennessee,Carter County,3,3101,1649,1452
Tennessee,Carter County,4,3205,1599,1606
Tennessee,Carter County,5,3650,1841,1809
Tennessee,Carter County,6,3545,1799,1746
Tennessee,Carter County,7,3093,1581,1512
Tennessee,Carter County,8,3094,1520,1574
Tennessee,Carter County,9,3817,1839,1978
Tennessee,Carter County,10,3975,2015,1960
Tennessee,Carter County,11,4199,2103,2096
Tennessee,Carter County,12,4264,2054,2210
Tennessee,Carter County,13,3924,1842,2082
Tennessee,Carter County,14,3682,1818,1864
Tennessee,Carter County,15,2911,1380,1531
Tennessee,Carter County,16,2047,915,1132
Tennessee,Carter County,17,1333,546,787
Tennessee,Carter County,18,1252,438,814
Tennessee,Cheatham County,0,39764,19788,19976
Tennessee,Cheatham County,1,2243,1179,1064
Tennessee,Cheatham County,2,2599,1301,1298
Tennessee,Cheatham County,3,2815,1408,1407
Tennessee,Cheatham County,4,2592,1367,1225
Tennessee,Cheatham County,5,2336,1219,1117
Tennessee,Cheatham County,6,2255,1153,1102
Tennessee,Cheatham County,7,2375,1119,1256
Tennessee,Cheatham County,8,2434,1200,1234
Tennessee,Cheatham County,9,2921,1499,1422
Tennessee,Cheatham County,10,3036,1488,1548
Tennessee,Cheatham County,11,3394,1715,1679
Tennessee,Cheatham County,12,2980,1460,1520
Tennessee,Cheatham County,13,2524,1236,1288
Tennessee,Cheatham County,14,2098,1048,1050
Tennessee,Cheatham County,15,1297,622,675
Tennessee,Cheatham County,16,905,425,480
Tennessee,Cheatham County,17,526,206,320
Tennessee,Cheatham County,18,434,143,291
Tennessee,Chester County,0,17379,8323,9056
Tennessee,Chester County,1,853,420,433
Tennessee,Chester County,2,1037,522,515
Tennessee,Chester County,3,1168,593,575
Tennessee,Chester County,4,1586,777,809
Tennessee,Chester County,5,1664,810,854
Tennessee,Chester County,6,942,454,488
Tennessee,Chester County,7,948,477,471
Tennessee,Chester County,8,983,439,544
Tennessee,Chester County,9,1069,532,537
Tennessee,Chester County,10,1005,485,520
Tennessee,Chester County,11,1148,562,586
Tennessee,Chester County,12,1100,540,560
Tennessee,Chester County,13,975,445,530
Tennessee,Chester County,14,930,445,485
Tennessee,Chester County,15,709,338,371
Tennessee,Chester County,16,502,212,290
Tennessee,Chester County,17,397,156,241
Tennessee,Chester County,18,363,116,247
Tennessee,Claiborne County,0,31592,15442,16150
Tennessee,Claiborne County,1,1486,735,751
Tennessee,Claiborne County,2,1688,851,837
Tennessee,Claiborne County,3,1848,962,886
Tennessee,Claiborne County,4,2018,990,1028
Tennessee,Claiborne County,5,2170,1097,1073
Tennessee,Claiborne County,6,1993,1036,957
Tennessee,Claiborne County,7,1669,841,828
Tennessee,Claiborne County,8,1829,908,921
Tennessee,Claiborne County,9,2081,983,1098
Tennessee,Claiborne County,10,2187,1102,1085
Tennessee,Claiborne County,11,2184,1049,1135
Tennessee,Claiborne County,12,2365,1174,1191
Tennessee,Claiborne County,13,2235,1066,1169
Tennessee,Claiborne County,14,2076,980,1096
Tennessee,Claiborne County,15,1521,756,765
Tennessee,Claiborne County,16,1061,498,563
Tennessee,Claiborne County,17,676,251,425
Tennessee,Claiborne County,18,505,163,342
Tennessee,Clay County,0,7765,3798,3967
Tennessee,Clay County,1,419,196,223
Tennessee,Clay County,2,488,247,241
Tennessee,Clay County,3,433,205,228
Tennessee,Clay County,4,378,189,189
Tennessee,Clay County,5,417,203,214
Tennessee,Clay County,6,337,149,188
Tennessee,Clay County,7,358,189,169
Tennessee,Clay County,8,398,211,187
Tennessee,Clay County,9,478,257,221
Tennessee,Clay County,10,561,272,289
Tennessee,Clay County,11,580,293,287
Tennessee,Clay County,12,540,261,279
Tennessee,Clay County,13,537,254,283
Tennessee,Clay County,14,569,261,308
Tennessee,Clay County,15,518,269,249
Tennessee,Clay County,16,356,167,189
Tennessee,Clay County,17,206,109,97
Tennessee,Clay County,18,192,66,126
Tennessee,Cocke County,0,35374,17129,18245
Tennessee,Cocke County,1,1857,955,902
Tennessee,Cocke County,2,2050,1053,997
Tennessee,Cocke County,3,2124,1086,1038
Tennessee,Cocke County,4,2035,1034,1001
Tennessee,Cocke County,5,2046,988,1058
Tennessee,Cocke County,6,1795,848,947
Tennessee,Cocke County,7,1782,875,907
Tennessee,Cocke County,8,2010,966,1044
Tennessee,Cocke County,9,2326,1147,1179
Tennessee,Cocke County,10,2418,1180,1238
Tennessee,Cocke County,11,2776,1333,1443
Tennessee,Cocke County,12,2775,1289,1486
Tennessee,Cocke County,13,2589,1224,1365
Tennessee,Cocke County,14,2402,1147,1255
Tennessee,Cocke County,15,1811,920,891
Tennessee,Cocke County,16,1199,541,658
Tennessee,Cocke County,17,811,343,468
Tennessee,Cocke County,18,568,200,368
Tennessee,Coffee County,0,53623,26167,27456
Tennessee,Coffee County,1,3210,1676,1534
Tennessee,Coffee County,2,3686,1904,1782
Tennessee,Coffee County,3,3696,1885,1811
Tennessee,Coffee County,4,3419,1787,1632
Tennessee,Coffee County,5,3306,1689,1617
Tennessee,Coffee County,6,3148,1527,1621
Tennessee,Coffee County,7,3189,1540,1649
Tennessee,Coffee County,8,3107,1554,1553
Tennessee,Coffee County,9,3367,1628,1739
Tennessee,Coffee County,10,3552,1765,1787
Tennessee,Coffee County,11,3977,1924,2053
Tennessee,Coffee County,12,3720,1844,1876
Tennessee,Coffee County,13,3195,1518,1677
Tennessee,Coffee County,14,2939,1392,1547
Tennessee,Coffee County,15,2262,996,1266
Tennessee,Coffee County,16,1713,740,973
Tennessee,Coffee County,17,1166,481,685
Tennessee,Coffee County,18,971,317,654
Tennessee,Crockett County,0,14668,7025,7643
Tennessee,Crockett County,1,855,428,427
Tennessee,Crockett County,2,1011,483,528
Tennessee,Crockett County,3,1084,523,561
Tennessee,Crockett County,4,931,460,471
Tennessee,Crockett County,5,883,459,424
Tennessee,Crockett County,6,853,402,451
Tennessee,Crockett County,7,899,425,474
Tennessee,Crockett County,8,820,415,405
Tennessee,Crockett County,9,901,431,470
Tennessee,Crockett County,10,895,465,430
Tennessee,Crockett County,11,1131,544,587
Tennessee,Crockett County,12,967,463,504
Tennessee,Crockett County,13,888,438,450
Tennessee,Crockett County,14,794,386,408
Tennessee,Crockett County,15,638,293,345
Tennessee,Crockett County,16,480,205,275
Tennessee,Crockett County,17,297,103,194
Tennessee,Crockett County,18,341,102,239
Tennessee,Cumberland County,0,57985,28250,29735
Tennessee,Cumberland County,1,2897,1433,1464
Tennessee,Cumberland County,2,2860,1517,1343
Tennessee,Cumberland County,3,2916,1461,1455
Tennessee,Cumberland County,4,2952,1549,1403
Tennessee,Cumberland County,5,2913,1475,1438
Tennessee,Cumberland County,6,2674,1351,1323
Tennessee,Cumberland County,7,2671,1307,1364
Tennessee,Cumberland County,8,2616,1263,1353
Tennessee,Cumberland County,9,3141,1610,1531
Tennessee,Cumberland County,10,3255,1598,1657
Tennessee,Cumberland County,11,3938,1863,2075
Tennessee,Cumberland County,12,4045,1870,2175
Tennessee,Cumberland County,13,4362,1973,2389
Tennessee,Cumberland County,14,5248,2446,2802
Tennessee,Cumberland County,15,4616,2272,2344
Tennessee,Cumberland County,16,3207,1573,1634
Tennessee,Cumberland County,17,2118,1043,1075
Tennessee,Cumberland County,18,1556,646,910
Tennessee,Davidson County,0,668347,321941,346406
Tennessee,Davidson County,1,46468,23086,23382
Tennessee,Davidson County,2,41584,21055,20529
Tennessee,Davidson County,3,35948,18191,17757
Tennessee,Davidson County,4,37668,19102,18566
Tennessee,Davidson County,5,51838,24722,27116
Tennessee,Davidson County,6,67259,31863,35396
Tennessee,Davidson County,7,60531,29862,30669
Tennessee,Davidson County,8,47850,24105,23745
Tennessee,Davidson County,9,44103,22220,21883
Tennessee,Davidson County,10,40378,20147,20231
Tennessee,Davidson County,11,43599,20824,22775
Tennessee,Davidson County,12,41642,19621,22021
Tennessee,Davidson County,13,35440,16523,18917
Tennessee,Davidson County,14,25897,11840,14057
Tennessee,Davidson County,15,16879,7390,9489
Tennessee,Davidson County,16,12367,4988,7379
Tennessee,Davidson County,17,9104,3382,5722
Tennessee,Davidson County,18,9792,3020,6772
Tennessee,Decatur County,0,11666,5725,5941
Tennessee,Decatur County,1,566,291,275
Tennessee,Decatur County,2,636,321,315
Tennessee,Decatur County,3,744,401,343
Tennessee,Decatur County,4,616,304,312
Tennessee,Decatur County,5,612,326,286
Tennessee,Decatur County,6,583,297,286
Tennessee,Decatur County,7,607,304,303
Tennessee,Decatur County,8,631,328,303
Tennessee,Decatur County,9,690,353,337
Tennessee,Decatur County,10,720,364,356
Tennessee,Decatur County,11,854,431,423
Tennessee,Decatur County,12,906,442,464
Tennessee,Decatur County,13,848,416,432
Tennessee,Decatur County,14,810,379,431
Tennessee,Decatur County,15,709,320,389
Tennessee,Decatur County,16,457,223,234
Tennessee,Decatur County,17,333,132,201
Tennessee,Decatur County,18,344,93,251
Tennessee,DeKalb County,0,19268,9563,9705
Tennessee,DeKalb County,1,1121,597,524
Tennessee,DeKalb County,2,1256,645,611
Tennessee,DeKalb County,3,1212,634,578
Tennessee,DeKalb County,4,1153,601,552
Tennessee,DeKalb County,5,1113,604,509
Tennessee,DeKalb County,6,1149,601,548
Tennessee,DeKalb County,7,1126,572,554
Tennessee,DeKalb County,8,1092,542,550
Tennessee,DeKalb County,9,1247,629,618
Tennessee,DeKalb County,10,1295,661,634
Tennessee,DeKalb County,11,1436,708,728
Tennessee,DeKalb County,12,1381,658,723
Tennessee,DeKalb County,13,1321,640,681
Tennessee,DeKalb County,14,1181,578,603
Tennessee,DeKalb County,15,884,404,480
Tennessee,DeKalb County,16,587,247,340
Tennessee,DeKalb County,17,360,137,223
Tennessee,DeKalb County,18,354,105,249
Tennessee,Dickson County,0,50575,24901,25674
Tennessee,Dickson County,1,2961,1558,1403
Tennessee,Dickson County,2,3282,1672,1610
Tennessee,Dickson County,3,3473,1832,1641
Tennessee,Dickson County,4,3236,1733,1503
Tennessee,Dickson County,5,2984,1534,1450
Tennessee,Dickson County,6,3098,1525,1573
Tennessee,Dickson County,7,3068,1495,1573
Tennessee,Dickson County,8,3124,1513,1611
Tennessee,Dickson County,9,3461,1728,1733
Tennessee,Dickson County,10,3630,1791,1839
Tennessee,Dickson County,11,3874,1867,2007
Tennessee,Dickson County,12,3699,1767,1932
Tennessee,Dickson County,13,3059,1458,1601
Tennessee,Dickson County,14,2552,1247,1305
Tennessee,Dickson County,15,1969,923,1046
Tennessee,Dickson County,16,1383,629,754
Tennessee,Dickson County,17,921,373,548
Tennessee,Dickson County,18,801,256,545
Tennessee,Dyer County,0,37935,18304,19631
Tennessee,Dyer County,1,2484,1246,1238
Tennessee,Dyer County,2,2481,1263,1218
Tennessee,Dyer County,3,2632,1373,1259
Tennessee,Dyer County,4,2420,1249,1171
Tennessee,Dyer County,5,2398,1200,1198
Tennessee,Dyer County,6,2198,1038,1160
Tennessee,Dyer County,7,2177,1019,1158
Tennessee,Dyer County,8,2270,1086,1184
Tennessee,Dyer County,9,2440,1176,1264
Tennessee,Dyer County,10,2574,1268,1306
Tennessee,Dyer County,11,2738,1350,1388
Tennessee,Dyer County,12,2590,1286,1304
Tennessee,Dyer County,13,2260,1071,1189
Tennessee,Dyer County,14,2212,1009,1203
Tennessee,Dyer County,15,1525,697,828
Tennessee,Dyer County,16,1122,499,623
Tennessee,Dyer County,17,721,257,464
Tennessee,Dyer County,18,693,217,476
Tennessee,Fayette County,0,39011,19309,19702
Tennessee,Fayette County,1,2089,1044,1045
Tennessee,Fayette County,2,2234,1171,1063
Tennessee,Fayette County,3,2339,1213,1126
Tennessee,Fayette County,4,2199,1188,1011
Tennessee,Fayette County,5,2013,988,1025
Tennessee,Fayette County,6,1962,992,970
Tennessee,Fayette County,7,2225,1085,1140
Tennessee,Fayette County,8,2203,1082,1121
Tennessee,Fayette County,9,2472,1236,1236
Tennessee,Fayette County,10,2525,1237,1288
Tennessee,Fayette County,11,3182,1560,1622
Tennessee,Fayette County,12,3275,1609,1666
Tennessee,Fayette County,13,2991,1448,1543
Tennessee,Fayette County,14,2639,1347,1292
Tennessee,Fayette County,15,1891,916,975
Tennessee,Fayette County,16,1295,584,711
Tennessee,Fayette County,17,799,349,450
Tennessee,Fayette County,18,678,260,418
Tennessee,Fentress County,0,17855,8743,9112
Tennessee,Fentress County,1,884,434,450
Tennessee,Fentress County,2,1037,521,516
Tennessee,Fentress County,3,1187,622,565
Tennessee,Fentress County,4,1192,650,542
Tennessee,Fentress County,5,935,467,468
Tennessee,Fentress County,6,872,434,438
Tennessee,Fentress County,7,880,435,445
Tennessee,Fentress County,8,933,448,485
Tennessee,Fentress County,9,1182,575,607
Tennessee,Fentress County,10,1234,610,624
Tennessee,Fentress County,11,1300,630,670
Tennessee,Fentress County,12,1318,642,676
Tennessee,Fentress County,13,1327,627,700
Tennessee,Fentress County,14,1291,600,691
Tennessee,Fentress County,15,978,496,482
Tennessee,Fentress County,16,633,290,343
Tennessee,Fentress County,17,370,165,205
Tennessee,Fentress County,18,302,97,205
Tennessee,Franklin County,0,41402,20201,21201
Tennessee,Franklin County,1,2019,989,1030
Tennessee,Franklin County,2,2299,1167,1132
Tennessee,Franklin County,3,2737,1418,1319
Tennessee,Franklin County,4,2985,1520,1465
Tennessee,Franklin County,5,3240,1584,1656
Tennessee,Franklin County,6,1994,1018,976
Tennessee,Franklin County,7,2091,1051,1040
Tennessee,Franklin County,8,2262,1117,1145
Tennessee,Franklin County,9,2596,1285,1311
Tennessee,Franklin County,10,2458,1216,1242
Tennessee,Franklin County,11,3012,1479,1533
Tennessee,Franklin County,12,3021,1454,1567
Tennessee,Franklin County,13,2824,1339,1485
Tennessee,Franklin County,14,2528,1216,1312
Tennessee,Franklin County,15,2058,974,1084
Tennessee,Franklin County,16,1426,666,760
Tennessee,Franklin County,17,1022,435,587
Tennessee,Franklin County,18,830,273,557
Tennessee,Gibson County,0,49472,23603,25869
Tennessee,Gibson County,1,3143,1559,1584
Tennessee,Gibson County,2,3279,1684,1595
Tennessee,Gibson County,3,3530,1739,1791
Tennessee,Gibson County,4,3188,1680,1508
Tennessee,Gibson County,5,2867,1403,1464
Tennessee,Gibson County,6,2706,1298,1408
Tennessee,Gibson County,7,3014,1435,1579
Tennessee,Gibson County,8,2988,1440,1548
Tennessee,Gibson County,9,3192,1508,1684
Tennessee,Gibson County,10,3097,1507,1590
Tennessee,Gibson County,11,3546,1710,1836
Tennessee,Gibson County,12,3300,1595,1705
Tennessee,Gibson County,13,2927,1372,1555
Tennessee,Gibson County,14,2706,1250,1456
Tennessee,Gibson County,15,2014,896,1118
Tennessee,Gibson County,16,1578,663,915
Tennessee,Gibson County,17,1193,477,716
Tennessee,Gibson County,18,1204,387,817
Tennessee,Giles County,0,28853,14035,14818
Tennessee,Giles County,1,1527,792,735
Tennessee,Giles County,2,1686,831,855
Tennessee,Giles County,3,1740,883,857
Tennessee,Giles County,4,1768,907,861
Tennessee,Giles County,5,1811,912,899
Tennessee,Giles County,6,1609,775,834
Tennessee,Giles County,7,1504,750,754
Tennessee,Giles County,8,1534,761,773
Tennessee,Giles County,9,1805,869,936
Tennessee,Giles County,10,1893,911,982
Tennessee,Giles County,11,2324,1145,1179
Tennessee,Giles County,12,2187,1119,1068
Tennessee,Giles County,13,1999,943,1056
Tennessee,Giles County,14,1819,913,906
Tennessee,Giles County,15,1415,621,794
Tennessee,Giles County,16,961,451,510
Tennessee,Giles County,17,630,280,350
Tennessee,Giles County,18,641,172,469
Tennessee,Grainger County,0,22864,11479,11385
Tennessee,Grainger County,1,1127,596,531
Tennessee,Grainger County,2,1366,743,623
Tennessee,Grainger County,3,1450,757,693
Tennessee,Grainger County,4,1384,750,634
Tennessee,Grainger County,5,1263,649,614
Tennessee,Grainger County,6,1185,606,579
Tennessee,Grainger County,7,1129,542,587
Tennessee,Grainger County,8,1323,660,663
Tennessee,Grainger County,9,1626,825,801
Tennessee,Grainger County,10,1779,886,893
Tennessee,Grainger County,11,1712,843,869
Tennessee,Grainger County,12,1712,842,870
Tennessee,Grainger County,13,1589,771,818
Tennessee,Grainger County,14,1567,787,780
Tennessee,Grainger County,15,1147,559,588
Tennessee,Grainger County,16,755,365,390
Tennessee,Grainger County,17,430,186,244
Tennessee,Grainger County,18,320,112,208
Tennessee,Greene County,0,68335,33549,34786
Tennessee,Greene County,1,3181,1694,1487
Tennessee,Greene County,2,3843,1984,1859
Tennessee,Greene County,3,4042,2087,1955
Tennessee,Greene County,4,4280,2221,2059
Tennessee,Greene County,5,4100,2148,1952
Tennessee,Greene County,6,3499,1733,1766
Tennessee,Greene County,7,3570,1792,1778
Tennessee,Greene County,8,3886,1905,1981
Tennessee,Greene County,9,4578,2288,2290
Tennessee,Greene County,10,4743,2326,2417
Tennessee,Greene County,11,5107,2488,2619
Tennessee,Greene County,12,5146,2458,2688
Tennessee,Greene County,13,4677,2226,2451
Tennessee,Greene County,14,4705,2251,2454
Tennessee,Greene County,15,3493,1648,1845
Tennessee,Greene County,16,2584,1215,1369
Tennessee,Greene County,17,1623,680,943
Tennessee,Greene County,18,1278,405,873
Tennessee,Grundy County,0,13425,6643,6782
Tennessee,Grundy County,1,692,371,321
Tennessee,Grundy County,2,785,417,368
Tennessee,Grundy County,3,903,484,419
Tennessee,Grundy County,4,807,426,381
Tennessee,Grundy County,5,769,391,378
Tennessee,Grundy County,6,700,332,368
Tennessee,Grundy County,7,739,358,381
Tennessee,Grundy County,8,775,382,393
Tennessee,Grundy County,9,871,448,423
Tennessee,Grundy County,10,857,440,417
Tennessee,Grundy County,11,935,495,440
Tennessee,Grundy County,12,963,471,492
Tennessee,Grundy County,13,852,394,458
Tennessee,Grundy County,14,971,449,522
Tennessee,Grundy County,15,728,352,376
Tennessee,Grundy County,16,521,220,301
Tennessee,Grundy County,17,311,134,177
Tennessee,Grundy County,18,246,79,167
Tennessee,Hamblen County,0,63036,30730,32306
Tennessee,Hamblen County,1,3915,1983,1932
Tennessee,Hamblen County,2,4124,2042,2082
Tennessee,Hamblen County,3,4233,2101,2132
Tennessee,Hamblen County,4,3787,1996,1791
Tennessee,Hamblen County,5,3801,1977,1824
Tennessee,Hamblen County,6,3556,1817,1739
Tennessee,Hamblen County,7,3619,1794,1825
Tennessee,Hamblen County,8,3807,1866,1941
Tennessee,Hamblen County,9,4375,2172,2203
Tennessee,Hamblen County,10,4281,2152,2129
Tennessee,Hamblen County,11,4591,2251,2340
Tennessee,Hamblen County,12,4128,2010,2118
Tennessee,Hamblen County,13,3709,1725,1984
Tennessee,Hamblen County,14,3717,1732,1985
Tennessee,Hamblen County,15,2819,1303,1516
Tennessee,Hamblen County,16,2044,910,1134
Tennessee,Hamblen County,17,1369,548,821
Tennessee,Hamblen County,18,1161,351,810
Tennessee,Hamilton County,0,351220,169374,181846
Tennessee,Hamilton County,1,20732,10697,10035
Tennessee,Hamilton County,2,21076,10715,10361
Tennessee,Hamilton County,3,20444,10425,10019
Tennessee,Hamilton County,4,21383,10429,10954
Tennessee,Hamilton County,5,24636,12354,12282
Tennessee,Hamilton County,6,24659,12159,12500
Tennessee,Hamilton County,7,23089,11409,11680
Tennessee,Hamilton County,8,21473,10624,10849
Tennessee,Hamilton County,9,22815,11256,11559
Tennessee,Hamilton County,10,22502,11008,11494
Tennessee,Hamilton County,11,24706,11948,12758
Tennessee,Hamilton County,12,24976,11770,13206
Tennessee,Hamilton County,13,22530,10643,11887
Tennessee,Hamilton County,14,18875,8942,9933
Tennessee,Hamilton County,15,13115,5921,7194
Tennessee,Hamilton County,16,9367,3921,5446
Tennessee,Hamilton County,17,7293,2819,4474
Tennessee,Hamilton County,18,7549,2334,5215
Tennessee,Hancock County,0,6657,3294,3363
Tennessee,Hancock County,1,371,191,180
Tennessee,Hancock County,2,386,210,176
Tennessee,Hancock County,3,415,222,193
Tennessee,Hancock County,4,366,191,175
Tennessee,Hancock County,5,380,188,192
Tennessee,Hancock County,6,358,173,185
Tennessee,Hancock County,7,382,191,191
Tennessee,Hancock County,8,395,205,190
Tennessee,Hancock County,9,412,203,209
Tennessee,Hancock County,10,421,214,207
Tennessee,Hancock County,11,485,230,255
Tennessee,Hancock County,12,540,268,272
Tennessee,Hancock County,13,517,256,261
Tennessee,Hancock County,14,427,209,218
Tennessee,Hancock County,15,304,156,148
Tennessee,Hancock County,16,221,79,142
Tennessee,Hancock County,17,157,60,97
Tennessee,Hancock County,18,120,48,72
Tennessee,Hardeman County,0,25965,14128,11837
Tennessee,Hardeman County,1,1263,614,649
Tennessee,Hardeman County,2,1449,734,715
Tennessee,Hardeman County,3,1540,762,778
Tennessee,Hardeman County,4,1458,745,713
Tennessee,Hardeman County,5,1825,1169,656
Tennessee,Hardeman County,6,1863,1222,641
Tennessee,Hardeman County,7,1833,1177,656
Tennessee,Hardeman County,8,1729,1025,704
Tennessee,Hardeman County,9,1625,989,636
Tennessee,Hardeman County,10,1817,1056,761
Tennessee,Hardeman County,11,1914,1008,906
Tennessee,Hardeman County,12,1759,891,868
Tennessee,Hardeman County,13,1654,838,816
Tennessee,Hardeman County,14,1485,719,766
Tennessee,Hardeman County,15,1052,509,543
Tennessee,Hardeman County,16,754,342,412
Tennessee,Hardeman County,17,514,189,325
Tennessee,Hardeman County,18,431,139,292
Tennessee,Hardin County,0,25870,12518,13352
Tennessee,Hardin County,1,1345,673,672
Tennessee,Hardin County,2,1465,724,741
Tennessee,Hardin County,3,1573,780,793
Tennessee,Hardin County,4,1522,780,742
Tennessee,Hardin County,5,1500,768,732
Tennessee,Hardin County,6,1273,630,643
Tennessee,Hardin County,7,1297,623,674
Tennessee,Hardin County,8,1430,710,720
Tennessee,Hardin County,9,1585,766,819
Tennessee,Hardin County,10,1738,864,874
Tennessee,Hardin County,11,1866,917,949
Tennessee,Hardin County,12,1968,946,1022
Tennessee,Hardin County,13,1878,913,965
Tennessee,Hardin County,14,1811,873,938
Tennessee,Hardin County,15,1341,639,702
Tennessee,Hardin County,16,969,453,516
Tennessee,Hardin County,17,702,280,422
Tennessee,Hardin County,18,607,179,428
Tennessee,Hawkins County,0,56735,27877,28858
Tennessee,Hawkins County,1,2903,1524,1379
Tennessee,Hawkins County,2,3254,1678,1576
Tennessee,Hawkins County,3,3629,1826,1803
Tennessee,Hawkins County,4,3305,1702,1603
Tennessee,Hawkins County,5,3194,1598,1596
Tennessee,Hawkins County,6,2898,1442,1456
Tennessee,Hawkins County,7,2980,1491,1489
Tennessee,Hawkins County,8,3133,1566,1567
Tennessee,Hawkins County,9,3960,1941,2019
Tennessee,Hawkins County,10,4141,2057,2084
Tennessee,Hawkins County,11,4264,2100,2164
Tennessee,Hawkins County,12,4105,1977,2128
Tennessee,Hawkins County,13,4051,1962,2089
Tennessee,Hawkins County,14,3829,1826,2003
Tennessee,Hawkins County,15,2917,1433,1484
Tennessee,Hawkins County,16,1911,876,1035
Tennessee,Hawkins County,17,1219,500,719
Tennessee,Hawkins County,18,1042,378,664
Tennessee,Haywood County,0,18185,8447,9738
Tennessee,Haywood County,1,1057,517,540
Tennessee,Haywood County,2,1221,613,608
Tennessee,Haywood County,3,1283,619,664
Tennessee,Haywood County,4,1168,595,573
Tennessee,Haywood County,5,1166,580,586
Tennessee,Haywood County,6,1020,481,539
Tennessee,Haywood County,7,1036,485,551
Tennessee,Haywood County,8,1042,452,590
Tennessee,Haywood County,9,1037,482,555
Tennessee,Haywood County,10,1175,543,632
Tennessee,Haywood County,11,1343,624,719
Tennessee,Haywood County,12,1407,624,783
Tennessee,Haywood County,13,1311,628,683
Tennessee,Haywood County,14,980,474,506
Tennessee,Haywood County,15,707,301,406
Tennessee,Haywood County,16,495,191,304
Tennessee,Haywood County,17,350,132,218
Tennessee,Haywood County,18,387,106,281
Tennessee,Henderson County,0,28009,13582,14427
Tennessee,Henderson County,1,1648,853,795
Tennessee,Henderson County,2,1893,951,942
Tennessee,Henderson County,3,1850,928,922
Tennessee,Henderson County,4,1757,916,841
Tennessee,Henderson County,5,1640,835,805
Tennessee,Henderson County,6,1629,807,822
Tennessee,Henderson County,7,1698,834,864
Tennessee,Henderson County,8,1726,836,890
Tennessee,Henderson County,9,1795,849,946
Tennessee,Henderson County,10,1939,939,1000
Tennessee,Henderson County,11,2073,1020,1053
Tennessee,Henderson County,12,1898,919,979
Tennessee,Henderson County,13,1750,852,898
Tennessee,Henderson County,14,1675,768,907
Tennessee,Henderson County,15,1211,551,660
Tennessee,Henderson County,16,799,354,445
Tennessee,Henderson County,17,573,214,359
Tennessee,Henderson County,18,455,156,299
Tennessee,Henry County,0,32204,15609,16595
Tennessee,Henry County,1,1609,794,815
Tennessee,Henry County,2,1995,997,998
Tennessee,Henry County,3,1955,989,966
Tennessee,Henry County,4,1820,1013,807
Tennessee,Henry County,5,1681,833,848
Tennessee,Henry County,6,1663,820,843
Tennessee,Henry County,7,1688,803,885
Tennessee,Henry County,8,1722,868,854
Tennessee,Henry County,9,1936,948,988
Tennessee,Henry County,10,2083,1003,1080
Tennessee,Henry County,11,2339,1139,1200
Tennessee,Henry County,12,2370,1164,1206
Tennessee,Henry County,13,2384,1095,1289
Tennessee,Henry County,14,2267,1101,1166
Tennessee,Henry County,15,1848,862,986
Tennessee,Henry County,16,1296,599,697
Tennessee,Henry County,17,841,353,488
Tennessee,Henry County,18,707,228,479
Tennessee,Hickman County,0,24384,12802,11582
Tennessee,Hickman County,1,1335,719,616
Tennessee,Hickman County,2,1438,750,688
Tennessee,Hickman County,3,1537,828,709
Tennessee,Hickman County,4,1509,788,721
Tennessee,Hickman County,5,1522,860,662
Tennessee,Hickman County,6,1577,887,690
Tennessee,Hickman County,7,1507,857,650
Tennessee,Hickman County,8,1519,837,682
Tennessee,Hickman County,9,1639,855,784
Tennessee,Hickman County,10,1802,981,821
Tennessee,Hickman County,11,1887,1033,854
Tennessee,Hickman County,12,1732,906,826
Tennessee,Hickman County,13,1575,732,843
Tennessee,Hickman County,14,1307,641,666
Tennessee,Hickman County,15,977,478,499
Tennessee,Hickman County,16,737,333,404
Tennessee,Hickman County,17,431,187,244
Tennessee,Hickman County,18,353,130,223
Tennessee,Houston County,0,8267,4038,4229
Tennessee,Houston County,1,415,193,222
Tennessee,Houston County,2,466,238,228
Tennessee,Houston County,3,581,306,275
Tennessee,Houston County,4,519,270,249
Tennessee,Houston County,5,505,265,240
Tennessee,Houston County,6,428,202,226
Tennessee,Houston County,7,453,216,237
Tennessee,Houston County,8,460,232,228
Tennessee,Houston County,9,533,256,277
Tennessee,Houston County,10,546,271,275
Tennessee,Houston County,11,573,284,289
Tennessee,Houston County,12,595,292,303
Tennessee,Houston County,13,583,273,310
Tennessee,Houston County,14,531,255,276
Tennessee,Houston County,15,420,218,202
Tennessee,Houston County,16,290,124,166
Tennessee,Houston County,17,200,81,119
Tennessee,Houston County,18,169,62,107
Tennessee,Humphreys County,0,18135,8996,9139
Tennessee,Humphreys County,1,1063,574,489
Tennessee,Humphreys County,2,1060,550,510
Tennessee,Humphreys County,3,1112,554,558
Tennessee,Humphreys County,4,1130,616,514
Tennessee,Humphreys County,5,1083,546,537
Tennessee,Humphreys County,6,910,462,448
Tennessee,Humphreys County,7,970,462,508
Tennessee,Humphreys County,8,1033,520,513
Tennessee,Humphreys County,9,1196,592,604
Tennessee,Humphreys County,10,1191,591,600
Tennessee,Humphreys County,11,1327,656,671
Tennessee,Humphreys County,12,1372,672,700
Tennessee,Humphreys County,13,1245,602,643
Tennessee,Humphreys County,14,1124,539,585
Tennessee,Humphreys County,15,912,460,452
Tennessee,Humphreys County,16,663,307,356
Tennessee,Humphreys County,17,404,173,231
Tennessee,Humphreys County,18,340,120,220
Tennessee,Jackson County,0,11568,5792,5776
Tennessee,Jackson County,1,568,301,267
Tennessee,Jackson County,2,586,327,259
Tennessee,Jackson County,3,627,340,287
Tennessee,Jackson County,4,665,324,341
Tennessee,Jackson County,5,659,348,311
Tennessee,Jackson County,6,573,297,276
Tennessee,Jackson County,7,550,253,297
Tennessee,Jackson County,8,617,325,292
Tennessee,Jackson County,9,752,364,388
Tennessee,Jackson County,10,807,408,399
Tennessee,Jackson County,11,861,417,444
Tennessee,Jackson County,12,1003,503,500
Tennessee,Jackson County,13,892,447,445
Tennessee,Jackson County,14,883,452,431
Tennessee,Jackson County,15,642,307,335
Tennessee,Jackson County,16,419,180,239
Tennessee,Jackson County,17,250,108,142
Tennessee,Jackson County,18,214,91,123
Tennessee,Jefferson County,0,52677,25846,26831
Tennessee,Jefferson County,1,2729,1321,1408
Tennessee,Jefferson County,2,3010,1595,1415
Tennessee,Jefferson County,3,3158,1590,1568
Tennessee,Jefferson County,4,3558,1841,1717
Tennessee,Jefferson County,5,3459,1757,1702
Tennessee,Jefferson County,6,2822,1363,1459
Tennessee,Jefferson County,7,2819,1417,1402
Tennessee,Jefferson County,8,2846,1423,1423
Tennessee,Jefferson County,9,3386,1672,1714
Tennessee,Jefferson County,10,3695,1837,1858
Tennessee,Jefferson County,11,3972,1960,2012
Tennessee,Jefferson County,12,3724,1854,1870
Tennessee,Jefferson County,13,3456,1620,1836
Tennessee,Jefferson County,14,3396,1587,1809
Tennessee,Jefferson County,15,2789,1353,1436
Tennessee,Jefferson County,16,1802,861,941
Tennessee,Jefferson County,17,1126,503,623
Tennessee,Jefferson County,18,930,292,638
Tennessee,Johnson County,0,17859,9552,8307
Tennessee,Johnson County,1,761,369,392
Tennessee,Johnson County,2,875,447,428
Tennessee,Johnson County,3,893,467,426
Tennessee,Johnson County,4,923,486,437
Tennessee,Johnson County,5,1039,638,401
Tennessee,Johnson County,6,990,587,403
Tennessee,Johnson County,7,1147,740,407
Tennessee,Johnson County,8,1045,580,465
Tennessee,Johnson County,9,1330,824,506
Tennessee,Johnson County,10,1399,846,553
Tennessee,Johnson County,11,1273,668,605
Tennessee,Johnson County,12,1254,605,649
Tennessee,Johnson County,13,1262,607,655
Tennessee,Johnson County,14,1319,647,672
Tennessee,Johnson County,15,950,472,478
Tennessee,Johnson County,16,664,306,358
Tennessee,Johnson County,17,385,154,231
Tennessee,Johnson County,18,350,109,241
Tennessee,Knox County,0,448644,217980,230664
Tennessee,Knox County,1,26175,13276,12899
Tennessee,Knox County,2,26826,13797,13029
Tennessee,Knox County,3,26944,13771,13173
Tennessee,Knox County,4,30143,15426,14717
Tennessee,Knox County,5,41288,20876,20412
Tennessee,Knox County,6,29385,14372,15013
Tennessee,Knox County,7,30409,14925,15484
Tennessee,Knox County,8,27630,13656,13974
Tennessee,Knox County,9,29050,14341,14709
Tennessee,Knox County,10,28795,14073,14722
Tennessee,Knox County,11,31237,15233,16004
Tennessee,Knox County,12,29620,14249,15371
Tennessee,Knox County,13,26179,12224,13955
Tennessee,Knox County,14,22015,10283,11732
Tennessee,Knox County,15,15635,6997,8638
Tennessee,Knox County,16,11137,4853,6284
Tennessee,Knox County,17,7957,3017,4940
Tennessee,Knox County,18,8219,2611,5608
Tennessee,Lake County,0,7631,4873,2758
Tennessee,Lake County,1,341,158,183
Tennessee,Lake County,2,322,161,161
Tennessee,Lake County,3,314,188,126
Tennessee,Lake County,4,374,260,114
Tennessee,Lake County,5,662,522,140
Tennessee,Lake County,6,691,542,149
Tennessee,Lake County,7,647,483,164
Tennessee,Lake County,8,588,429,159
Tennessee,Lake County,9,573,402,171
Tennessee,Lake County,10,547,356,191
Tennessee,Lake County,11,506,330,176
Tennessee,Lake County,12,527,306,221
Tennessee,Lake County,13,417,226,191
Tennessee,Lake County,14,393,212,181
Tennessee,Lake County,15,240,125,115
Tennessee,Lake County,16,194,80,114
Tennessee,Lake County,17,162,61,101
Tennessee,Lake County,18,133,32,101
Tennessee,Lauderdale County,0,27382,14308,13074
Tennessee,Lauderdale County,1,1524,739,785
Tennessee,Lauderdale County,2,1823,916,907
Tennessee,Lauderdale County,3,1879,973,906
Tennessee,Lauderdale County,4,1724,900,824
Tennessee,Lauderdale County,5,1955,1186,769
Tennessee,Lauderdale County,6,1914,1128,786
Tennessee,Lauderdale County,7,2021,1203,818
Tennessee,Lauderdale County,8,1845,1038,807
Tennessee,Lauderdale County,9,1770,955,815
Tennessee,Lauderdale County,10,1876,1046,830
Tennessee,Lauderdale County,11,1956,979,977
Tennessee,Lauderdale County,12,1781,877,904
Tennessee,Lauderdale County,13,1546,706,840
Tennessee,Lauderdale County,14,1313,629,684
Tennessee,Lauderdale County,15,984,484,500
Tennessee,Lauderdale County,16,665,270,395
Tennessee,Lauderdale County,17,398,160,238
Tennessee,Lauderdale County,18,408,119,289
Tennessee,Lawrence County,0,42274,20716,21558
Tennessee,Lawrence County,1,2860,1490,1370
Tennessee,Lawrence County,2,2881,1490,1391
Tennessee,Lawrence County,3,3051,1543,1508
Tennessee,Lawrence County,4,2606,1368,1238
Tennessee,Lawrence County,5,2571,1272,1299
Tennessee,Lawrence County,6,2387,1171,1216
Tennessee,Lawrence County,7,2377,1189,1188
Tennessee,Lawrence County,8,2343,1128,1215
Tennessee,Lawrence County,9,2650,1317,1333
Tennessee,Lawrence County,10,2830,1416,1414
Tennessee,Lawrence County,11,2939,1467,1472
Tennessee,Lawrence County,12,2811,1329,1482
Tennessee,Lawrence County,13,2566,1242,1324
Tennessee,Lawrence County,14,2357,1178,1179
Tennessee,Lawrence County,15,1922,884,1038
Tennessee,Lawrence County,16,1369,606,763
Tennessee,Lawrence County,17,949,398,551
Tennessee,Lawrence County,18,805,228,577
Tennessee,Lewis County,0,11906,5827,6079
Tennessee,Lewis County,1,696,339,357
Tennessee,Lewis County,2,697,361,336
Tennessee,Lewis County,3,757,404,353
Tennessee,Lewis County,4,742,389,353
Tennessee,Lewis County,5,654,339,315
Tennessee,Lewis County,6,617,291,326
Tennessee,Lewis County,7,619,303,316
Tennessee,Lewis County,8,698,354,344
Tennessee,Lewis County,9,775,385,390
Tennessee,Lewis County,10,690,331,359
Tennessee,Lewis County,11,892,462,430
Tennessee,Lewis County,12,960,456,504
Tennessee,Lewis County,13,879,424,455
Tennessee,Lewis County,14,758,372,386
Tennessee,Lewis County,15,578,265,313
Tennessee,Lewis County,16,370,168,202
Tennessee,Lewis County,17,297,119,178
Tennessee,Lewis County,18,227,65,162
Tennessee,Lincoln County,0,33637,16464,17173
Tennessee,Lincoln County,1,1897,997,900
Tennessee,Lincoln County,2,2210,1080,1130
Tennessee,Lincoln County,3,2089,1108,981
Tennessee,Lincoln County,4,2074,1076,998
Tennessee,Lincoln County,5,1920,1000,920
Tennessee,Lincoln County,6,1791,921,870
Tennessee,Lincoln County,7,1869,913,956
Tennessee,Lincoln County,8,1788,911,877
Tennessee,Lincoln County,9,2098,991,1107
Tennessee,Lincoln County,10,2246,1115,1131
Tennessee,Lincoln County,11,2628,1338,1290
Tennessee,Lincoln County,12,2603,1269,1334
Tennessee,Lincoln County,13,2232,1091,1141
Tennessee,Lincoln County,14,1997,906,1091
Tennessee,Lincoln County,15,1549,694,855
Tennessee,Lincoln County,16,1224,522,702
Tennessee,Lincoln County,17,783,329,454
Tennessee,Lincoln County,18,639,203,436
Tennessee,Loudon County,0,50771,24851,25920
Tennessee,Loudon County,1,2667,1392,1275
Tennessee,Loudon County,2,2755,1401,1354
Tennessee,Loudon County,3,2860,1496,1364
Tennessee,Loudon County,4,2728,1385,1343
Tennessee,Loudon County,5,2553,1308,1245
Tennessee,Loudon County,6,2493,1265,1228
Tennessee,Loudon County,7,2481,1228,1253
Tennessee,Loudon County,8,2555,1247,1308
Tennessee,Loudon County,9,3040,1483,1557
Tennessee,Loudon County,10,3093,1529,1564
Tennessee,Loudon County,11,3465,1708,1757
Tennessee,Loudon County,12,3823,1819,2004
Tennessee,Loudon County,13,3803,1810,1993
Tennessee,Loudon County,14,4182,2002,2180
Tennessee,Loudon County,15,3447,1677,1770
Tennessee,Loudon County,16,2283,1110,1173
Tennessee,Loudon County,17,1340,594,746
Tennessee,Loudon County,18,1203,397,806
Tennessee,McMinn County,0,52626,25636,26990
Tennessee,McMinn County,1,2948,1552,1396
Tennessee,McMinn County,2,3064,1559,1505
Tennessee,McMinn County,3,3355,1711,1644
Tennessee,McMinn County,4,3256,1661,1595
Tennessee,McMinn County,5,3333,1644,1689
Tennessee,McMinn County,6,2820,1376,1444
Tennessee,McMinn County,7,2822,1344,1478
Tennessee,McMinn County,8,2967,1436,1531
Tennessee,McMinn County,9,3398,1696,1702
Tennessee,McMinn County,10,3612,1782,1830
Tennessee,McMinn County,11,3885,1882,2003
Tennessee,McMinn County,12,3884,1909,1975
Tennessee,McMinn County,13,3453,1663,1790
Tennessee,McMinn County,14,3187,1557,1630
Tennessee,McMinn County,15,2588,1202,1386
Tennessee,McMinn County,16,1831,816,1015
Tennessee,McMinn County,17,1174,497,677
Tennessee,McMinn County,18,1049,349,700
Tennessee,McNairy County,0,26267,12889,13378
Tennessee,McNairy County,1,1543,796,747
Tennessee,McNairy County,2,1572,797,775
Tennessee,McNairy County,3,1791,940,851
Tennessee,McNairy County,4,1579,850,729
Tennessee,McNairy County,5,1552,762,790
Tennessee,McNairy County,6,1287,655,632
Tennessee,McNairy County,7,1464,718,746
Tennessee,McNairy County,8,1548,771,777
Tennessee,McNairy County,9,1656,813,843
Tennessee,McNairy County,10,1708,821,887
Tennessee,McNairy County,11,1864,944,920
Tennessee,McNairy County,12,1857,877,980
Tennessee,McNairy County,13,1745,833,912
Tennessee,McNairy County,14,1724,846,878
Tennessee,McNairy County,15,1327,603,724
Tennessee,McNairy County,16,946,444,502
Tennessee,McNairy County,17,613,279,334
Tennessee,McNairy County,18,491,140,351
Tennessee,Macon County,0,23003,11191,11812
Tennessee,Macon County,1,1611,772,839
Tennessee,Macon County,2,1514,784,730
Tennessee,Macon County,3,1525,745,780
Tennessee,Macon County,4,1534,782,752
Tennessee,Macon County,5,1474,702,772
Tennessee,Macon County,6,1419,696,723
Tennessee,Macon County,7,1311,654,657
Tennessee,Macon County,8,1333,651,682
Tennessee,Macon County,9,1547,772,775
Tennessee,Macon County,10,1635,832,803
Tennessee,Macon County,11,1659,840,819
Tennessee,Macon County,12,1491,716,775
Tennessee,Macon County,13,1387,660,727
Tennessee,Macon County,14,1252,624,628
Tennessee,Macon County,15,939,418,521
Tennessee,Macon County,16,591,247,344
Tennessee,Macon County,17,446,176,270
Tennessee,Macon County,18,335,120,215
Tennessee,Madison County,0,98178,46369,51809
Tennessee,Madison County,1,6499,3257,3242
Tennessee,Madison County,2,6256,3103,3153
Tennessee,Madison County,3,6203,3171,3032
Tennessee,Madison County,4,7003,3397,3606
Tennessee,Madison County,5,7651,3693,3958
Tennessee,Madison County,6,6181,2913,3268
Tennessee,Madison County,7,6002,2810,3192
Tennessee,Madison County,8,5695,2725,2970
Tennessee,Madison County,9,5959,2859,3100
Tennessee,Madison County,10,6107,2882,3225
Tennessee,Madison County,11,7050,3289,3761
Tennessee,Madison County,12,6885,3122,3763
Tennessee,Madison County,13,6041,2870,3171
Tennessee,Madison County,14,4869,2261,2608
Tennessee,Madison County,15,3550,1598,1952
Tennessee,Madison County,16,2505,1091,1414
Tennessee,Madison County,17,1836,724,1112
Tennessee,Madison County,18,1886,604,1282
Tennessee,Marion County,0,28407,13934,14473
Tennessee,Marion County,1,1461,792,669
Tennessee,Marion County,2,1634,859,775
Tennessee,Marion County,3,1812,923,889
Tennessee,Marion County,4,1729,895,834
Tennessee,Marion County,5,1674,845,829
Tennessee,Marion County,6,1642,838,804
Tennessee,Marion County,7,1523,757,766
Tennessee,Marion County,8,1656,824,832
Tennessee,Marion County,9,1818,879,939
Tennessee,Marion County,10,1920,965,955
Tennessee,Marion County,11,2148,1019,1129
Tennessee,Marion County,12,2215,1063,1152
Tennessee,Marion County,13,2024,972,1052
Tennessee,Marion County,14,1854,884,970
Tennessee,Marion County,15,1338,627,711
Tennessee,Marion County,16,870,372,498
Tennessee,Marion County,17,623,280,343
Tennessee,Marion County,18,466,140,326
Tennessee,Marshall County,0,31269,15342,15927
Tennessee,Marshall County,1,1794,943,851
Tennessee,Marshall County,2,2006,1045,961
Tennessee,Marshall County,3,2261,1158,1103
Tennessee,Marshall County,4,1989,1018,971
Tennessee,Marshall County,5,1912,918,994
Tennessee,Marshall County,6,1755,854,901
Tennessee,Marshall County,7,1901,980,921
Tennessee,Marshall County,8,2023,993,1030
Tennessee,Marshall County,9,2141,1062,1079
Tennessee,Marshall County,10,2146,1066,1080
Tennessee,Marshall County,11,2335,1155,1180
Tennessee,Marshall County,12,2217,1052,1165
Tennessee,Marshall County,13,2055,1019,1036
Tennessee,Marshall County,14,1737,804,933
Tennessee,Marshall County,15,1236,600,636
Tennessee,Marshall County,16,713,305,408
Tennessee,Marshall County,17,567,226,341
Tennessee,Marshall County,18,481,144,337
Tennessee,Maury County,0,85515,41375,44140
Tennessee,Maury County,1,5598,2917,2681
Tennessee,Maury County,2,5918,3058,2860
Tennessee,Maury County,3,5445,2757,2688
Tennessee,Maury County,4,4906,2551,2355
Tennessee,Maury County,5,5171,2614,2557
Tennessee,Maury County,6,5558,2632,2926
Tennessee,Maury County,7,5889,2886,3003
Tennessee,Maury County,8,5443,2577,2866
Tennessee,Maury County,9,5380,2688,2692
Tennessee,Maury County,10,5397,2632,2765
Tennessee,Maury County,11,6029,2728,3301
Tennessee,Maury County,12,6454,3100,3354
Tennessee,Maury County,13,5561,2678,2883
Tennessee,Maury County,14,4554,2150,2404
Tennessee,Maury County,15,3089,1450,1639
Tennessee,Maury County,16,2160,959,1201
Tennessee,Maury County,17,1500,568,932
Tennessee,Maury County,18,1463,430,1033
Tennessee,Meigs County,0,11701,5861,5840
Tennessee,Meigs County,1,565,277,288
Tennessee,Meigs County,2,623,324,299
Tennessee,Meigs County,3,736,352,384
Tennessee,Meigs County,4,685,351,334
Tennessee,Meigs County,5,633,345,288
Tennessee,Meigs County,6,564,286,278
Tennessee,Meigs County,7,583,283,300
Tennessee,Meigs County,8,723,376,347
Tennessee,Meigs County,9,770,391,379
Tennessee,Meigs County,10,845,428,417
Tennessee,Meigs County,11,908,447,461
Tennessee,Meigs County,12,853,420,433
Tennessee,Meigs County,13,891,432,459
Tennessee,Meigs County,14,919,479,440
Tennessee,Meigs County,15,663,336,327
Tennessee,Meigs County,16,345,166,179
Tennessee,Meigs County,17,232,108,124
Tennessee,Meigs County,18,163,60,103
Tennessee,Monroe County,0,45233,22406,22827
Tennessee,Monroe County,1,2358,1227,1131
Tennessee,Monroe County,2,2738,1405,1333
Tennessee,Monroe County,3,2966,1579,1387
Tennessee,Monroe County,4,2664,1383,1281
Tennessee,Monroe County,5,2596,1315,1281
Tennessee,Monroe County,6,2440,1276,1164
Tennessee,Monroe County,7,2386,1225,1161
Tennessee,Monroe County,8,2454,1212,1242
Tennessee,Monroe County,9,2963,1463,1500
Tennessee,Monroe County,10,3077,1516,1561
Tennessee,Monroe County,11,3220,1612,1608
Tennessee,Monroe County,12,3301,1612,1689
Tennessee,Monroe County,13,3218,1498,1720
Tennessee,Monroe County,14,3224,1559,1665
Tennessee,Monroe County,15,2439,1219,1220
Tennessee,Monroe County,16,1534,670,864
Tennessee,Monroe County,17,869,349,520
Tennessee,Monroe County,18,786,286,500
Tennessee,Montgomery County,0,189961,94816,95145
Tennessee,Montgomery County,1,16508,8492,8016
Tennessee,Montgomery County,2,14962,7516,7446
Tennessee,Montgomery County,3,13003,6581,6422
Tennessee,Montgomery County,4,11922,5983,5939
Tennessee,Montgomery County,5,18047,9438,8609
Tennessee,Montgomery County,6,19485,10284,9201
Tennessee,Montgomery County,7,16544,8603,7941
Tennessee,Montgomery County,8,13249,6669,6580
Tennessee,Montgomery County,9,11837,5788,6049
Tennessee,Montgomery County,10,10583,5236,5347
Tennessee,Montgomery County,11,10728,5093,5635
Tennessee,Montgomery County,12,9550,4488,5062
Tennessee,Montgomery County,13,7242,3449,3793
Tennessee,Montgomery County,14,5916,2778,3138
Tennessee,Montgomery County,15,4023,1802,2221
Tennessee,Montgomery County,16,2982,1237,1745
Tennessee,Montgomery County,17,1934,845,1089
Tennessee,Montgomery County,18,1446,534,912
Tennessee,Moore County,0,6319,3110,3209
Tennessee,Moore County,1,241,95,146
Tennessee,Moore County,2,332,169,163
Tennessee,Moore County,3,432,212,220
Tennessee,Moore County,4,414,219,195
Tennessee,Moore County,5,319,157,162
Tennessee,Moore County,6,294,144,150
Tennessee,Moore County,7,333,168,165
Tennessee,Moore County,8,360,177,183
Tennessee,Moore County,9,439,223,216
Tennessee,Moore County,10,424,236,188
Tennessee,Moore County,11,458,227,231
Tennessee,Moore County,12,526,241,285
Tennessee,Moore County,13,432,207,225
Tennessee,Moore County,14,423,210,213
Tennessee,Moore County,15,353,185,168
Tennessee,Moore County,16,222,107,115
Tennessee,Moore County,17,148,80,68
Tennessee,Moore County,18,169,53,116
Tennessee,Morgan County,0,21660,11878,9782
Tennessee,Morgan County,1,917,480,437
Tennessee,Morgan County,2,1162,600,562
Tennessee,Morgan County,3,1361,705,656
Tennessee,Morgan County,4,1260,666,594
Tennessee,Morgan County,5,1397,880,517
Tennessee,Morgan County,6,1373,874,499
Tennessee,Morgan County,7,1461,920,541
Tennessee,Morgan County,8,1441,860,581
Tennessee,Morgan County,9,1614,935,679
Tennessee,Morgan County,10,1625,921,704
Tennessee,Morgan County,11,1602,899,703
Tennessee,Morgan County,12,1537,796,741
Tennessee,Morgan County,13,1416,694,722
Tennessee,Morgan County,14,1260,627,633
Tennessee,Morgan County,15,887,424,463
Tennessee,Morgan County,16,635,306,329
Tennessee,Morgan County,17,392,181,211
Tennessee,Morgan County,18,320,110,210
Tennessee,Obion County,0,30941,14973,15968
Tennessee,Obion County,1,1786,940,846
Tennessee,Obion County,2,1784,908,876
Tennessee,Obion County,3,2031,1001,1030
Tennessee,Obion County,4,1919,963,956
Tennessee,Obion County,5,1783,919,864
Tennessee,Obion County,6,1664,817,847
Tennessee,Obion County,7,1765,871,894
Tennessee,Obion County,8,1799,881,918
Tennessee,Obion County,9,2032,1016,1016
Tennessee,Obion County,10,1993,982,1011
Tennessee,Obion County,11,2167,1070,1097
Tennessee,Obion County,12,2299,1093,1206
Tennessee,Obion County,13,2079,984,1095
Tennessee,Obion County,14,1929,925,1004
Tennessee,Obion County,15,1496,667,829
Tennessee,Obion County,16,1051,476,575
Tennessee,Obion County,17,720,270,450
Tennessee,Obion County,18,644,190,454
Tennessee,Overton County,0,22028,10858,11170
Tennessee,Overton County,1,1204,610,594
Tennessee,Overton County,2,1370,723,647
Tennessee,Overton County,3,1463,777,686
Tennessee,Overton County,4,1327,667,660
Tennessee,Overton County,5,1290,701,589
Tennessee,Overton County,6,1082,507,575
Tennessee,Overton County,7,1164,582,582
Tennessee,Overton County,8,1286,647,639
Tennessee,Overton County,9,1426,697,729
Tennessee,Overton County,10,1519,746,773
Tennessee,Overton County,11,1514,755,759
Tennessee,Overton County,12,1594,764,830
Tennessee,Overton County,13,1514,751,763
Tennessee,Overton County,14,1489,710,779
Tennessee,Overton County,15,1117,517,600
Tennessee,Overton County,16,807,362,445
Tennessee,Overton County,17,465,193,272
Tennessee,Overton County,18,397,149,248
Tennessee,Perry County,0,7822,3949,3873
Tennessee,Perry County,1,432,221,211
Tennessee,Perry County,2,459,231,228
Tennessee,Perry County,3,477,249,228
Tennessee,Perry County,4,500,282,218
Tennessee,Perry County,5,419,217,202
Tennessee,Perry County,6,434,233,201
Tennessee,Perry County,7,404,202,202
Tennessee,Perry County,8,440,216,224
Tennessee,Perry County,9,446,231,215
Tennessee,Perry County,10,479,240,239
Tennessee,Perry County,11,520,258,262
Tennessee,Perry County,12,619,318,301
Tennessee,Perry County,13,554,288,266
Tennessee,Perry County,14,556,275,281
Tennessee,Perry County,15,450,207,243
Tennessee,Perry County,16,273,132,141
Tennessee,Perry County,17,204,92,112
Tennessee,Perry County,18,156,57,99
Tennessee,Pickett County,0,5124,2570,2554
Tennessee,Pickett County,1,198,103,95
Tennessee,Pickett County,2,258,130,128
Tennessee,Pickett County,3,299,178,121
Tennessee,Pickett County,4,287,148,139
Tennessee,Pickett County,5,253,137,116
Tennessee,Pickett County,6,221,125,96
Tennessee,Pickett County,7,224,111,113
Tennessee,Pickett County,8,278,131,147
Tennessee,Pickett County,9,270,128,142
Tennessee,Pickett County,10,352,185,167
Tennessee,Pickett County,11,397,200,197
Tennessee,Pickett County,12,369,172,197
Tennessee,Pickett County,13,426,219,207
Tennessee,Pickett County,14,423,208,215
Tennessee,Pickett County,15,336,169,167
Tennessee,Pickett County,16,258,123,135
Tennessee,Pickett County,17,153,64,89
Tennessee,Pickett County,18,122,39,83
Tennessee,Polk County,0,16730,8334,8396
Tennessee,Polk County,1,778,401,377
Tennessee,Polk County,2,945,498,447
Tennessee,Polk County,3,1042,548,494
Tennessee,Polk County,4,1018,534,484
Tennessee,Polk County,5,932,509,423
Tennessee,Polk County,6,824,403,421
Tennessee,Polk County,7,826,399,427
Tennessee,Polk County,8,944,447,497
Tennessee,Polk County,9,1217,622,595
Tennessee,Polk County,10,1246,623,623
Tennessee,Polk County,11,1288,660,628
Tennessee,Polk County,12,1256,597,659
Tennessee,Polk County,13,1165,559,606
Tennessee,Polk County,14,1124,549,575
Tennessee,Polk County,15,889,452,437
Tennessee,Polk County,16,583,286,297
Tennessee,Polk County,17,363,150,213
Tennessee,Polk County,18,290,97,193
Tennessee,Putnam County,0,74165,36633,37532
Tennessee,Putnam County,1,4333,2250,2083
Tennessee,Putnam County,2,4360,2204,2156
Tennessee,Putnam County,3,4427,2346,2081
Tennessee,Putnam County,4,5518,2832,2686
Tennessee,Putnam County,5,8073,4343,3730
Tennessee,Putnam County,6,4682,2439,2243
Tennessee,Putnam County,7,4368,2239,2129
Tennessee,Putnam County,8,4111,2019,2092
Tennessee,Putnam County,9,4349,2167,2182
Tennessee,Putnam County,10,4443,2133,2310
Tennessee,Putnam County,11,4707,2212,2495
Tennessee,Putnam County,12,4571,2201,2370
Tennessee,Putnam County,13,4194,1962,2232
Tennessee,Putnam County,14,3985,1846,2139
Tennessee,Putnam County,15,3073,1416,1657
Tennessee,Putnam County,16,2094,940,1154
Tennessee,Putnam County,17,1497,586,911
Tennessee,Putnam County,18,1380,498,882
Tennessee,Rhea County,0,32641,16046,16595
Tennessee,Rhea County,1,1781,914,867
Tennessee,Rhea County,2,2189,1083,1106
Tennessee,Rhea County,3,2197,1121,1076
Tennessee,Rhea County,4,2229,1140,1089
Tennessee,Rhea County,5,2165,1106,1059
Tennessee,Rhea County,6,1795,876,919
Tennessee,Rhea County,7,1799,896,903
Tennessee,Rhea County,8,1841,906,935
Tennessee,Rhea County,9,2100,1053,1047
Tennessee,Rhea County,10,2166,1052,1114
Tennessee,Rhea County,11,2226,1118,1108
Tennessee,Rhea County,12,2254,1083,1171
Tennessee,Rhea County,13,2156,1052,1104
Tennessee,Rhea County,14,2008,986,1022
Tennessee,Rhea County,15,1541,707,834
Tennessee,Rhea County,16,987,457,530
Tennessee,Rhea County,17,631,278,353
Tennessee,Rhea County,18,576,218,358
Tennessee,Roane County,0,52748,25919,26829
Tennessee,Roane County,1,2415,1278,1137
Tennessee,Roane County,2,2773,1452,1321
Tennessee,Roane County,3,3212,1691,1521
Tennessee,Roane County,4,3064,1622,1442
Tennessee,Roane County,5,2747,1388,1359
Tennessee,Roane County,6,2512,1240,1272
Tennessee,Roane County,7,2522,1217,1305
Tennessee,Roane County,8,2788,1374,1414
Tennessee,Roane County,9,3306,1641,1665
Tennessee,Roane County,10,3657,1796,1861
Tennessee,Roane County,11,4080,1958,2122
Tennessee,Roane County,12,4398,2138,2260
Tennessee,Roane County,13,4089,1999,2090
Tennessee,Roane County,14,3815,1889,1926
Tennessee,Roane County,15,2758,1366,1392
Tennessee,Roane County,16,1927,883,1044
Tennessee,Roane County,17,1366,545,821
Tennessee,Roane County,18,1319,442,877
Tennessee,Robertson County,0,68079,33449,34630
Tennessee,Robertson County,1,4587,2336,2251
Tennessee,Robertson County,2,4721,2453,2268
Tennessee,Robertson County,3,4873,2471,2402
Tennessee,Robertson County,4,4423,2241,2182
Tennessee,Robertson County,5,3950,2021,1929
Tennessee,Robertson County,6,4034,2009,2025
Tennessee,Robertson County,7,4516,2212,2304
Tennessee,Robertson County,8,4275,2053,2222
Tennessee,Robertson County,9,4667,2303,2364
Tennessee,Robertson County,10,4665,2279,2386
Tennessee,Robertson County,11,5351,2658,2693
Tennessee,Robertson County,12,4799,2329,2470
Tennessee,Robertson County,13,4014,1923,2091
Tennessee,Robertson County,14,3263,1562,1701
Tennessee,Robertson County,15,2344,1133,1211
Tennessee,Robertson County,16,1672,741,931
Tennessee,Robertson County,17,1035,436,599
Tennessee,Robertson County,18,890,289,601
Tennessee,Rutherford County,0,288906,142376,146530
Tennessee,Rutherford County,1,18725,9523,9202
Tennessee,Rutherford County,2,20839,10607,10232
Tennessee,Rutherford County,3,20658,10545,10113
Tennessee,Rutherford County,4,21291,10800,10491
Tennessee,Rutherford County,5,28992,14738,14254
Tennessee,Rutherford County,6,19764,10041,9723
Tennessee,Rutherford County,7,21743,10721,11022
Tennessee,Rutherford County,8,20552,10009,10543
Tennessee,Rutherford County,9,20979,10317,10662
Tennessee,Rutherford County,10,19089,9413,9676
Tennessee,Rutherford County,11,18989,9218,9771
Tennessee,Rutherford County,12,16396,7935,8461
Tennessee,Rutherford County,13,13093,6239,6854
Tennessee,Rutherford County,14,10355,4927,5428
Tennessee,Rutherford County,15,6946,3181,3765
Tennessee,Rutherford County,16,4693,2027,2666
Tennessee,Rutherford County,17,2990,1227,1763
Tennessee,Rutherford County,18,2812,908,1904
Tennessee,Scott County,0,21987,10825,11162
Tennessee,Scott County,1,1385,700,685
Tennessee,Scott County,2,1457,745,712
Tennessee,Scott County,3,1627,803,824
Tennessee,Scott County,4,1388,717,671
Tennessee,Scott County,5,1384,702,682
Tennessee,Scott County,6,1212,613,599
Tennessee,Scott County,7,1299,638,661
Tennessee,Scott County,8,1513,746,767
Tennessee,Scott County,9,1426,691,735
Tennessee,Scott County,10,1547,792,755
Tennessee,Scott County,11,1536,778,758
Tennessee,Scott County,12,1477,707,770
Tennessee,Scott County,13,1316,632,684
Tennessee,Scott County,14,1195,567,628
Tennessee,Scott County,15,924,431,493
Tennessee,Scott County,16,621,283,338
Tennessee,Scott County,17,363,158,205
Tennessee,Scott County,18,317,122,195
Tennessee,Sequatchie County,0,14704,7228,7476
Tennessee,Sequatchie County,1,763,370,393
Tennessee,Sequatchie County,2,911,448,463
Tennessee,Sequatchie County,3,991,492,499
Tennessee,Sequatchie County,4,823,438,385
Tennessee,Sequatchie County,5,840,450,390
Tennessee,Sequatchie County,6,724,333,391
Tennessee,Sequatchie County,7,809,395,414
Tennessee,Sequatchie County,8,847,422,425
Tennessee,Sequatchie County,9,1023,521,502
Tennessee,Sequatchie County,10,987,500,487
Tennessee,Sequatchie County,11,1061,515,546
Tennessee,Sequatchie County,12,1107,518,589
Tennessee,Sequatchie County,13,1002,480,522
Tennessee,Sequatchie County,14,1006,518,488
Tennessee,Sequatchie County,15,790,383,407
Tennessee,Sequatchie County,16,495,244,251
Tennessee,Sequatchie County,17,269,114,155
Tennessee,Sequatchie County,18,256,87,169
Tennessee,Sevier County,0,95110,46653,48457
Tennessee,Sevier County,1,5273,2717,2556
Tennessee,Sevier County,2,5437,2787,2650
Tennessee,Sevier County,3,5796,2990,2806
Tennessee,Sevier County,4,5592,2910,2682
Tennessee,Sevier County,5,5938,2967,2971
Tennessee,Sevier County,6,5549,2861,2688
Tennessee,Sevier County,7,5383,2697,2686
Tennessee,Sevier County,8,5576,2755,2821
Tennessee,Sevier County,9,6519,3241,3278
Tennessee,Sevier County,10,6531,3203,3328
Tennessee,Sevier County,11,7164,3450,3714
Tennessee,Sevier County,12,6925,3256,3669
Tennessee,Sevier County,13,6578,3035,3543
Tennessee,Sevier County,14,5983,2876,3107
Tennessee,Sevier County,15,4674,2242,2432
Tennessee,Sevier County,16,2895,1353,1542
Tennessee,Sevier County,17,1796,772,1024
Tennessee,Sevier County,18,1501,541,960
Tennessee,Shelby County,0,938803,447124,491679
Tennessee,Shelby County,1,68019,34715,33304
Tennessee,Shelby County,2,66197,33475,32722
Tennessee,Shelby County,3,65066,32764,32302
Tennessee,Shelby County,4,64932,33128,31804
Tennessee,Shelby County,5,71420,35135,36285
Tennessee,Shelby County,6,68920,33426,35494
Tennessee,Shelby County,7,64892,31063,33829
Tennessee,Shelby County,8,59222,28282,30940
Tennessee,Shelby County,9,61468,29125,32343
Tennessee,Shelby County,10,59574,28003,31571
Tennessee,Shelby County,11,64450,30158,34292
Tennessee,Shelby County,12,62446,28733,33713
Tennessee,Shelby County,13,53150,24293,28857
Tennessee,Shelby County,14,39209,17957,21252
Tennessee,Shelby County,15,25348,10881,14467
Tennessee,Shelby County,16,17639,6988,10651
Tennessee,Shelby County,17,12939,4691,8248
Tennessee,Shelby County,18,13912,4307,9605
Tennessee,Smith County,0,19009,9410,9599
Tennessee,Smith County,1,1081,586,495
Tennessee,Smith County,2,1219,603,616
Tennessee,Smith County,3,1338,704,634
Tennessee,Smith County,4,1215,620,595
Tennessee,Smith County,5,1127,579,548
Tennessee,Smith County,6,1073,536,537
Tennessee,Smith County,7,1140,561,579
Tennessee,Smith County,8,1068,508,560
Tennessee,Smith County,9,1206,588,618
Tennessee,Smith County,10,1388,692,696
Tennessee,Smith County,11,1594,806,788
Tennessee,Smith County,12,1402,700,702
Tennessee,Smith County,13,1224,611,613
Tennessee,Smith County,14,1105,538,567
Tennessee,Smith County,15,778,364,414
Tennessee,Smith County,16,476,222,254
Tennessee,Smith County,17,310,120,190
Tennessee,Smith County,18,265,72,193
Tennessee,Stewart County,0,13279,6678,6601
Tennessee,Stewart County,1,675,364,311
Tennessee,Stewart County,2,764,404,360
Tennessee,Stewart County,3,867,477,390
Tennessee,Stewart County,4,833,421,412
Tennessee,Stewart County,5,728,383,345
Tennessee,Stewart County,6,706,368,338
Tennessee,Stewart County,7,697,362,335
Tennessee,Stewart County,8,751,372,379
Tennessee,Stewart County,9,829,408,421
Tennessee,Stewart County,10,969,478,491
Tennessee,Stewart County,11,1035,553,482
Tennessee,Stewart County,12,1013,469,544
Tennessee,Stewart County,13,906,446,460
Tennessee,Stewart County,14,899,453,446
Tennessee,Stewart County,15,666,322,344
Tennessee,Stewart County,16,426,185,241
Tennessee,Stewart County,17,282,129,153
Tennessee,Stewart County,18,233,84,149
Tennessee,Sullivan County,0,157047,76038,81009
Tennessee,Sullivan County,1,7906,4036,3870
Tennessee,Sullivan County,2,8578,4364,4214
Tennessee,Sullivan County,3,9082,4637,4445
Tennessee,Sullivan County,4,8973,4591,4382
Tennessee,Sullivan County,5,9161,4643,4518
Tennessee,Sullivan County,6,8385,4106,4279
Tennessee,Sullivan County,7,8304,4045,4259
Tennessee,Sullivan County,8,8721,4318,4403
Tennessee,Sullivan County,9,10534,5226,5308
Tennessee,Sullivan County,10,10913,5371,5542
Tennessee,Sullivan County,11,11743,5704,6039
Tennessee,Sullivan County,12,11815,5757,6058
Tennessee,Sullivan County,13,11011,5163,5848
Tennessee,Sullivan County,14,9970,4748,5222
Tennessee,Sullivan County,15,8272,3871,4401
Tennessee,Sullivan County,16,5776,2534,3242
Tennessee,Sullivan County,17,4049,1656,2393
Tennessee,Sullivan County,18,3854,1268,2586
Tennessee,Sumner County,0,172706,84266,88440
Tennessee,Sumner County,1,10302,5250,5052
Tennessee,Sumner County,2,11736,6053,5683
Tennessee,Sumner County,3,12394,6300,6094
Tennessee,Sumner County,4,11452,5959,5493
Tennessee,Sumner County,5,10062,5172,4890
Tennessee,Sumner County,6,9797,4789,5008
Tennessee,Sumner County,7,10965,5255,5710
Tennessee,Sumner County,8,11205,5531,5674
Tennessee,Sumner County,9,12378,5949,6429
Tennessee,Sumner County,10,12259,5996,6263
Tennessee,Sumner County,11,13093,6346,6747
Tennessee,Sumner County,12,11705,5703,6002
Tennessee,Sumner County,13,10080,4779,5301
Tennessee,Sumner County,14,9005,4364,4641
Tennessee,Sumner County,15,6552,2973,3579
Tennessee,Sumner County,16,4327,1904,2423
Tennessee,Sumner County,17,2757,1074,1683
Tennessee,Sumner County,18,2637,869,1768
Tennessee,Tipton County,0,61623,30352,31271
Tennessee,Tipton County,1,3784,1956,1828
Tennessee,Tipton County,2,4307,2222,2085
Tennessee,Tipton County,3,4699,2419,2280
Tennessee,Tipton County,4,4575,2327,2248
Tennessee,Tipton County,5,3991,2082,1909
Tennessee,Tipton County,6,3817,1919,1898
Tennessee,Tipton County,7,3749,1851,1898
Tennessee,Tipton County,8,3837,1845,1992
Tennessee,Tipton County,9,4095,1984,2111
Tennessee,Tipton County,10,4318,2147,2171
Tennessee,Tipton County,11,4741,2276,2465
Tennessee,Tipton County,12,4187,2029,2158
Tennessee,Tipton County,13,3477,1686,1791
Tennessee,Tipton County,14,2869,1355,1514
Tennessee,Tipton County,15,2101,1004,1097
Tennessee,Tipton County,16,1447,626,821
Tennessee,Tipton County,17,922,392,530
Tennessee,Tipton County,18,707,232,475
Tennessee,Trousdale County,0,8002,3968,4034
Tennessee,Trousdale County,1,444,244,200
Tennessee,Trousdale County,2,521,264,257
Tennessee,Trousdale County,3,513,276,237
Tennessee,Trousdale County,4,543,279,264
Tennessee,Trousdale County,5,514,264,250
Tennessee,Trousdale County,6,441,234,207
Tennessee,Trousdale County,7,478,228,250
Tennessee,Trousdale County,8,465,226,239
Tennessee,Trousdale County,9,544,265,279
Tennessee,Trousdale County,10,562,256,306
Tennessee,Trousdale County,11,599,313,286
Tennessee,Trousdale County,12,593,286,307
Tennessee,Trousdale County,13,545,256,289
Tennessee,Trousdale County,14,443,217,226
Tennessee,Trousdale County,15,332,172,160
Tennessee,Trousdale County,16,216,98,118
Tennessee,Trousdale County,17,129,49,80
Tennessee,Trousdale County,18,120,41,79
Tennessee,Unicoi County,0,17963,8839,9124
Tennessee,Unicoi County,1,783,380,403
Tennessee,Unicoi County,2,953,528,425
Tennessee,Unicoi County,3,1075,544,531
Tennessee,Unicoi County,4,1010,504,506
Tennessee,Unicoi County,5,917,480,437
Tennessee,Unicoi County,6,897,457,440
Tennessee,Unicoi County,7,957,493,464
Tennessee,Unicoi County,8,978,495,483
Tennessee,Unicoi County,9,1139,566,573
Tennessee,Unicoi County,10,1235,605,630
Tennessee,Unicoi County,11,1347,659,688
Tennessee,Unicoi County,12,1438,715,723
Tennessee,Unicoi County,13,1320,655,665
Tennessee,Unicoi County,14,1260,610,650
Tennessee,Unicoi County,15,949,451,498
Tennessee,Unicoi County,16,720,331,389
Tennessee,Unicoi County,17,521,227,294
Tennessee,Unicoi County,18,464,139,325
Tennessee,Union County,0,19113,9477,9636
Tennessee,Union County,1,1234,639,595
Tennessee,Union County,2,1217,598,619
Tennessee,Union County,3,1289,682,607
Tennessee,Union County,4,1121,594,527
Tennessee,Union County,5,1072,555,517
Tennessee,Union County,6,1087,499,588
Tennessee,Union County,7,1077,548,529
Tennessee,Union County,8,1157,593,564
Tennessee,Union County,9,1185,594,591
Tennessee,Union County,10,1321,635,686
Tennessee,Union County,11,1497,733,764
Tennessee,Union County,12,1454,707,747
Tennessee,Union County,13,1280,628,652
Tennessee,Union County,14,1144,598,546
Tennessee,Union County,15,873,440,433
Tennessee,Union County,16,542,242,300
Tennessee,Union County,17,302,103,199
Tennessee,Union County,18,261,89,172
Tennessee,Van Buren County,0,5633,2812,2821
Tennessee,Van Buren County,1,236,110,126
Tennessee,Van Buren County,2,304,162,142
Tennessee,Van Buren County,3,321,161,160
Tennessee,Van Buren County,4,332,179,153
Tennessee,Van Buren County,5,292,149,143
Tennessee,Van Buren County,6,263,139,124
Tennessee,Van Buren County,7,267,139,128
Tennessee,Van Buren County,8,326,167,159
Tennessee,Van Buren County,9,374,180,194
Tennessee,Van Buren County,10,364,189,175
Tennessee,Van Buren County,11,420,202,218
Tennessee,Van Buren County,12,484,250,234
Tennessee,Van Buren County,13,477,222,255
Tennessee,Van Buren County,14,460,238,222
Tennessee,Van Buren County,15,310,151,159
Tennessee,Van Buren County,16,195,98,97
Tennessee,Van Buren County,17,114,46,68
Tennessee,Van Buren County,18,94,30,64
Tennessee,Warren County,0,39969,19759,20210
Tennessee,Warren County,1,2364,1239,1125
Tennessee,Warren County,2,2646,1335,1311
Tennessee,Warren County,3,2862,1490,1372
Tennessee,Warren County,4,2369,1232,1137
Tennessee,Warren County,5,2329,1220,1109
Tennessee,Warren County,6,2219,1067,1152
Tennessee,Warren County,7,2448,1192,1256
Tennessee,Warren County,8,2517,1293,1224
Tennessee,Warren County,9,2732,1420,1312
Tennessee,Warren County,10,2625,1357,1268
Tennessee,Warren County,11,2899,1456,1443
Tennessee,Warren County,12,2796,1353,1443
Tennessee,Warren County,13,2442,1145,1297
Tennessee,Warren County,14,2217,1052,1165
Tennessee,Warren County,15,1740,787,953
Tennessee,Warren County,16,1200,550,650
Tennessee,Warren County,17,844,345,499
Tennessee,Warren County,18,720,226,494
Tennessee,Washington County,0,126242,61781,64461
Tennessee,Washington County,1,6607,3369,3238
Tennessee,Washington County,2,6914,3526,3388
Tennessee,Washington County,3,7088,3590,3498
Tennessee,Washington County,4,8360,4165,4195
Tennessee,Washington County,5,11545,5573,5972
Tennessee,Washington County,6,7874,3933,3941
Tennessee,Washington County,7,7496,3743,3753
Tennessee,Washington County,8,7303,3671,3632
Tennessee,Washington County,9,8341,4147,4194
Tennessee,Washington County,10,8154,4114,4040
Tennessee,Washington County,11,8809,4325,4484
Tennessee,Washington County,12,8552,4165,4387
Tennessee,Washington County,13,7804,3809,3995
Tennessee,Washington County,14,7198,3454,3744
Tennessee,Washington County,15,5401,2582,2819
Tennessee,Washington County,16,3767,1716,2051
Tennessee,Washington County,17,2584,1079,1505
Tennessee,Washington County,18,2445,820,1625
Tennessee,Wayne County,0,16913,9320,7593
Tennessee,Wayne County,1,752,376,376
Tennessee,Wayne County,2,844,448,396
Tennessee,Wayne County,3,914,480,434
Tennessee,Wayne County,4,929,518,411
Tennessee,Wayne County,5,1111,686,425
Tennessee,Wayne County,6,1143,759,384
Tennessee,Wayne County,7,1139,740,399
Tennessee,Wayne County,8,1094,674,420
Tennessee,Wayne County,9,1187,715,472
Tennessee,Wayne County,10,1242,709,533
Tennessee,Wayne County,11,1234,669,565
Tennessee,Wayne County,12,1151,615,536
Tennessee,Wayne County,13,1083,523,560
Tennessee,Wayne County,14,1027,525,502
Tennessee,Wayne County,15,766,350,416
Tennessee,Wayne County,16,568,263,305
Tennessee,Wayne County,17,364,141,223
Tennessee,Wayne County,18,365,129,236
Tennessee,Weakley County,0,34373,16822,17551
Tennessee,Weakley County,1,1804,968,836
Tennessee,Weakley County,2,1779,921,858
Tennessee,Weakley County,3,1878,939,939
Tennessee,Weakley County,4,2850,1381,1469
Tennessee,Weakley County,5,4279,2153,2126
Tennessee,Weakley County,6,1972,1058,914
Tennessee,Weakley County,7,1802,879,923
Tennessee,Weakley County,8,1721,844,877
Tennessee,Weakley County,9,1884,929,955
Tennessee,Weakley County,10,2081,1043,1038
Tennessee,Weakley County,11,2221,1067,1154
Tennessee,Weakley County,12,2188,1080,1108
Tennessee,Weakley County,13,2065,1004,1061
Tennessee,Weakley County,14,1853,880,973
Tennessee,Weakley County,15,1413,665,748
Tennessee,Weakley County,16,1026,452,574
Tennessee,Weakley County,17,803,330,473
Tennessee,Weakley County,18,754,229,525
Tennessee,White County,0,26301,12846,13455
Tennessee,White County,1,1561,814,747
Tennessee,White County,2,1554,761,793
Tennessee,White County,3,1666,844,822
Tennessee,White County,4,1513,780,733
Tennessee,White County,5,1508,765,743
Tennessee,White County,6,1525,781,744
Tennessee,White County,7,1492,747,745
Tennessee,White County,8,1477,718,759
Tennessee,White County,9,1579,783,796
Tennessee,White County,10,1805,879,926
Tennessee,White County,11,1881,927,954
Tennessee,White County,12,1851,905,946
Tennessee,White County,13,1835,872,963
Tennessee,White County,14,1678,826,852
Tennessee,White County,15,1278,602,676
Tennessee,White County,16,886,386,500
Tennessee,White County,17,628,265,363
Tennessee,White County,18,584,191,393
Tennessee,Williamson County,0,205226,100137,105089
Tennessee,Williamson County,1,11853,5994,5859
Tennessee,Williamson County,2,16389,8332,8057
Tennessee,Williamson County,3,18486,9380,9106
Tennessee,Williamson County,4,15783,8124,7659
Tennessee,Williamson County,5,10168,5227,4941
Tennessee,Williamson County,6,8136,3997,4139
Tennessee,Williamson County,7,10961,5074,5887
Tennessee,Williamson County,8,13972,6630,7342
Tennessee,Williamson County,9,16613,8033,8580
Tennessee,Williamson County,10,16455,7987,8468
Tennessee,Williamson County,11,16333,7877,8456
Tennessee,Williamson County,12,14709,7178,7531
Tennessee,Williamson County,13,11540,5620,5920
Tennessee,Williamson County,14,9027,4441,4586
Tennessee,Williamson County,15,5561,2640,2921
Tennessee,Williamson County,16,3770,1656,2114
Tennessee,Williamson County,17,2632,1041,1591
Tennessee,Williamson County,18,2838,906,1932
Tennessee,Wilson County,0,125376,61533,63843
Tennessee,Wilson County,1,7300,3784,3516
Tennessee,Wilson County,2,8515,4343,4172
Tennessee,Wilson County,3,9229,4750,4479
Tennessee,Wilson County,4,8165,4209,3956
Tennessee,Wilson County,5,6942,3623,3319
Tennessee,Wilson County,6,6357,3007,3350
Tennessee,Wilson County,7,7724,3706,4018
Tennessee,Wilson County,8,8179,3950,4229
Tennessee,Wilson County,9,9211,4590,4621
Tennessee,Wilson County,10,9226,4505,4721
Tennessee,Wilson County,11,9810,4761,5049
Tennessee,Wilson County,12,8825,4268,4557
Tennessee,Wilson County,13,7705,3730,3975
Tennessee,Wilson County,14,6837,3288,3549
Tennessee,Wilson County,15,4756,2287,2469
Tennessee,Wilson County,16,3089,1438,1651
Tennessee,Wilson County,17,1867,794,1073
Tennessee,Wilson County,18,1639,500,1139
Texas,Anderson County,0,57627,35124,22503
Texas,Anderson County,1,2962,1473,1489
Texas,Anderson County,2,3044,1582,1462
Texas,Anderson County,3,3160,1645,1515
Texas,Anderson County,4,2998,1599,1399
Texas,Anderson County,5,3581,2272,1309
Texas,Anderson County,6,4316,3023,1293
Texas,Anderson County,7,4825,3471,1354
Texas,Anderson County,8,4558,3312,1246
Texas,Anderson County,9,4694,3335,1359
Texas,Anderson County,10,4454,3102,1352
Texas,Anderson County,11,4235,2760,1475
Texas,Anderson County,12,3716,2163,1553
Texas,Anderson County,13,3157,1679,1478
Texas,Anderson County,14,2656,1364,1292
Texas,Anderson County,15,2050,988,1062
Texas,Anderson County,16,1470,663,807
Texas,Anderson County,17,948,417,531
Texas,Anderson County,18,803,276,527
Texas,Andrews County,0,17477,8925,8552
Texas,Andrews County,1,1626,824,802
Texas,Andrews County,2,1484,791,693
Texas,Andrews County,3,1449,726,723
Texas,Andrews County,4,1272,686,586
Texas,Andrews County,5,1269,701,568
Texas,Andrews County,6,1327,692,635
Texas,Andrews County,7,1346,710,636
Texas,Andrews County,8,1066,554,512
Texas,Andrews County,9,1016,528,488
Texas,Andrews County,10,1023,522,501
Texas,Andrews County,11,1094,552,542
Texas,Andrews County,12,1021,502,519
Texas,Andrews County,13,746,390,356
Texas,Andrews County,14,557,259,298
Texas,Andrews County,15,394,179,215
Texas,Andrews County,16,338,127,211
Texas,Andrews County,17,233,102,131
Texas,Andrews County,18,216,80,136
Texas,Angelina County,0,87750,42930,44820
Texas,Angelina County,1,6134,3146,2988
Texas,Angelina County,2,6511,3312,3199
Texas,Angelina County,3,6352,3224,3128
Texas,Angelina County,4,5988,3004,2984
Texas,Angelina County,5,6015,2955,3060
Texas,Angelina County,6,5628,2755,2873
Texas,Angelina County,7,5374,2600,2774
Texas,Angelina County,8,5258,2574,2684
Texas,Angelina County,9,5470,2673,2797
Texas,Angelina County,10,5481,2717,2764
Texas,Angelina County,11,5882,2954,2928
Texas,Angelina County,12,5715,2919,2796
Texas,Angelina County,13,4771,2341,2430
Texas,Angelina County,14,4225,1905,2320
Texas,Angelina County,15,3168,1476,1692
Texas,Angelina County,16,2408,1061,1347
Texas,Angelina County,17,1688,729,959
Texas,Angelina County,18,1682,585,1097
Texas,Aransas County,0,24972,12373,12599
Texas,Aransas County,1,1141,595,546
Texas,Aransas County,2,1314,692,622
Texas,Aransas County,3,1329,675,654
Texas,Aransas County,4,1362,712,650
Texas,Aransas County,5,1343,711,632
Texas,Aransas County,6,1266,659,607
Texas,Aransas County,7,1238,602,636
Texas,Aransas County,8,1120,595,525
Texas,Aransas County,9,1289,630,659
Texas,Aransas County,10,1359,637,722
Texas,Aransas County,11,1773,849,924
Texas,Aransas County,12,1881,877,1004
Texas,Aransas County,13,1917,935,982
Texas,Aransas County,14,2110,1025,1085
Texas,Aransas County,15,1877,934,943
Texas,Aransas County,16,1228,594,634
Texas,Aransas County,17,814,416,398
Texas,Aransas County,18,611,235,376
Texas,Archer County,0,8811,4415,4396
Texas,Archer County,1,310,154,156
Texas,Archer County,2,549,270,279
Texas,Archer County,3,630,330,300
Texas,Archer County,4,648,341,307
Texas,Archer County,5,504,289,215
Texas,Archer County,6,458,234,224
Texas,Archer County,7,455,251,204
Texas,Archer County,8,455,220,235
Texas,Archer County,9,503,223,280
Texas,Archer County,10,601,321,280
Texas,Archer County,11,789,384,405
Texas,Archer County,12,716,344,372
Texas,Archer County,13,597,288,309
Texas,Archer County,14,496,255,241
Texas,Archer County,15,409,183,226
Texas,Archer County,16,312,148,164
Texas,Archer County,17,213,112,101
Texas,Archer County,18,166,68,98
Texas,Armstrong County,0,1955,964,991
Texas,Armstrong County,1,119,52,67
Texas,Armstrong County,2,126,67,59
Texas,Armstrong County,3,133,63,70
Texas,Armstrong County,4,119,66,53
Texas,Armstrong County,5,84,46,38
Texas,Armstrong County,6,69,30,39
Texas,Armstrong County,7,120,63,57
Texas,Armstrong County,8,127,65,62
Texas,Armstrong County,9,103,52,51
Texas,Armstrong County,10,97,48,49
Texas,Armstrong County,11,139,62,77
Texas,Armstrong County,12,161,78,83
Texas,Armstrong County,13,140,77,63
Texas,Armstrong County,14,137,75,62
Texas,Armstrong County,15,97,44,53
Texas,Armstrong County,16,90,38,52
Texas,Armstrong County,17,51,24,27
Texas,Armstrong County,18,43,14,29
Texas,Atascosa County,0,47774,23762,24012
Texas,Atascosa County,1,3485,1777,1708
Texas,Atascosa County,2,3696,1891,1805
Texas,Atascosa County,3,3835,1961,1874
Texas,Atascosa County,4,3586,1791,1795
Texas,Atascosa County,5,3106,1607,1499
Texas,Atascosa County,6,3010,1521,1489
Texas,Atascosa County,7,3044,1568,1476
Texas,Atascosa County,8,2854,1451,1403
Texas,Atascosa County,9,2962,1436,1526
Texas,Atascosa County,10,2800,1424,1376
Texas,Atascosa County,11,3192,1535,1657
Texas,Atascosa County,12,2939,1423,1516
Texas,Atascosa County,13,2620,1308,1312
Texas,Atascosa County,14,2316,1116,1200
Texas,Atascosa County,15,1643,796,847
Texas,Atascosa County,16,1121,533,588
Texas,Atascosa County,17,808,350,458
Texas,Atascosa County,18,757,274,483
Texas,Austin County,0,29114,14454,14660
Texas,Austin County,1,1792,934,858
Texas,Austin County,2,1978,971,1007
Texas,Austin County,3,1994,1055,939
Texas,Austin County,4,1941,978,963
Texas,Austin County,5,1697,885,812
Texas,Austin County,6,1481,739,742
Texas,Austin County,7,1567,795,772
Texas,Austin County,8,1634,801,833
Texas,Austin County,9,1717,846,871
Texas,Austin County,10,1813,915,898
Texas,Austin County,11,2096,1002,1094
Texas,Austin County,12,2315,1189,1126
Texas,Austin County,13,1967,988,979
Texas,Austin County,14,1713,834,879
Texas,Austin County,15,1379,665,714
Texas,Austin County,16,821,389,432
Texas,Austin County,17,619,263,356
Texas,Austin County,18,590,205,385
Texas,Bailey County,0,6910,3501,3409
Texas,Bailey County,1,648,333,315
Texas,Bailey County,2,596,314,282
Texas,Bailey County,3,554,277,277
Texas,Bailey County,4,481,259,222
Texas,Bailey County,5,440,226,214
Texas,Bailey County,6,401,188,213
Texas,Bailey County,7,430,225,205
Texas,Bailey County,8,402,214,188
Texas,Bailey County,9,352,170,182
Texas,Bailey County,10,376,189,187
Texas,Bailey County,11,401,215,186
Texas,Bailey County,12,423,221,202
Texas,Bailey County,13,369,189,180
Texas,Bailey County,14,269,137,132
Texas,Bailey County,15,267,126,141
Texas,Bailey County,16,225,96,129
Texas,Bailey County,17,154,73,81
Texas,Bailey County,18,122,49,73
Texas,Bandera County,0,20892,10347,10545
Texas,Bandera County,1,849,447,402
Texas,Bandera County,2,983,458,525
Texas,Bandera County,3,1054,542,512
Texas,Bandera County,4,1163,612,551
Texas,Bandera County,5,911,459,452
Texas,Bandera County,6,862,440,422
Texas,Bandera County,7,857,436,421
Texas,Bandera County,8,878,451,427
Texas,Bandera County,9,1056,515,541
Texas,Bandera County,10,1282,606,676
Texas,Bandera County,11,1907,879,1028
Texas,Bandera County,12,2009,979,1030
Texas,Bandera County,13,1936,957,979
Texas,Bandera County,14,1903,962,941
Texas,Bandera County,15,1379,683,696
Texas,Bandera County,16,835,421,414
Texas,Bandera County,17,532,271,261
Texas,Bandera County,18,496,229,267
Texas,Bastrop County,0,78069,39756,38313
Texas,Bastrop County,1,4780,2309,2471
Texas,Bastrop County,2,5662,2903,2759
Texas,Bastrop County,3,5857,2968,2889
Texas,Bastrop County,4,5436,2879,2557
Texas,Bastrop County,5,4570,2385,2185
Texas,Bastrop County,6,4282,2284,1998
Texas,Bastrop County,7,4723,2518,2205
Texas,Bastrop County,8,4809,2546,2263
Texas,Bastrop County,9,5116,2674,2442
Texas,Bastrop County,10,5287,2689,2598
Texas,Bastrop County,11,5981,3105,2876
Texas,Bastrop County,12,5817,2907,2910
Texas,Bastrop County,13,5066,2580,2486
Texas,Bastrop County,14,4153,2068,2085
Texas,Bastrop County,15,2623,1264,1359
Texas,Bastrop County,16,1740,788,952
Texas,Bastrop County,17,1078,500,578
Texas,Bastrop County,18,1089,389,700
Texas,Baylor County,0,3592,1729,1863
Texas,Baylor County,1,209,98,111
Texas,Baylor County,2,215,112,103
Texas,Baylor County,3,204,99,105
Texas,Baylor County,4,202,99,103
Texas,Baylor County,5,182,86,96
Texas,Baylor County,6,175,85,90
Texas,Baylor County,7,171,86,85
Texas,Baylor County,8,185,96,89
Texas,Baylor County,9,170,82,88
Texas,Baylor County,10,219,101,118
Texas,Baylor County,11,251,134,117
Texas,Baylor County,12,248,126,122
Texas,Baylor County,13,260,132,128
Texas,Baylor County,14,235,103,132
Texas,Baylor County,15,240,110,130
Texas,Baylor County,16,158,73,85
Texas,Baylor County,17,139,59,80
Texas,Baylor County,18,129,48,81
Texas,Bee County,0,32863,19729,13134
Texas,Bee County,1,1935,927,1008
Texas,Bee County,2,1984,1000,984
Texas,Bee County,3,1991,1031,960
Texas,Bee County,4,2086,1153,933
Texas,Bee County,5,2932,2014,918
Texas,Bee County,6,2846,1998,848
Texas,Bee County,7,2824,1974,850
Texas,Bee County,8,2445,1736,709
Texas,Bee County,9,2289,1563,726
Texas,Bee County,10,2241,1514,727
Texas,Bee County,11,2159,1323,836
Texas,Bee County,12,1858,1022,836
Texas,Bee County,13,1517,781,736
Texas,Bee County,14,1267,637,630
Texas,Bee County,15,905,400,505
Texas,Bee County,16,663,300,363
Texas,Bee County,17,471,179,292
Texas,Bee County,18,450,177,273
Texas,Bell County,0,329140,164488,164652
Texas,Bell County,1,28640,14504,14136
Texas,Bell County,2,26004,13305,12699
Texas,Bell County,3,23569,11946,11623
Texas,Bell County,4,21996,11538,10458
Texas,Bell County,5,31194,17086,14108
Texas,Bell County,6,30743,15947,14796
Texas,Bell County,7,26256,13198,13058
Texas,Bell County,8,21346,10602,10744
Texas,Bell County,9,19766,9657,10109
Texas,Bell County,10,18079,8903,9176
Texas,Bell County,11,18895,8963,9932
Texas,Bell County,12,16763,8010,8753
Texas,Bell County,13,13395,6320,7075
Texas,Bell County,14,11284,5308,5976
Texas,Bell County,15,7941,3696,4245
Texas,Bell County,16,5436,2417,3019
Texas,Bell County,17,4045,1760,2285
Texas,Bell County,18,3788,1328,2460
Texas,Bexar County,0,1855866,913205,942661
Texas,Bexar County,1,133848,68283,65565
Texas,Bexar County,2,136528,69351,67177
Texas,Bexar County,3,135694,68611,67083
Texas,Bexar County,4,134255,69529,64726
Texas,Bexar County,5,144965,75131,69834
Texas,Bexar County,6,148246,75518,72728
Texas,Bexar County,7,140752,70915,69837
Texas,Bexar County,8,122859,61024,61835
Texas,Bexar County,9,123274,60169,63105
Texas,Bexar County,10,114278,56106,58172
Texas,Bexar County,11,117499,57128,60371
Texas,Bexar County,12,104721,49878,54843
Texas,Bexar County,13,89590,41468,48122
Texas,Bexar County,14,71918,33108,38810
Texas,Bexar County,15,49377,22123,27254
Texas,Bexar County,16,35432,15143,20289
Texas,Bexar County,17,26198,10658,15540
Texas,Bexar County,18,26432,9062,17370
Texas,Blanco County,0,10812,5451,5361
Texas,Blanco County,1,435,218,217
Texas,Blanco County,2,555,279,276
Texas,Blanco County,3,657,363,294
Texas,Blanco County,4,640,352,288
Texas,Blanco County,5,489,265,224
Texas,Blanco County,6,468,236,232
Texas,Blanco County,7,497,270,227
Texas,Blanco County,8,491,254,237
Texas,Blanco County,9,650,321,329
Texas,Blanco County,10,667,328,339
Texas,Blanco County,11,883,451,432
Texas,Blanco County,12,962,473,489
Texas,Blanco County,13,995,485,510
Texas,Blanco County,14,866,416,450
Texas,Blanco County,15,656,328,328
Texas,Blanco County,16,385,188,197
Texas,Blanco County,17,253,132,121
Texas,Blanco County,18,263,92,171
Texas,Borden County,0,652,349,303
Texas,Borden County,1,35,28,7
Texas,Borden County,2,30,14,16
Texas,Borden County,3,41,19,22
Texas,Borden County,4,51,30,21
Texas,Borden County,5,31,17,14
Texas,Borden County,6,30,19,11
Texas,Borden County,7,34,16,18
Texas,Borden County,8,25,12,13
Texas,Borden County,9,46,25,21
Texas,Borden County,10,49,23,26
Texas,Borden County,11,59,29,30
Texas,Borden County,12,43,22,21
Texas,Borden County,13,44,23,21
Texas,Borden County,14,33,20,13
Texas,Borden County,15,35,19,16
Texas,Borden County,16,26,14,12
Texas,Borden County,17,24,13,11
Texas,Borden County,18,16,6,10
Texas,Bosque County,0,17780,8797,8983
Texas,Bosque County,1,957,487,470
Texas,Bosque County,2,1073,565,508
Texas,Bosque County,3,1092,567,525
Texas,Bosque County,4,1111,569,542
Texas,Bosque County,5,860,418,442
Texas,Bosque County,6,741,354,387
Texas,Bosque County,7,842,435,407
Texas,Bosque County,8,874,429,445
Texas,Bosque County,9,970,468,502
Texas,Bosque County,10,1098,534,564
Texas,Bosque County,11,1281,635,646
Texas,Bosque County,12,1402,724,678
Texas,Bosque County,13,1238,625,613
Texas,Bosque County,14,1363,664,699
Texas,Bosque County,15,1070,514,556
Texas,Bosque County,16,770,357,413
Texas,Bosque County,17,506,248,258
Texas,Bosque County,18,532,204,328
Texas,Bowie County,0,93275,47091,46184
Texas,Bowie County,1,6036,3102,2934
Texas,Bowie County,2,6135,3169,2966
Texas,Bowie County,3,6260,3205,3055
Texas,Bowie County,4,6043,3116,2927
Texas,Bowie County,5,6206,3418,2788
Texas,Bowie County,6,6261,3401,2860
Texas,Bowie County,7,6204,3288,2916
Texas,Bowie County,8,6047,3249,2798
Texas,Bowie County,9,6038,3167,2871
Texas,Bowie County,10,5857,3064,2793
Texas,Bowie County,11,6402,3185,3217
Texas,Bowie County,12,6048,2987,3061
Texas,Bowie County,13,5326,2574,2752
Texas,Bowie County,14,4716,2243,2473
Texas,Bowie County,15,3521,1576,1945
Texas,Bowie County,16,2443,1068,1375
Texas,Bowie County,17,1772,678,1094
Texas,Bowie County,18,1960,601,1359
Texas,Brazoria County,0,338124,171329,166795
Texas,Brazoria County,1,24126,12410,11716
Texas,Brazoria County,2,25893,13206,12687
Texas,Brazoria County,3,26108,13198,12910
Texas,Brazoria County,4,22571,11845,10726
Texas,Brazoria County,5,20965,10969,9996
Texas,Brazoria County,6,21877,11186,10691
Texas,Brazoria County,7,25271,12853,12418
Texas,Brazoria County,8,24024,12174,11850
Texas,Brazoria County,9,25168,12902,12266
Texas,Brazoria County,10,23104,11974,11130
Texas,Brazoria County,11,23695,12218,11477
Texas,Brazoria County,12,21559,10906,10653
Texas,Brazoria County,13,17004,8614,8390
Texas,Brazoria County,14,13249,6574,6675
Texas,Brazoria County,15,9390,4394,4996
Texas,Brazoria County,16,6122,2809,3313
Texas,Brazoria County,17,4242,1804,2438
Texas,Brazoria County,18,3756,1293,2463
Texas,Brazos County,0,209152,106002,103150
Texas,Brazos County,1,12960,6717,6243
Texas,Brazos County,2,12322,6281,6041
Texas,Brazos County,3,11214,5672,5542
Texas,Brazos County,4,19765,9889,9876
Texas,Brazos County,5,45426,24397,21029
Texas,Brazos County,6,18179,9502,8677
Texas,Brazos County,7,14565,7485,7080
Texas,Brazos County,8,11274,5824,5450
Texas,Brazos County,9,10328,5068,5260
Texas,Brazos County,10,9455,4709,4746
Texas,Brazos County,11,9751,4707,5044
Texas,Brazos County,12,9066,4414,4652
Texas,Brazos County,13,7554,3741,3813
Texas,Brazos County,14,5777,2725,3052
Texas,Brazos County,15,4124,1829,2295
Texas,Brazos County,16,2908,1294,1614
Texas,Brazos County,17,2235,934,1301
Texas,Brazos County,18,2249,814,1435
Texas,Brewster County,0,9173,4576,4597
Texas,Brewster County,1,580,261,319
Texas,Brewster County,2,465,226,239
Texas,Brewster County,3,486,254,232
Texas,Brewster County,4,443,232,211
Texas,Brewster County,5,573,281,292
Texas,Brewster County,6,642,344,298
Texas,Brewster County,7,648,346,302
Texas,Brewster County,8,523,262,261
Texas,Brewster County,9,488,253,235
Texas,Brewster County,10,549,254,295
Texas,Brewster County,11,599,299,300
Texas,Brewster County,12,699,331,368
Texas,Brewster County,13,694,354,340
Texas,Brewster County,14,638,347,291
Texas,Brewster County,15,450,229,221
Texas,Brewster County,16,312,165,147
Texas,Brewster County,17,192,71,121
Texas,Brewster County,18,192,67,125
Texas,Briscoe County,0,1536,761,775
Texas,Briscoe County,1,85,47,38
Texas,Briscoe County,2,98,56,42
Texas,Briscoe County,3,96,45,51
Texas,Briscoe County,4,85,43,42
Texas,Briscoe County,5,63,39,24
Texas,Briscoe County,6,69,33,36
Texas,Briscoe County,7,88,37,51
Texas,Briscoe County,8,100,52,48
Texas,Briscoe County,9,86,46,40
Texas,Briscoe County,10,96,46,50
Texas,Briscoe County,11,113,57,56
Texas,Briscoe County,12,89,40,49
Texas,Briscoe County,13,101,52,49
Texas,Briscoe County,14,109,51,58
Texas,Briscoe County,15,86,42,44
Texas,Briscoe County,16,68,31,37
Texas,Briscoe County,17,67,37,30
Texas,Briscoe County,18,37,7,30
Texas,Brooks County,0,7194,3570,3624
Texas,Brooks County,1,662,322,340
Texas,Brooks County,2,573,308,265
Texas,Brooks County,3,491,253,238
Texas,Brooks County,4,482,276,206
Texas,Brooks County,5,519,278,241
Texas,Brooks County,6,425,226,199
Texas,Brooks County,7,453,219,234
Texas,Brooks County,8,332,170,162
Texas,Brooks County,9,340,167,173
Texas,Brooks County,10,368,184,184
Texas,Brooks County,11,443,202,241
Texas,Brooks County,12,418,201,217
Texas,Brooks County,13,379,188,191
Texas,Brooks County,14,418,209,209
Texas,Brooks County,15,298,138,160
Texas,Brooks County,16,260,124,136
Texas,Brooks County,17,171,60,111
Texas,Brooks County,18,162,45,117
Texas,Brown County,0,37653,18674,18979
Texas,Brown County,1,2116,1110,1006
Texas,Brown County,2,2318,1191,1127
Texas,Brown County,3,2532,1299,1233
Texas,Brown County,4,2707,1407,1300
Texas,Brown County,5,2301,1170,1131
Texas,Brown County,6,2171,1097,1074
Texas,Brown County,7,2217,1096,1121
Texas,Brown County,8,2081,1052,1029
Texas,Brown County,9,2231,1126,1105
Texas,Brown County,10,2200,1124,1076
Texas,Brown County,11,2586,1303,1283
Texas,Brown County,12,2555,1242,1313
Texas,Brown County,13,2381,1115,1266
Texas,Brown County,14,2328,1153,1175
Texas,Brown County,15,1883,878,1005
Texas,Brown County,16,1287,599,688
Texas,Brown County,17,881,397,484
Texas,Brown County,18,878,315,563
Texas,Burleson County,0,17253,8578,8675
Texas,Burleson County,1,1021,531,490
Texas,Burleson County,2,1140,598,542
Texas,Burleson County,3,1093,583,510
Texas,Burleson County,4,1049,539,510
Texas,Burleson County,5,973,483,490
Texas,Burleson County,6,872,444,428
Texas,Burleson County,7,930,453,477
Texas,Burleson County,8,873,415,458
Texas,Burleson County,9,913,452,461
Texas,Burleson County,10,1127,571,556
Texas,Burleson County,11,1305,664,641
Texas,Burleson County,12,1389,668,721
Texas,Burleson County,13,1257,622,635
Texas,Burleson County,14,1070,539,531
Texas,Burleson County,15,730,381,349
Texas,Burleson County,16,566,263,303
Texas,Burleson County,17,484,198,286
Texas,Burleson County,18,461,174,287
Texas,Burnet County,0,44943,21992,22951
Texas,Burnet County,1,2366,1213,1153
Texas,Burnet County,2,2671,1381,1290
Texas,Burnet County,3,2877,1457,1420
Texas,Burnet County,4,2803,1423,1380
Texas,Burnet County,5,2605,1332,1273
Texas,Burnet County,6,2349,1176,1173
Texas,Burnet County,7,2496,1234,1262
Texas,Burnet County,8,2398,1122,1276
Texas,Burnet County,9,2528,1215,1313
Texas,Burnet County,10,2533,1224,1309
Texas,Burnet County,11,3290,1606,1684
Texas,Burnet County,12,3270,1572,1698
Texas,Burnet County,13,3257,1559,1698
Texas,Burnet County,14,3128,1561,1567
Texas,Burnet County,15,2310,1144,1166
Texas,Burnet County,16,1730,798,932
Texas,Burnet County,17,1213,556,657
Texas,Burnet County,18,1119,419,700
Texas,Caldwell County,0,39810,20080,19730
Texas,Caldwell County,1,2287,1228,1059
Texas,Caldwell County,2,2725,1358,1367
Texas,Caldwell County,3,2760,1404,1356
Texas,Caldwell County,4,3320,1827,1493
Texas,Caldwell County,5,3290,1835,1455
Texas,Caldwell County,6,2629,1307,1322
Texas,Caldwell County,7,2559,1280,1279
Texas,Caldwell County,8,2338,1149,1189
Texas,Caldwell County,9,2649,1277,1372
Texas,Caldwell County,10,2468,1249,1219
Texas,Caldwell County,11,2658,1346,1312
Texas,Caldwell County,12,2567,1269,1298
Texas,Caldwell County,13,2273,1133,1140
Texas,Caldwell County,14,1796,868,928
Texas,Caldwell County,15,1283,601,682
Texas,Caldwell County,16,900,414,486
Texas,Caldwell County,17,654,292,362
Texas,Caldwell County,18,654,243,411
Texas,Calhoun County,0,21797,11121,10676
Texas,Calhoun County,1,1449,723,726
Texas,Calhoun County,2,1476,748,728
Texas,Calhoun County,3,1602,823,779
Texas,Calhoun County,4,1475,767,708
Texas,Calhoun County,5,1477,776,701
Texas,Calhoun County,6,1294,704,590
Texas,Calhoun County,7,1355,684,671
Texas,Calhoun County,8,1241,636,605
Texas,Calhoun County,9,1261,650,611
Texas,Calhoun County,10,1338,650,688
Texas,Calhoun County,11,1533,826,707
Texas,Calhoun County,12,1502,765,737
Texas,Calhoun County,13,1299,667,632
Texas,Calhoun County,14,1109,555,554
Texas,Calhoun County,15,913,453,460
Texas,Calhoun County,16,622,301,321
Texas,Calhoun County,17,469,210,259
Texas,Calhoun County,18,382,183,199
Texas,Callahan County,0,13513,6657,6856
Texas,Callahan County,1,736,387,349
Texas,Callahan County,2,780,408,372
Texas,Callahan County,3,937,480,457
Texas,Callahan County,4,841,403,438
Texas,Callahan County,5,664,353,311
Texas,Callahan County,6,699,356,343
Texas,Callahan County,7,754,387,367
Texas,Callahan County,8,765,361,404
Texas,Callahan County,9,746,344,402
Texas,Callahan County,10,822,414,408
Texas,Callahan County,11,1055,522,533
Texas,Callahan County,12,1019,492,527
Texas,Callahan County,13,985,482,503
Texas,Callahan County,14,864,404,460
Texas,Callahan County,15,657,347,310
Texas,Callahan County,16,544,255,289
Texas,Callahan County,17,328,143,185
Texas,Callahan County,18,317,119,198
Texas,Cameron County,0,420392,202933,217459
Texas,Cameron County,1,36679,18592,18087
Texas,Cameron County,2,36044,18358,17686
Texas,Cameron County,3,37971,19228,18743
Texas,Cameron County,4,35706,18258,17448
Texas,Cameron County,5,31559,16004,15555
Texas,Cameron County,6,25249,12543,12706
Texas,Cameron County,7,25547,12329,13218
Texas,Cameron County,8,26319,12507,13812
Texas,Cameron County,9,26497,12216,14281
Texas,Cameron County,10,23568,10941,12627
Texas,Cameron County,11,22777,10468,12309
Texas,Cameron County,12,21264,9709,11555
Texas,Cameron County,13,19002,8725,10277
Texas,Cameron County,14,16603,7746,8857
Texas,Cameron County,15,12477,5655,6822
Texas,Cameron County,16,9765,4285,5480
Texas,Cameron County,17,7129,2958,4171
Texas,Cameron County,18,6236,2411,3825
Texas,Camp County,0,12621,6107,6514
Texas,Camp County,1,846,428,418
Texas,Camp County,2,954,485,469
Texas,Camp County,3,905,440,465
Texas,Camp County,4,901,469,432
Texas,Camp County,5,806,388,418
Texas,Camp County,6,713,336,377
Texas,Camp County,7,708,339,369
Texas,Camp County,8,745,363,382
Texas,Camp County,9,692,323,369
Texas,Camp County,10,740,335,405
Texas,Camp County,11,815,394,421
Texas,Camp County,12,805,381,424
Texas,Camp County,13,808,402,406
Texas,Camp County,14,711,347,364
Texas,Camp County,15,514,245,269
Texas,Camp County,16,442,218,224
Texas,Camp County,17,269,115,154
Texas,Camp County,18,247,99,148
Texas,Carson County,0,6013,2987,3026
Texas,Carson County,1,336,185,151
Texas,Carson County,2,408,201,207
Texas,Carson County,3,493,241,252
Texas,Carson County,4,418,207,211
Texas,Carson County,5,313,165,148
Texas,Carson County,6,295,150,145
Texas,Carson County,7,355,173,182
Texas,Carson County,8,336,168,168
Texas,Carson County,9,348,187,161
Texas,Carson County,10,369,166,203
Texas,Carson County,11,442,223,219
Texas,Carson County,12,463,241,222
Texas,Carson County,13,408,205,203
Texas,Carson County,14,308,149,159
Texas,Carson County,15,266,125,141
Texas,Carson County,16,194,93,101
Texas,Carson County,17,143,62,81
Texas,Carson County,18,118,46,72
Texas,Cass County,0,30261,14639,15622
Texas,Cass County,1,1794,887,907
Texas,Cass County,2,1816,915,901
Texas,Cass County,3,1934,995,939
Texas,Cass County,4,1927,1055,872
Texas,Cass County,5,1632,843,789
Texas,Cass County,6,1499,700,799
Texas,Cass County,7,1574,751,823
Texas,Cass County,8,1601,751,850
Texas,Cass County,9,1790,840,950
Texas,Cass County,10,1870,928,942
Texas,Cass County,11,2121,1005,1116
Texas,Cass County,12,2247,1099,1148
Texas,Cass County,13,2030,987,1043
Texas,Cass County,14,1965,952,1013
Texas,Cass County,15,1747,839,908
Texas,Cass County,16,1200,513,687
Texas,Cass County,17,784,322,462
Texas,Cass County,18,730,257,473
Texas,Castro County,0,7781,3966,3815
Texas,Castro County,1,697,370,327
Texas,Castro County,2,645,337,308
Texas,Castro County,3,629,327,302
Texas,Castro County,4,618,309,309
Texas,Castro County,5,482,231,251
Texas,Castro County,6,441,231,210
Texas,Castro County,7,423,201,222
Texas,Castro County,8,469,255,214
Texas,Castro County,9,420,232,188
Texas,Castro County,10,388,196,192
Texas,Castro County,11,510,258,252
Texas,Castro County,12,493,253,240
Texas,Castro County,13,476,241,235
Texas,Castro County,14,297,149,148
Texas,Castro County,15,252,126,126
Texas,Castro County,16,234,112,122
Texas,Castro County,17,182,86,96
Texas,Castro County,18,125,52,73
Texas,Chambers County,0,38145,19179,18966
Texas,Chambers County,1,2553,1276,1277
Texas,Chambers County,2,2984,1535,1449
Texas,Chambers County,3,3166,1634,1532
Texas,Chambers County,4,2877,1463,1414
Texas,Chambers County,5,2391,1267,1124
Texas,Chambers County,6,2301,1128,1173
Texas,Chambers County,7,2694,1332,1362
Texas,Chambers County,8,2582,1266,1316
Texas,Chambers County,9,2728,1310,1418
Texas,Chambers County,10,2659,1336,1323
Texas,Chambers County,11,2632,1376,1256
Texas,Chambers County,12,2407,1256,1151
Texas,Chambers County,13,2061,1058,1003
Texas,Chambers County,14,1658,808,850
Texas,Chambers County,15,1056,530,526
Texas,Chambers County,16,611,308,303
Texas,Chambers County,17,413,167,246
Texas,Chambers County,18,372,129,243
Texas,Cherokee County,0,50902,25992,24910
Texas,Cherokee County,1,3507,1794,1713
Texas,Cherokee County,2,3661,1901,1760
Texas,Cherokee County,3,3709,1895,1814
Texas,Cherokee County,4,3641,1969,1672
Texas,Cherokee County,5,3352,1846,1506
Texas,Cherokee County,6,2952,1523,1429
Texas,Cherokee County,7,2902,1471,1431
Texas,Cherokee County,8,3003,1578,1425
Texas,Cherokee County,9,3221,1681,1540
Texas,Cherokee County,10,3096,1690,1406
Texas,Cherokee County,11,3329,1732,1597
Texas,Cherokee County,12,3226,1650,1576
Texas,Cherokee County,13,3116,1534,1582
Texas,Cherokee County,14,2725,1306,1419
Texas,Cherokee County,15,2058,966,1092
Texas,Cherokee County,16,1443,686,757
Texas,Cherokee County,17,1009,444,565
Texas,Cherokee County,18,952,326,626
Texas,Childress County,0,7089,4186,2903
Texas,Childress County,1,393,202,191
Texas,Childress County,2,421,237,184
Texas,Childress County,3,408,209,199
Texas,Childress County,4,436,263,173
Texas,Childress County,5,694,544,150
Texas,Childress County,6,726,592,134
Texas,Childress County,7,599,419,180
Texas,Childress County,8,465,296,169
Texas,Childress County,9,381,219,162
Texas,Childress County,10,350,181,169
Texas,Childress County,11,388,188,200
Texas,Childress County,12,390,210,180
Texas,Childress County,13,356,170,186
Texas,Childress County,14,304,141,163
Texas,Childress County,15,268,123,145
Texas,Childress County,16,192,79,113
Texas,Childress County,17,172,77,95
Texas,Childress County,18,146,36,110
Texas,Clay County,0,10370,5206,5164
Texas,Clay County,1,512,265,247
Texas,Clay County,2,609,329,280
Texas,Clay County,3,670,338,332
Texas,Clay County,4,668,357,311
Texas,Clay County,5,513,263,250
Texas,Clay County,6,473,249,224
Texas,Clay County,7,494,240,254
Texas,Clay County,8,537,260,277
Texas,Clay County,9,571,284,287
Texas,Clay County,10,649,324,325
Texas,Clay County,11,863,434,429
Texas,Clay County,12,877,445,432
Texas,Clay County,13,826,418,408
Texas,Clay County,14,689,342,347
Texas,Clay County,15,515,255,260
Texas,Clay County,16,406,192,214
Texas,Clay County,17,282,123,159
Texas,Clay County,18,216,88,128
Texas,Cochran County,0,2935,1453,1482
Texas,Cochran County,1,229,117,112
Texas,Cochran County,2,237,112,125
Texas,Cochran County,3,216,102,114
Texas,Cochran County,4,227,103,124
Texas,Cochran County,5,198,107,91
Texas,Cochran County,6,198,99,99
Texas,Cochran County,7,192,90,102
Texas,Cochran County,8,133,66,67
Texas,Cochran County,9,153,74,79
Texas,Cochran County,10,174,93,81
Texas,Cochran County,11,213,120,93
Texas,Cochran County,12,184,88,96
Texas,Cochran County,13,145,69,76
Texas,Cochran County,14,127,67,60
Texas,Cochran County,15,95,39,56
Texas,Cochran County,16,115,54,61
Texas,Cochran County,17,69,36,33
Texas,Cochran County,18,30,17,13
Texas,Coke County,0,3254,1585,1669
Texas,Coke County,1,165,72,93
Texas,Coke County,2,163,80,83
Texas,Coke County,3,197,82,115
Texas,Coke County,4,182,91,91
Texas,Coke County,5,131,69,62
Texas,Coke County,6,154,77,77
Texas,Coke County,7,155,81,74
Texas,Coke County,8,138,69,69
Texas,Coke County,9,140,67,73
Texas,Coke County,10,209,98,111
Texas,Coke County,11,258,131,127
Texas,Coke County,12,246,137,109
Texas,Coke County,13,241,114,127
Texas,Coke County,14,247,106,141
Texas,Coke County,15,225,116,109
Texas,Coke County,16,195,104,91
Texas,Coke County,17,117,64,53
Texas,Coke County,18,91,27,64
Texas,Coleman County,0,8430,4229,4201
Texas,Coleman County,1,479,232,247
Texas,Coleman County,2,518,254,264
Texas,Coleman County,3,522,276,246
Texas,Coleman County,4,502,267,235
Texas,Coleman County,5,378,190,188
Texas,Coleman County,6,363,180,183
Texas,Coleman County,7,394,200,194
Texas,Coleman County,8,412,197,215
Texas,Coleman County,9,488,239,249
Texas,Coleman County,10,474,260,214
Texas,Coleman County,11,631,322,309
Texas,Coleman County,12,690,364,326
Texas,Coleman County,13,605,272,333
Texas,Coleman County,14,625,315,310
Texas,Coleman County,15,493,256,237
Texas,Coleman County,16,374,178,196
Texas,Coleman County,17,277,130,147
Texas,Coleman County,18,205,97,108
Texas,Collin County,0,885241,434591,450650
Texas,Collin County,1,57527,29300,28227
Texas,Collin County,2,68612,35007,33605
Texas,Collin County,3,72840,37090,35750
Texas,Collin County,4,62899,32325,30574
Texas,Collin County,5,49630,25331,24299
Texas,Collin County,6,51274,25153,26121
Texas,Collin County,7,62128,29566,32562
Texas,Collin County,8,69648,33170,36478
Texas,Collin County,9,76644,37607,39037
Texas,Collin County,10,69097,34343,34754
Texas,Collin County,11,65912,32973,32939
Texas,Collin County,12,51894,25478,26416
Texas,Collin County,13,41090,19300,21790
Texas,Collin County,14,33134,15233,17901
Texas,Collin County,15,22130,10226,11904
Texas,Collin County,16,13782,6158,7624
Texas,Collin County,17,8741,3611,5130
Texas,Collin County,18,8259,2720,5539
Texas,Collingsworth County,0,3017,1474,1543
Texas,Collingsworth County,1,225,107,118
Texas,Collingsworth County,2,263,134,129
Texas,Collingsworth County,3,207,112,95
Texas,Collingsworth County,4,231,118,113
Texas,Collingsworth County,5,155,78,77
Texas,Collingsworth County,6,164,73,91
Texas,Collingsworth County,7,204,107,97
Texas,Collingsworth County,8,155,75,80
Texas,Collingsworth County,9,140,66,74
Texas,Collingsworth County,10,174,88,86
Texas,Collingsworth County,11,196,102,94
Texas,Collingsworth County,12,191,90,101
Texas,Collingsworth County,13,183,92,91
Texas,Collingsworth County,14,144,65,79
Texas,Collingsworth County,15,136,64,72
Texas,Collingsworth County,16,97,39,58
Texas,Collingsworth County,17,88,37,51
Texas,Collingsworth County,18,64,27,37
Texas,Colorado County,0,20719,10390,10329
Texas,Colorado County,1,1181,646,535
Texas,Colorado County,2,1322,710,612
Texas,Colorado County,3,1374,683,691
Texas,Colorado County,4,1363,712,651
Texas,Colorado County,5,1184,616,568
Texas,Colorado County,6,1015,538,477
Texas,Colorado County,7,1069,536,533
Texas,Colorado County,8,1030,522,508
Texas,Colorado County,9,1052,525,527
Texas,Colorado County,10,1212,598,614
Texas,Colorado County,11,1514,775,739
Texas,Colorado County,12,1557,786,771
Texas,Colorado County,13,1562,779,783
Texas,Colorado County,14,1257,618,639
Texas,Colorado County,15,1054,523,531
Texas,Colorado County,16,788,360,428
Texas,Colorado County,17,567,253,314
Texas,Colorado County,18,618,210,408
Texas,Comal County,0,123694,60928,62766
Texas,Comal County,1,7005,3549,3456
Texas,Comal County,2,7641,3898,3743
Texas,Comal County,3,8622,4483,4139
Texas,Comal County,4,8049,4126,3923
Texas,Comal County,5,6740,3467,3273
Texas,Comal County,6,6613,3239,3374
Texas,Comal County,7,6838,3394,3444
Texas,Comal County,8,6766,3322,3444
Texas,Comal County,9,8003,3931,4072
Texas,Comal County,10,8249,4121,4128
Texas,Comal County,11,9371,4495,4876
Texas,Comal County,12,9527,4681,4846
Texas,Comal County,13,8740,4166,4574
Texas,Comal County,14,7775,3792,3983
Texas,Comal County,15,5433,2699,2734
Texas,Comal County,16,3634,1719,1915
Texas,Comal County,17,2454,1084,1370
Texas,Comal County,18,2234,762,1472
Texas,Comanche County,0,13550,6648,6902
Texas,Comanche County,1,820,417,403
Texas,Comanche County,2,892,439,453
Texas,Comanche County,3,851,417,434
Texas,Comanche County,4,861,434,427
Texas,Comanche County,5,711,370,341
Texas,Comanche County,6,657,329,328
Texas,Comanche County,7,648,320,328
Texas,Comanche County,8,616,301,315
Texas,Comanche County,9,738,328,410
Texas,Comanche County,10,885,457,428
Texas,Comanche County,11,904,456,448
Texas,Comanche County,12,932,481,451
Texas,Comanche County,13,926,475,451
Texas,Comanche County,14,924,433,491
Texas,Comanche County,15,853,404,449
Texas,Comanche County,16,609,297,312
Texas,Comanche County,17,389,176,213
Texas,Comanche County,18,334,114,220
Texas,Concho County,0,4050,2831,1219
Texas,Concho County,1,137,78,59
Texas,Concho County,2,158,72,86
Texas,Concho County,3,140,70,70
Texas,Concho County,4,153,74,79
Texas,Concho County,5,231,165,66
Texas,Concho County,6,341,304,37
Texas,Concho County,7,362,309,53
Texas,Concho County,8,367,322,45
Texas,Concho County,9,421,356,65
Texas,Concho County,10,360,297,63
Texas,Concho County,11,240,158,82
Texas,Concho County,12,267,162,105
Texas,Concho County,13,238,149,89
Texas,Concho County,14,195,96,99
Texas,Concho County,15,165,94,71
Texas,Concho County,16,120,52,68
Texas,Concho County,17,79,40,39
Texas,Concho County,18,76,33,43
Texas,Cooke County,0,38761,19209,19552
Texas,Cooke County,1,2507,1281,1226
Texas,Cooke County,2,2589,1315,1274
Texas,Cooke County,3,2561,1279,1282
Texas,Cooke County,4,2673,1497,1176
Texas,Cooke County,5,2531,1254,1277
Texas,Cooke County,6,2255,1148,1107
Texas,Cooke County,7,2228,1102,1126
Texas,Cooke County,8,2013,1001,1012
Texas,Cooke County,9,2120,1027,1093
Texas,Cooke County,10,2361,1152,1209
Texas,Cooke County,11,2720,1355,1365
Texas,Cooke County,12,2846,1411,1435
Texas,Cooke County,13,2598,1299,1299
Texas,Cooke County,14,2201,1061,1140
Texas,Cooke County,15,1659,798,861
Texas,Cooke County,16,1243,562,681
Texas,Cooke County,17,889,395,494
Texas,Cooke County,18,767,272,495
Texas,Coryell County,0,75562,37515,38047
Texas,Coryell County,1,5521,2813,2708
Texas,Coryell County,2,5532,2853,2679
Texas,Coryell County,3,5011,2593,2418
Texas,Coryell County,4,4482,2372,2110
Texas,Coryell County,5,7563,4369,3194
Texas,Coryell County,6,7845,3983,3862
Texas,Coryell County,7,6954,3467,3487
Texas,Coryell County,8,5688,2770,2918
Texas,Coryell County,9,5428,2536,2892
Texas,Coryell County,10,4482,2066,2416
Texas,Coryell County,11,4070,1866,2204
Texas,Coryell County,12,3466,1575,1891
Texas,Coryell County,13,2732,1272,1460
Texas,Coryell County,14,2365,1078,1287
Texas,Coryell County,15,1773,802,971
Texas,Coryell County,16,1289,528,761
Texas,Coryell County,17,788,354,434
Texas,Coryell County,18,573,218,355
Texas,Cottle County,0,1415,675,740
Texas,Cottle County,1,57,27,30
Texas,Cottle County,2,78,38,40
Texas,Cottle County,3,125,74,51
Texas,Cottle County,4,82,44,38
Texas,Cottle County,5,67,33,34
Texas,Cottle County,6,66,29,37
Texas,Cottle County,7,68,30,38
Texas,Cottle County,8,66,32,34
Texas,Cottle County,9,64,29,35
Texas,Cottle County,10,61,23,38
Texas,Cottle County,11,130,66,64
Texas,Cottle County,12,95,45,50
Texas,Cottle County,13,109,52,57
Texas,Cottle County,14,94,49,45
Texas,Cottle County,15,97,40,57
Texas,Cottle County,16,69,32,37
Texas,Cottle County,17,49,17,32
Texas,Cottle County,18,38,15,23
Texas,Crane County,0,4950,2463,2487
Texas,Crane County,1,414,181,233
Texas,Crane County,2,422,222,200
Texas,Crane County,3,422,206,216
Texas,Crane County,4,348,178,170
Texas,Crane County,5,373,199,174
Texas,Crane County,6,314,162,152
Texas,Crane County,7,367,187,180
Texas,Crane County,8,293,156,137
Texas,Crane County,9,279,135,144
Texas,Crane County,10,303,160,143
Texas,Crane County,11,343,180,163
Texas,Crane County,12,291,141,150
Texas,Crane County,13,222,113,109
Texas,Crane County,14,188,90,98
Texas,Crane County,15,133,66,67
Texas,Crane County,16,95,34,61
Texas,Crane County,17,73,29,44
Texas,Crane County,18,70,24,46
Texas,Crockett County,0,3812,1893,1919
Texas,Crockett County,1,285,143,142
Texas,Crockett County,2,275,139,136
Texas,Crockett County,3,250,124,126
Texas,Crockett County,4,263,123,140
Texas,Crockett County,5,213,104,109
Texas,Crockett County,6,208,116,92
Texas,Crockett County,7,270,135,135
Texas,Crockett County,8,204,97,107
Texas,Crockett County,9,246,131,115
Texas,Crockett County,10,239,112,127
Texas,Crockett County,11,243,125,118
Texas,Crockett County,12,296,154,142
Texas,Crockett County,13,245,120,125
Texas,Crockett County,14,173,89,84
Texas,Crockett County,15,149,64,85
Texas,Crockett County,16,116,60,56
Texas,Crockett County,17,81,44,37
Texas,Crockett County,18,56,13,43
Texas,Crosby County,0,5899,2911,2988
Texas,Crosby County,1,418,226,192
Texas,Crosby County,2,444,239,205
Texas,Crosby County,3,449,223,226
Texas,Crosby County,4,402,202,200
Texas,Crosby County,5,357,172,185
Texas,Crosby County,6,283,153,130
Texas,Crosby County,7,340,175,165
Texas,Crosby County,8,352,171,181
Texas,Crosby County,9,301,137,164
Texas,Crosby County,10,322,157,165
Texas,Crosby County,11,379,197,182
Texas,Crosby County,12,384,189,195
Texas,Crosby County,13,353,182,171
Texas,Crosby County,14,314,157,157
Texas,Crosby County,15,304,130,174
Texas,Crosby County,16,207,89,118
Texas,Crosby County,17,154,64,90
Texas,Crosby County,18,136,48,88
Texas,Culberson County,0,2266,1105,1161
Texas,Culberson County,1,170,92,78
Texas,Culberson County,2,153,73,80
Texas,Culberson County,3,161,78,83
Texas,Culberson County,4,141,77,64
Texas,Culberson County,5,142,64,78
Texas,Culberson County,6,146,75,71
Texas,Culberson County,7,122,63,59
Texas,Culberson County,8,113,57,56
Texas,Culberson County,9,129,60,69
Texas,Culberson County,10,141,67,74
Texas,Culberson County,11,154,76,78
Texas,Culberson County,12,168,82,86
Texas,Culberson County,13,146,60,86
Texas,Culberson County,14,129,58,71
Texas,Culberson County,15,84,45,39
Texas,Culberson County,16,59,27,32
Texas,Culberson County,17,56,26,30
Texas,Culberson County,18,52,25,27
Texas,Dallam County,0,7135,3676,3459
Texas,Dallam County,1,662,340,322
Texas,Dallam County,2,673,336,337
Texas,Dallam County,3,606,308,298
Texas,Dallam County,4,504,263,241
Texas,Dallam County,5,500,257,243
Texas,Dallam County,6,540,295,245
Texas,Dallam County,7,472,251,221
Texas,Dallam County,8,407,194,213
Texas,Dallam County,9,485,237,248
Texas,Dallam County,10,450,242,208
Texas,Dallam County,11,463,254,209
Texas,Dallam County,12,372,198,174
Texas,Dallam County,13,383,213,170
Texas,Dallam County,14,233,116,117
Texas,Dallam County,15,165,83,82
Texas,Dallam County,16,98,43,55
Texas,Dallam County,17,50,23,27
Texas,Dallam County,18,72,23,49
Texas,Dallas County,0,2518638,1241277,1277361
Texas,Dallas County,1,194213,99506,94707
Texas,Dallas County,2,194473,99376,95097
Texas,Dallas County,3,183886,93445,90441
Texas,Dallas County,4,168704,86086,82618
Texas,Dallas County,5,182493,91808,90685
Texas,Dallas County,6,204754,102045,102709
Texas,Dallas County,7,199775,99335,100440
Texas,Dallas County,8,180770,89835,90935
Texas,Dallas County,9,175469,86576,88893
Texas,Dallas County,10,162968,81677,81291
Texas,Dallas County,11,165007,82057,82950
Texas,Dallas County,12,146496,71549,74947
Texas,Dallas County,13,115790,54325,61465
Texas,Dallas County,14,86642,39692,46950
Texas,Dallas County,15,57997,25834,32163
Texas,Dallas County,16,40044,16927,23117
Texas,Dallas County,17,28969,11388,17581
Texas,Dallas County,18,30188,9816,20372
Texas,Dawson County,0,13372,7386,5986
Texas,Dawson County,1,946,498,448
Texas,Dawson County,2,993,508,485
Texas,Dawson County,3,918,496,422
Texas,Dawson County,4,852,462,390
Texas,Dawson County,5,1103,736,367
Texas,Dawson County,6,1141,804,337
Texas,Dawson County,7,1024,639,385
Texas,Dawson County,8,855,535,320
Texas,Dawson County,9,726,385,341
Texas,Dawson County,10,676,374,302
Texas,Dawson County,11,801,434,367
Texas,Dawson County,12,731,374,357
Texas,Dawson County,13,636,310,326
Texas,Dawson County,14,529,242,287
Texas,Dawson County,15,477,210,267
Texas,Dawson County,16,381,143,238
Texas,Dawson County,17,322,131,191
Texas,Dawson County,18,261,105,156
Texas,Deaf Smith County,0,19195,9521,9674
Texas,Deaf Smith County,1,1742,846,896
Texas,Deaf Smith County,2,1778,905,873
Texas,Deaf Smith County,3,1662,804,858
Texas,Deaf Smith County,4,1500,789,711
Texas,Deaf Smith County,5,1375,712,663
Texas,Deaf Smith County,6,1239,660,579
Texas,Deaf Smith County,7,1207,576,631
Texas,Deaf Smith County,8,1183,594,589
Texas,Deaf Smith County,9,1051,534,517
Texas,Deaf Smith County,10,1084,546,538
Texas,Deaf Smith County,11,1062,545,517
Texas,Deaf Smith County,12,1078,540,538
Texas,Deaf Smith County,13,958,471,487
Texas,Deaf Smith County,14,668,307,361
Texas,Deaf Smith County,15,531,253,278
Texas,Deaf Smith County,16,409,185,224
Texas,Deaf Smith County,17,313,117,196
Texas,Deaf Smith County,18,355,137,218
Texas,Delta County,0,5238,2593,2645
Texas,Delta County,1,277,135,142
Texas,Delta County,2,307,151,156
Texas,Delta County,3,345,180,165
Texas,Delta County,4,350,177,173
Texas,Delta County,5,277,146,131
Texas,Delta County,6,253,123,130
Texas,Delta County,7,275,131,144
Texas,Delta County,8,262,136,126
Texas,Delta County,9,286,143,143
Texas,Delta County,10,324,153,171
Texas,Delta County,11,365,189,176
Texas,Delta County,12,413,202,211
Texas,Delta County,13,353,176,177
Texas,Delta County,14,363,176,187
Texas,Delta County,15,331,163,168
Texas,Delta County,16,208,107,101
Texas,Delta County,17,123,70,53
Texas,Delta County,18,126,35,91
Texas,Denton County,0,753363,370582,382781
Texas,Denton County,1,49834,25625,24209
Texas,Denton County,2,56158,28862,27296
Texas,Denton County,3,57724,29471,28253
Texas,Denton County,4,53240,26751,26489
Texas,Denton County,5,52175,25715,26460
Texas,Denton County,6,56373,27632,28741
Texas,Denton County,7,56961,27877,29084
Texas,Denton County,8,57353,27675,29678
Texas,Denton County,9,61480,30422,31058
Texas,Denton County,10,55218,27535,27683
Texas,Denton County,11,54311,26934,27377
Texas,Denton County,12,43666,21177,22489
Texas,Denton County,13,33164,15690,17474
Texas,Denton County,14,26301,12384,13917
Texas,Denton County,15,16907,7853,9054
Texas,Denton County,16,9985,4465,5520
Texas,Denton County,17,6339,2484,3855
Texas,Denton County,18,6174,2030,4144
Texas,DeWitt County,0,20684,10783,9901
Texas,DeWitt County,1,1315,684,631
Texas,DeWitt County,2,1249,629,620
Texas,DeWitt County,3,1236,645,591
Texas,DeWitt County,4,1211,618,593
Texas,DeWitt County,5,1078,564,514
Texas,DeWitt County,6,1151,619,532
Texas,DeWitt County,7,1240,738,502
Texas,DeWitt County,8,1263,749,514
Texas,DeWitt County,9,1291,768,523
Texas,DeWitt County,10,1306,738,568
Texas,DeWitt County,11,1553,876,677
Texas,DeWitt County,12,1440,748,692
Texas,DeWitt County,13,1345,687,658
Texas,DeWitt County,14,1178,561,617
Texas,DeWitt County,15,878,395,483
Texas,DeWitt County,16,741,333,408
Texas,DeWitt County,17,592,238,354
Texas,DeWitt County,18,617,193,424
Texas,Dickens County,0,2218,1277,941
Texas,Dickens County,1,137,69,68
Texas,Dickens County,2,96,45,51
Texas,Dickens County,3,126,63,63
Texas,Dickens County,4,116,78,38
Texas,Dickens County,5,135,103,32
Texas,Dickens County,6,132,103,29
Texas,Dickens County,7,160,116,44
Texas,Dickens County,8,149,90,59
Texas,Dickens County,9,153,101,52
Texas,Dickens County,10,100,56,44
Texas,Dickens County,11,148,81,67
Texas,Dickens County,12,160,83,77
Texas,Dickens County,13,142,67,75
Texas,Dickens County,14,130,53,77
Texas,Dickens County,15,112,55,57
Texas,Dickens County,16,92,41,51
Texas,Dickens County,17,74,39,35
Texas,Dickens County,18,56,34,22
Texas,Dimmit County,0,11089,5441,5648
Texas,Dimmit County,1,916,449,467
Texas,Dimmit County,2,963,483,480
Texas,Dimmit County,3,937,474,463
Texas,Dimmit County,4,839,391,448
Texas,Dimmit County,5,797,407,390
Texas,Dimmit County,6,704,387,317
Texas,Dimmit County,7,664,332,332
Texas,Dimmit County,8,631,308,323
Texas,Dimmit County,9,602,291,311
Texas,Dimmit County,10,581,279,302
Texas,Dimmit County,11,649,326,323
Texas,Dimmit County,12,637,335,302
Texas,Dimmit County,13,579,260,319
Texas,Dimmit County,14,549,259,290
Texas,Dimmit County,15,354,167,187
Texas,Dimmit County,16,264,122,142
Texas,Dimmit County,17,220,101,119
Texas,Dimmit County,18,203,70,133
Texas,Donley County,0,3543,1719,1824
Texas,Donley County,1,197,80,117
Texas,Donley County,2,208,103,105
Texas,Donley County,3,166,84,82
Texas,Donley County,4,354,197,157
Texas,Donley County,5,262,132,130
Texas,Donley County,6,147,71,76
Texas,Donley County,7,190,101,89
Texas,Donley County,8,157,74,83
Texas,Donley County,9,161,88,73
Texas,Donley County,10,161,75,86
Texas,Donley County,11,232,115,117
Texas,Donley County,12,233,118,115
Texas,Donley County,13,249,124,125
Texas,Donley County,14,223,101,122
Texas,Donley County,15,222,105,117
Texas,Donley County,16,166,68,98
Texas,Donley County,17,100,50,50
Texas,Donley County,18,115,33,82
Texas,Duval County,0,11533,5950,5583
Texas,Duval County,1,835,410,425
Texas,Duval County,2,846,420,426
Texas,Duval County,3,787,400,387
Texas,Duval County,4,857,435,422
Texas,Duval County,5,881,528,353
Texas,Duval County,6,728,419,309
Texas,Duval County,7,688,359,329
Texas,Duval County,8,667,367,300
Texas,Duval County,9,643,342,301
Texas,Duval County,10,670,370,300
Texas,Duval County,11,749,391,358
Texas,Duval County,12,642,325,317
Texas,Duval County,13,561,289,272
Texas,Duval County,14,586,287,299
Texas,Duval County,15,494,229,265
Texas,Duval County,16,384,177,207
Texas,Duval County,17,282,127,155
Texas,Duval County,18,233,75,158
Texas,Eastland County,0,18176,8934,9242
Texas,Eastland County,1,1008,515,493
Texas,Eastland County,2,1070,527,543
Texas,Eastland County,3,1112,593,519
Texas,Eastland County,4,1459,785,674
Texas,Eastland County,5,1191,652,539
Texas,Eastland County,6,915,466,449
Texas,Eastland County,7,990,479,511
Texas,Eastland County,8,922,468,454
Texas,Eastland County,9,900,427,473
Texas,Eastland County,10,945,442,503
Texas,Eastland County,11,1285,641,644
Texas,Eastland County,12,1357,688,669
Texas,Eastland County,13,1181,583,598
Texas,Eastland County,14,1164,521,643
Texas,Eastland County,15,952,436,516
Texas,Eastland County,16,717,331,386
Texas,Eastland County,17,513,209,304
Texas,Eastland County,18,495,171,324
Texas,Ector County,0,153904,77519,76385
Texas,Ector County,1,13899,7093,6806
Texas,Ector County,2,13280,6768,6512
Texas,Ector County,3,12089,6201,5888
Texas,Ector County,4,10639,5418,5221
Texas,Ector County,5,12967,6680,6287
Texas,Ector County,6,13093,6884,6209
Texas,Ector County,7,11831,6244,5587
Texas,Ector County,8,9575,5002,4573
Texas,Ector County,9,8840,4380,4460
Texas,Ector County,10,8430,4183,4247
Texas,Ector County,11,9139,4548,4591
Texas,Ector County,12,8664,4278,4386
Texas,Ector County,13,6707,3362,3345
Texas,Ector County,14,4887,2346,2541
Texas,Ector County,15,3479,1550,1929
Texas,Ector County,16,2774,1261,1513
Texas,Ector County,17,1975,772,1203
Texas,Ector County,18,1636,549,1087
Texas,Edwards County,0,1879,946,933
Texas,Edwards County,1,106,47,59
Texas,Edwards County,2,106,52,54
Texas,Edwards County,3,108,63,45
Texas,Edwards County,4,104,54,50
Texas,Edwards County,5,94,46,48
Texas,Edwards County,6,81,47,34
Texas,Edwards County,7,83,41,42
Texas,Edwards County,8,81,37,44
Texas,Edwards County,9,95,44,51
Texas,Edwards County,10,86,44,42
Texas,Edwards County,11,133,61,72
Texas,Edwards County,12,133,59,74
Texas,Edwards County,13,180,93,87
Texas,Edwards County,14,163,95,68
Texas,Edwards County,15,132,64,68
Texas,Edwards County,16,88,49,39
Texas,Edwards County,17,59,31,28
Texas,Edwards County,18,47,19,28
Texas,Ellis County,0,159317,78682,80635
Texas,Ellis County,1,10252,5407,4845
Texas,Ellis County,2,12165,6257,5908
Texas,Ellis County,3,12829,6520,6309
Texas,Ellis County,4,12250,6337,5913
Texas,Ellis County,5,10576,5415,5161
Texas,Ellis County,6,9709,4793,4916
Texas,Ellis County,7,9966,4780,5186
Texas,Ellis County,8,10103,4920,5183
Texas,Ellis County,9,11120,5370,5750
Texas,Ellis County,10,10786,5394,5392
Texas,Ellis County,11,11471,5621,5850
Texas,Ellis County,12,10526,5266,5260
Texas,Ellis County,13,8641,4125,4516
Texas,Ellis County,14,7055,3363,3692
Texas,Ellis County,15,4799,2272,2527
Texas,Ellis County,16,3081,1385,1696
Texas,Ellis County,17,2084,814,1270
Texas,Ellis County,18,1904,643,1261
Texas,El Paso County,0,833487,408298,425189
Texas,El Paso County,1,67808,34497,33311
Texas,El Paso County,2,63952,32366,31586
Texas,El Paso County,3,65001,32999,32002
Texas,El Paso County,4,64862,33345,31517
Texas,El Paso County,5,72436,38659,33777
Texas,El Paso County,6,62269,32584,29685
Texas,El Paso County,7,56448,28417,28031
Texas,El Paso County,8,51307,25161,26146
Texas,El Paso County,9,53322,25551,27771
Texas,El Paso County,10,48773,23148,25625
Texas,El Paso County,11,49942,23397,26545
Texas,El Paso County,12,46068,21320,24748
Texas,El Paso County,13,37228,17063,20165
Texas,El Paso County,14,29967,13807,16160
Texas,El Paso County,15,21914,9474,12440
Texas,El Paso County,16,17033,7076,9957
Texas,El Paso County,17,12857,5039,7818
Texas,El Paso County,18,12300,4395,7905
Texas,Erath County,0,40147,19706,20441
Texas,Erath County,1,2416,1196,1220
Texas,Erath County,2,2311,1179,1132
Texas,Erath County,3,2313,1195,1118
Texas,Erath County,4,4174,1940,2234
Texas,Erath County,5,5902,2950,2952
Texas,Erath County,6,2688,1406,1282
Texas,Erath County,7,2150,1083,1067
Texas,Erath County,8,1987,1000,987
Texas,Erath County,9,2022,960,1062
Texas,Erath County,10,2074,1038,1036
Texas,Erath County,11,2395,1207,1188
Texas,Erath County,12,2198,1101,1097
Texas,Erath County,13,2003,972,1031
Texas,Erath County,14,1811,878,933
Texas,Erath County,15,1329,648,681
Texas,Erath County,16,939,410,529
Texas,Erath County,17,741,309,432
Texas,Erath County,18,694,234,460
Texas,Falls County,0,16989,8101,8888
Texas,Falls County,1,1063,516,547
Texas,Falls County,2,973,507,466
Texas,Falls County,3,1000,524,476
Texas,Falls County,4,930,473,457
Texas,Falls County,5,1176,613,563
Texas,Falls County,6,1196,572,624
Texas,Falls County,7,1114,471,643
Texas,Falls County,8,967,410,557
Texas,Falls County,9,1041,456,585
Texas,Falls County,10,1110,493,617
Texas,Falls County,11,1264,592,672
Texas,Falls County,12,1136,558,578
Texas,Falls County,13,1076,540,536
Texas,Falls County,14,857,409,448
Texas,Falls County,15,720,352,368
Texas,Falls County,16,558,271,287
Texas,Falls County,17,416,174,242
Texas,Falls County,18,392,170,222
Texas,Fannin County,0,33752,17889,15863
Texas,Fannin County,1,1782,903,879
Texas,Fannin County,2,1979,1011,968
Texas,Fannin County,3,2086,1066,1020
Texas,Fannin County,4,1941,1039,902
Texas,Fannin County,5,2227,1344,883
Texas,Fannin County,6,2006,1198,808
Texas,Fannin County,7,2042,1209,833
Texas,Fannin County,8,1956,1076,880
Texas,Fannin County,9,2175,1181,994
Texas,Fannin County,10,2138,1155,983
Texas,Fannin County,11,2573,1354,1219
Texas,Fannin County,12,2362,1232,1130
Texas,Fannin County,13,2138,1096,1042
Texas,Fannin County,14,2093,1050,1043
Texas,Fannin County,15,1603,767,836
Texas,Fannin County,16,1173,577,596
Texas,Fannin County,17,768,348,420
Texas,Fannin County,18,710,283,427
Texas,Fayette County,0,24833,12206,12627
Texas,Fayette County,1,1249,644,605
Texas,Fayette County,2,1506,770,736
Texas,Fayette County,3,1495,729,766
Texas,Fayette County,4,1511,765,746
Texas,Fayette County,5,1224,639,585
Texas,Fayette County,6,1103,537,566
Texas,Fayette County,7,1191,567,624
Texas,Fayette County,8,1214,616,598
Texas,Fayette County,9,1270,653,617
Texas,Fayette County,10,1387,665,722
Texas,Fayette County,11,1943,962,981
Texas,Fayette County,12,1917,962,955
Texas,Fayette County,13,1924,957,967
Texas,Fayette County,14,1743,886,857
Texas,Fayette County,15,1422,691,731
Texas,Fayette County,16,1080,545,535
Texas,Fayette County,17,747,311,436
Texas,Fayette County,18,907,307,600
Texas,Fisher County,0,3831,1901,1930
Texas,Fisher County,1,170,72,98
Texas,Fisher County,2,237,124,113
Texas,Fisher County,3,228,123,105
Texas,Fisher County,4,262,134,128
Texas,Fisher County,5,217,118,99
Texas,Fisher County,6,170,89,81
Texas,Fisher County,7,194,94,100
Texas,Fisher County,8,163,90,73
Texas,Fisher County,9,240,115,125
Texas,Fisher County,10,207,101,106
Texas,Fisher County,11,287,150,137
Texas,Fisher County,12,299,152,147
Texas,Fisher County,13,273,136,137
Texas,Fisher County,14,249,127,122
Texas,Fisher County,15,201,83,118
Texas,Fisher County,16,203,98,105
Texas,Fisher County,17,135,63,72
Texas,Fisher County,18,96,32,64
Texas,Floyd County,0,5949,2955,2994
Texas,Floyd County,1,459,230,229
Texas,Floyd County,2,441,228,213
Texas,Floyd County,3,420,233,187
Texas,Floyd County,4,453,229,224
Texas,Floyd County,5,340,169,171
Texas,Floyd County,6,289,158,131
Texas,Floyd County,7,345,173,172
Texas,Floyd County,8,304,135,169
Texas,Floyd County,9,351,192,159
Texas,Floyd County,10,304,155,149
Texas,Floyd County,11,396,192,204
Texas,Floyd County,12,378,201,177
Texas,Floyd County,13,354,178,176
Texas,Floyd County,14,285,129,156
Texas,Floyd County,15,279,116,163
Texas,Floyd County,16,212,96,116
Texas,Floyd County,17,183,70,113
Texas,Floyd County,18,156,71,85
Texas,Foard County,0,1275,620,655
Texas,Foard County,1,61,23,38
Texas,Foard County,2,81,42,39
Texas,Foard County,3,94,47,47
Texas,Foard County,4,72,33,39
Texas,Foard County,5,63,28,35
Texas,Foard County,6,53,26,27
Texas,Foard County,7,58,30,28
Texas,Foard County,8,55,26,29
Texas,Foard County,9,70,37,33
Texas,Foard County,10,83,45,38
Texas,Foard County,11,111,62,49
Texas,Foard County,12,72,34,38
Texas,Foard County,13,85,48,37
Texas,Foard County,14,82,35,47
Texas,Foard County,15,81,41,40
Texas,Foard County,16,67,28,39
Texas,Foard County,17,46,21,25
Texas,Foard County,18,41,14,27
Texas,Fort Bend County,0,685345,336840,348505
Texas,Fort Bend County,1,46224,23670,22554
Texas,Fort Bend County,2,54288,27827,26461
Texas,Fort Bend County,3,57222,29403,27819
Texas,Fort Bend County,4,50877,26198,24679
Texas,Fort Bend County,5,41082,21231,19851
Texas,Fort Bend County,6,38699,19097,19602
Texas,Fort Bend County,7,47025,22249,24776
Texas,Fort Bend County,8,50126,23635,26491
Texas,Fort Bend County,9,54554,26072,28482
Texas,Fort Bend County,10,49498,24157,25341
Texas,Fort Bend County,11,48673,23642,25031
Texas,Fort Bend County,12,46086,22666,23420
Texas,Fort Bend County,13,36325,17605,18720
Texas,Fort Bend County,14,26388,12742,13646
Texas,Fort Bend County,15,15963,7566,8397
Texas,Fort Bend County,16,9916,4442,5474
Texas,Fort Bend County,17,6255,2544,3711
Texas,Fort Bend County,18,6144,2094,4050
Texas,Franklin County,0,10600,5196,5404
Texas,Franklin County,1,621,309,312
Texas,Franklin County,2,775,384,391
Texas,Franklin County,3,744,396,348
Texas,Franklin County,4,635,317,318
Texas,Franklin County,5,544,265,279
Texas,Franklin County,6,583,267,316
Texas,Franklin County,7,576,282,294
Texas,Franklin County,8,505,250,255
Texas,Franklin County,9,563,291,272
Texas,Franklin County,10,653,317,336
Texas,Franklin County,11,755,388,367
Texas,Franklin County,12,744,371,373
Texas,Franklin County,13,748,356,392
Texas,Franklin County,14,724,344,380
Texas,Franklin County,15,533,263,270
Texas,Franklin County,16,396,194,202
Texas,Franklin County,17,264,118,146
Texas,Franklin County,18,237,84,153
Texas,Freestone County,0,19762,10239,9523
Texas,Freestone County,1,1161,534,627
Texas,Freestone County,2,1269,662,607
Texas,Freestone County,3,1390,686,704
Texas,Freestone County,4,1159,605,554
Texas,Freestone County,5,973,501,472
Texas,Freestone County,6,1078,586,492
Texas,Freestone County,7,1203,668,535
Texas,Freestone County,8,1284,736,548
Texas,Freestone County,9,1338,792,546
Texas,Freestone County,10,1252,724,528
Texas,Freestone County,11,1393,757,636
Texas,Freestone County,12,1392,721,671
Texas,Freestone County,13,1273,643,630
Texas,Freestone County,14,1160,562,598
Texas,Freestone County,15,922,425,497
Texas,Freestone County,16,651,313,338
Texas,Freestone County,17,434,181,253
Texas,Freestone County,18,430,143,287
Texas,Frio County,0,18531,10881,7650
Texas,Frio County,1,1305,669,636
Texas,Frio County,2,1290,678,612
Texas,Frio County,3,1199,593,606
Texas,Frio County,4,1300,754,546
Texas,Frio County,5,1913,1366,547
Texas,Frio County,6,1759,1304,455
Texas,Frio County,7,1585,1118,467
Texas,Frio County,8,1188,779,409
Texas,Frio County,9,1091,647,444
Texas,Frio County,10,1036,571,465
Texas,Frio County,11,993,537,456
Texas,Frio County,12,947,496,451
Texas,Frio County,13,783,391,392
Texas,Frio County,14,729,355,374
Texas,Frio County,15,509,245,264
Texas,Frio County,16,384,178,206
Texas,Frio County,17,277,121,156
Texas,Frio County,18,243,79,164
Texas,Gaines County,0,19425,9836,9589
Texas,Gaines County,1,1922,1004,918
Texas,Gaines County,2,1995,992,1003
Texas,Gaines County,3,1874,940,934
Texas,Gaines County,4,1600,803,797
Texas,Gaines County,5,1309,690,619
Texas,Gaines County,6,1400,727,673
Texas,Gaines County,7,1271,645,626
Texas,Gaines County,8,1213,618,595
Texas,Gaines County,9,1045,518,527
Texas,Gaines County,10,1020,509,511
Texas,Gaines County,11,1220,624,596
Texas,Gaines County,12,1016,544,472
Texas,Gaines County,13,728,363,365
Texas,Gaines County,14,551,281,270
Texas,Gaines County,15,420,189,231
Texas,Gaines County,16,377,179,198
Texas,Gaines County,17,257,123,134
Texas,Gaines County,18,207,87,120
Texas,Galveston County,0,314198,155220,158978
Texas,Galveston County,1,20230,10421,9809
Texas,Galveston County,2,21726,11136,10590
Texas,Galveston County,3,22116,11363,10753
Texas,Galveston County,4,21262,11136,10126
Texas,Galveston County,5,20309,10314,9995
Texas,Galveston County,6,20374,10164,10210
Texas,Galveston County,7,21155,10377,10778
Texas,Galveston County,8,19986,9826,10160
Texas,Galveston County,9,20759,10094,10665
Texas,Galveston County,10,20854,10245,10609
Texas,Galveston County,11,23755,11599,12156
Texas,Galveston County,12,22655,11208,11447
Texas,Galveston County,13,18897,9238,9659
Texas,Galveston County,14,14415,7068,7347
Texas,Galveston County,15,9885,4581,5304
Texas,Galveston County,16,6643,2954,3689
Texas,Galveston County,17,4611,1891,2720
Texas,Galveston County,18,4566,1605,2961
Texas,Garza County,0,6435,4155,2280
Texas,Garza County,1,294,149,145
Texas,Garza County,2,339,164,175
Texas,Garza County,3,299,161,138
Texas,Garza County,4,484,331,153
Texas,Garza County,5,664,531,133
Texas,Garza County,6,758,585,173
Texas,Garza County,7,504,367,137
Texas,Garza County,8,354,220,134
Texas,Garza County,9,430,272,158
Texas,Garza County,10,502,364,138
Texas,Garza County,11,388,230,158
Texas,Garza County,12,446,335,111
Texas,Garza County,13,238,104,134
Texas,Garza County,14,212,99,113
Texas,Garza County,15,174,84,90
Texas,Garza County,16,164,81,83
Texas,Garza County,17,114,56,58
Texas,Garza County,18,71,22,49
Texas,Gillespie County,0,25520,12378,13142
Texas,Gillespie County,1,1264,660,604
Texas,Gillespie County,2,1344,710,634
Texas,Gillespie County,3,1449,763,686
Texas,Gillespie County,4,1418,723,695
Texas,Gillespie County,5,1213,615,598
Texas,Gillespie County,6,1069,555,514
Texas,Gillespie County,7,1104,553,551
Texas,Gillespie County,8,1096,532,564
Texas,Gillespie County,9,1245,630,615
Texas,Gillespie County,10,1305,625,680
Texas,Gillespie County,11,1783,847,936
Texas,Gillespie County,12,1865,850,1015
Texas,Gillespie County,13,2104,960,1144
Texas,Gillespie County,14,2037,954,1083
Texas,Gillespie County,15,1761,851,910
Texas,Gillespie County,16,1368,687,681
Texas,Gillespie County,17,968,415,553
Texas,Gillespie County,18,1127,448,679
Texas,Glasscock County,0,1291,700,591
Texas,Glasscock County,1,78,32,46
Texas,Glasscock County,2,85,42,43
Texas,Glasscock County,3,105,55,50
Texas,Glasscock County,4,108,67,41
Texas,Glasscock County,5,80,39,41
Texas,Glasscock County,6,53,31,22
Texas,Glasscock County,7,75,44,31
Texas,Glasscock County,8,92,48,44
Texas,Glasscock County,9,98,59,39
Texas,Glasscock County,10,71,40,31
Texas,Glasscock County,11,89,40,49
Texas,Glasscock County,12,97,53,44
Texas,Glasscock County,13,74,44,30
Texas,Glasscock County,14,66,41,25
Texas,Glasscock County,15,51,26,25
Texas,Glasscock County,16,38,21,17
Texas,Glasscock County,17,22,12,10
Texas,Glasscock County,18,9,6,3
Texas,Goliad County,0,7549,3767,3782
Texas,Goliad County,1,357,164,193
Texas,Goliad County,2,438,248,190
Texas,Goliad County,3,518,262,256
Texas,Goliad County,4,488,252,236
Texas,Goliad County,5,439,242,197
Texas,Goliad County,6,329,166,163
Texas,Goliad County,7,400,190,210
Texas,Goliad County,8,361,162,199
Texas,Goliad County,9,427,220,207
Texas,Goliad County,10,476,233,243
Texas,Goliad County,11,563,271,292
Texas,Goliad County,12,624,319,305
Texas,Goliad County,13,595,292,303
Texas,Goliad County,14,504,261,243
Texas,Goliad County,15,375,192,183
Texas,Goliad County,16,253,121,132
Texas,Goliad County,17,184,83,101
Texas,Goliad County,18,218,89,129
Texas,Gonzales County,0,20462,10339,10123
Texas,Gonzales County,1,1448,735,713
Texas,Gonzales County,2,1564,828,736
Texas,Gonzales County,3,1554,772,782
Texas,Gonzales County,4,1351,733,618
Texas,Gonzales County,5,1337,699,638
Texas,Gonzales County,6,1275,658,617
Texas,Gonzales County,7,1149,603,546
Texas,Gonzales County,8,1118,558,560
Texas,Gonzales County,9,1171,580,591
Texas,Gonzales County,10,1207,605,602
Texas,Gonzales County,11,1397,718,679
Texas,Gonzales County,12,1439,748,691
Texas,Gonzales County,13,1148,584,564
Texas,Gonzales County,14,1010,498,512
Texas,Gonzales County,15,825,397,428
Texas,Gonzales County,16,635,301,334
Texas,Gonzales County,17,418,172,246
Texas,Gonzales County,18,416,150,266
Texas,Gray County,0,23044,12109,10935
Texas,Gray County,1,1682,915,767
Texas,Gray County,2,1743,888,855
Texas,Gray County,3,1599,794,805
Texas,Gray County,4,1401,705,696
Texas,Gray County,5,1394,736,658
Texas,Gray County,6,1514,829,685
Texas,Gray County,7,1561,877,684
Texas,Gray County,8,1480,850,630
Texas,Gray County,9,1479,888,591
Texas,Gray County,10,1451,840,611
Texas,Gray County,11,1523,850,673
Texas,Gray County,12,1463,766,697
Texas,Gray County,13,1227,617,610
Texas,Gray County,14,1003,488,515
Texas,Gray County,15,842,383,459
Texas,Gray County,16,690,296,394
Texas,Gray County,17,521,204,317
Texas,Gray County,18,471,183,288
Texas,Grayson County,0,123534,60296,63238
Texas,Grayson County,1,7593,3994,3599
Texas,Grayson County,2,8422,4288,4134
Texas,Grayson County,3,8327,4236,4091
Texas,Grayson County,4,8211,4189,4022
Texas,Grayson County,5,7948,4031,3917
Texas,Grayson County,6,7322,3552,3770
Texas,Grayson County,7,7248,3555,3693
Texas,Grayson County,8,6695,3283,3412
Texas,Grayson County,9,7491,3634,3857
Texas,Grayson County,10,7662,3745,3917
Texas,Grayson County,11,9063,4452,4611
Texas,Grayson County,12,9002,4356,4646
Texas,Grayson County,13,7580,3601,3979
Texas,Grayson County,14,6915,3287,3628
Texas,Grayson County,15,5187,2458,2729
Texas,Grayson County,16,3703,1657,2046
Texas,Grayson County,17,2719,1133,1586
Texas,Grayson County,18,2446,845,1601
Texas,Gregg County,0,123204,60332,62872
Texas,Gregg County,1,9418,4788,4630
Texas,Gregg County,2,9002,4707,4295
Texas,Gregg County,3,8371,4297,4074
Texas,Gregg County,4,8324,4360,3964
Texas,Gregg County,5,9336,4791,4545
Texas,Gregg County,6,8486,4225,4261
Texas,Gregg County,7,8386,4145,4241
Texas,Gregg County,8,7428,3749,3679
Texas,Gregg County,9,7199,3463,3736
Texas,Gregg County,10,7058,3453,3605
Texas,Gregg County,11,8018,3837,4181
Texas,Gregg County,12,8038,3983,4055
Texas,Gregg County,13,6677,3192,3485
Texas,Gregg County,14,5328,2443,2885
Texas,Gregg County,15,4041,1794,2247
Texas,Gregg County,16,3211,1343,1868
Texas,Gregg County,17,2401,947,1454
Texas,Gregg County,18,2482,815,1667
Texas,Grimes County,0,27172,14820,12352
Texas,Grimes County,1,1509,790,719
Texas,Grimes County,2,1702,888,814
Texas,Grimes County,3,1772,855,917
Texas,Grimes County,4,1572,796,776
Texas,Grimes County,5,1760,1078,682
Texas,Grimes County,6,1707,1041,666
Texas,Grimes County,7,1684,980,704
Texas,Grimes County,8,1654,951,703
Texas,Grimes County,9,1726,1009,717
Texas,Grimes County,10,1786,1051,735
Texas,Grimes County,11,2024,1131,893
Texas,Grimes County,12,2066,1096,970
Texas,Grimes County,13,1849,1005,844
Texas,Grimes County,14,1538,836,702
Texas,Grimes County,15,1163,623,540
Texas,Grimes County,16,718,330,388
Texas,Grimes County,17,470,212,258
Texas,Grimes County,18,472,148,324
Texas,Guadalupe County,0,147250,72702,74548
Texas,Guadalupe County,1,9349,4795,4554
Texas,Guadalupe County,2,10744,5603,5141
Texas,Guadalupe County,3,11309,5698,5611
Texas,Guadalupe County,4,11258,5798,5460
Texas,Guadalupe County,5,9227,4668,4559
Texas,Guadalupe County,6,8549,4351,4198
Texas,Guadalupe County,7,9831,4885,4946
Texas,Guadalupe County,8,9936,4801,5135
Texas,Guadalupe County,9,10479,5107,5372
Texas,Guadalupe County,10,10358,5083,5275
Texas,Guadalupe County,11,10501,5159,5342
Texas,Guadalupe County,12,9041,4419,4622
Texas,Guadalupe County,13,7522,3605,3917
Texas,Guadalupe County,14,6620,3169,3451
Texas,Guadalupe County,15,4826,2310,2516
Texas,Guadalupe County,16,3344,1532,1812
Texas,Guadalupe County,17,2266,985,1281
Texas,Guadalupe County,18,2090,734,1356
Texas,Hale County,0,34720,18016,16704
Texas,Hale County,1,2782,1341,1441
Texas,Hale County,2,2657,1360,1297
Texas,Hale County,3,2659,1362,1297
Texas,Hale County,4,2684,1409,1275
Texas,Hale County,5,2904,1655,1249
Texas,Hale County,6,2483,1433,1050
Texas,Hale County,7,2283,1266,1017
Texas,Hale County,8,1979,1078,901
Texas,Hale County,9,2037,1062,975
Texas,Hale County,10,2050,1103,947
Texas,Hale County,11,2126,1107,1019
Texas,Hale County,12,1993,980,1013
Texas,Hale County,13,1580,816,764
Texas,Hale County,14,1300,633,667
Texas,Hale County,15,1116,516,600
Texas,Hale County,16,805,361,444
Texas,Hale County,17,673,296,377
Texas,Hale County,18,609,238,371
Texas,Hall County,0,3147,1536,1611
Texas,Hall County,1,170,69,101
Texas,Hall County,2,213,119,94
Texas,Hall County,3,202,100,102
Texas,Hall County,4,236,126,110
Texas,Hall County,5,187,99,88
Texas,Hall County,6,141,73,68
Texas,Hall County,7,156,75,81
Texas,Hall County,8,146,53,93
Texas,Hall County,9,143,60,83
Texas,Hall County,10,182,100,82
Texas,Hall County,11,212,116,96
Texas,Hall County,12,216,102,114
Texas,Hall County,13,200,88,112
Texas,Hall County,14,209,105,104
Texas,Hall County,15,184,87,97
Texas,Hall County,16,149,75,74
Texas,Hall County,17,104,45,59
Texas,Hall County,18,97,44,53
Texas,Hamilton County,0,8199,4024,4175
Texas,Hamilton County,1,423,202,221
Texas,Hamilton County,2,459,240,219
Texas,Hamilton County,3,483,244,239
Texas,Hamilton County,4,486,264,222
Texas,Hamilton County,5,435,213,222
Texas,Hamilton County,6,390,205,185
Texas,Hamilton County,7,369,187,182
Texas,Hamilton County,8,394,206,188
Texas,Hamilton County,9,438,216,222
Texas,Hamilton County,10,434,229,205
Texas,Hamilton County,11,598,304,294
Texas,Hamilton County,12,593,287,306
Texas,Hamilton County,13,579,275,304
Texas,Hamilton County,14,580,277,303
Texas,Hamilton County,15,536,255,281
Texas,Hamilton County,16,410,199,211
Texas,Hamilton County,17,268,125,143
Texas,Hamilton County,18,324,96,228
Texas,Hansford County,0,5509,2794,2715
Texas,Hansford County,1,382,196,186
Texas,Hansford County,2,489,253,236
Texas,Hansford County,3,478,249,229
Texas,Hansford County,4,392,189,203
Texas,Hansford County,5,338,177,161
Texas,Hansford County,6,296,161,135
Texas,Hansford County,7,298,148,150
Texas,Hansford County,8,317,154,163
Texas,Hansford County,9,358,191,167
Texas,Hansford County,10,328,172,156
Texas,Hansford County,11,382,208,174
Texas,Hansford County,12,341,170,171
Texas,Hansford County,13,309,168,141
Texas,Hansford County,14,237,114,123
Texas,Hansford County,15,195,103,92
Texas,Hansford County,16,163,70,93
Texas,Hansford County,17,116,46,70
Texas,Hansford County,18,90,25,65
Texas,Hardeman County,0,3928,2001,1927
Texas,Hardeman County,1,248,149,99
Texas,Hardeman County,2,262,149,113
Texas,Hardeman County,3,242,123,119
Texas,Hardeman County,4,265,146,119
Texas,Hardeman County,5,184,86,98
Texas,Hardeman County,6,187,102,85
Texas,Hardeman County,7,237,119,118
Texas,Hardeman County,8,222,105,117
Texas,Hardeman County,9,245,123,122
Texas,Hardeman County,10,234,117,117
Texas,Hardeman County,11,245,128,117
Texas,Hardeman County,12,299,156,143
Texas,Hardeman County,13,282,145,137
Texas,Hardeman County,14,228,99,129
Texas,Hardeman County,15,204,103,101
Texas,Hardeman County,16,148,73,75
Texas,Hardeman County,17,99,49,50
Texas,Hardeman County,18,97,29,68
Texas,Hardin County,0,55621,27504,28117
Texas,Hardin County,1,3579,1856,1723
Texas,Hardin County,2,3846,2005,1841
Texas,Hardin County,3,3962,2029,1933
Texas,Hardin County,4,3642,1952,1690
Texas,Hardin County,5,3324,1715,1609
Texas,Hardin County,6,3343,1645,1698
Texas,Hardin County,7,3576,1778,1798
Texas,Hardin County,8,3408,1643,1765
Texas,Hardin County,9,3555,1730,1825
Texas,Hardin County,10,3592,1785,1807
Texas,Hardin County,11,3987,1964,2023
Texas,Hardin County,12,3964,1937,2027
Texas,Hardin County,13,3400,1653,1747
Texas,Hardin County,14,2853,1394,1459
Texas,Hardin County,15,2201,1009,1192
Texas,Hardin County,16,1473,648,825
Texas,Hardin County,17,1013,419,594
Texas,Hardin County,18,903,342,561
Texas,Harris County,0,4441370,2210767,2230603
Texas,Harris County,1,343888,175037,168851
Texas,Harris County,2,344177,175350,168827
Texas,Harris County,3,328237,167326,160911
Texas,Harris County,4,302462,155433,147029
Texas,Harris County,5,324735,165472,159263
Texas,Harris County,6,359470,182768,176702
Texas,Harris County,7,358923,181980,176943
Texas,Harris County,8,322888,162577,160311
Texas,Harris County,9,312852,156148,156704
Texas,Harris County,10,282996,141106,141890
Texas,Harris County,11,281880,139086,142794
Texas,Harris County,12,261019,127969,133050
Texas,Harris County,13,208760,100437,108323
Texas,Harris County,14,152260,72166,80094
Texas,Harris County,15,100221,45848,54373
Texas,Harris County,16,66121,28373,37748
Texas,Harris County,17,45630,18268,27362
Texas,Harris County,18,44851,15423,29428
Texas,Harrison County,0,67336,32920,34416
Texas,Harrison County,1,4428,2309,2119
Texas,Harrison County,2,4712,2437,2275
Texas,Harrison County,3,4847,2462,2385
Texas,Harrison County,4,4733,2461,2272
Texas,Harrison County,5,5128,2495,2633
Texas,Harrison County,6,3966,1888,2078
Texas,Harrison County,7,4124,2009,2115
Texas,Harrison County,8,3895,1909,1986
Texas,Harrison County,9,4112,2044,2068
Texas,Harrison County,10,3966,1914,2052
Texas,Harrison County,11,4663,2274,2389
Texas,Harrison County,12,4729,2363,2366
Texas,Harrison County,13,4031,1916,2115
Texas,Harrison County,14,3511,1681,1830
Texas,Harrison County,15,2409,1171,1238
Texas,Harrison County,16,1733,730,1003
Texas,Harrison County,17,1237,475,762
Texas,Harrison County,18,1112,382,730
Texas,Hartley County,0,6089,3754,2335
Texas,Hartley County,1,324,184,140
Texas,Hartley County,2,355,184,171
Texas,Hartley County,3,371,200,171
Texas,Hartley County,4,344,171,173
Texas,Hartley County,5,245,132,113
Texas,Hartley County,6,410,298,112
Texas,Hartley County,7,477,360,117
Texas,Hartley County,8,510,379,131
Texas,Hartley County,9,571,396,175
Texas,Hartley County,10,505,375,130
Texas,Hartley County,11,479,323,156
Texas,Hartley County,12,349,216,133
Texas,Hartley County,13,262,130,132
Texas,Hartley County,14,227,109,118
Texas,Hartley County,15,243,114,129
Texas,Hartley County,16,158,76,82
Texas,Hartley County,17,136,62,74
Texas,Hartley County,18,123,45,78
Texas,Haskell County,0,5769,3051,2718
Texas,Haskell County,1,296,146,150
Texas,Haskell County,2,313,144,169
Texas,Haskell County,3,351,191,160
Texas,Haskell County,4,341,218,123
Texas,Haskell County,5,368,208,160
Texas,Haskell County,6,329,208,121
Texas,Haskell County,7,354,217,137
Texas,Haskell County,8,350,205,145
Texas,Haskell County,9,294,161,133
Texas,Haskell County,10,298,158,140
Texas,Haskell County,11,433,216,217
Texas,Haskell County,12,398,206,192
Texas,Haskell County,13,395,213,182
Texas,Haskell County,14,340,165,175
Texas,Haskell County,15,297,135,162
Texas,Haskell County,16,227,113,114
Texas,Haskell County,17,182,75,107
Texas,Haskell County,18,203,72,131
Texas,Hays County,0,185025,92151,92874
Texas,Hays County,1,11180,5709,5471
Texas,Hays County,2,12430,6292,6138
Texas,Hays County,3,12664,6486,6178
Texas,Hays County,4,15900,7959,7941
Texas,Hays County,5,24006,11765,12241
Texas,Hays County,6,13147,6989,6158
Texas,Hays County,7,12765,6488,6277
Texas,Hays County,8,11888,6082,5806
Texas,Hays County,9,11812,5895,5917
Texas,Hays County,10,10569,5328,5241
Texas,Hays County,11,10941,5315,5626
Texas,Hays County,12,10237,4944,5293
Texas,Hays County,13,9034,4376,4658
Texas,Hays County,14,7279,3605,3674
Texas,Hays County,15,4516,2117,2399
Texas,Hays County,16,2928,1377,1551
Texas,Hays County,17,1879,794,1085
Texas,Hays County,18,1850,630,1220
Texas,Hemphill County,0,4180,2122,2058
Texas,Hemphill County,1,363,209,154
Texas,Hemphill County,2,386,193,193
Texas,Hemphill County,3,397,194,203
Texas,Hemphill County,4,284,153,131
Texas,Hemphill County,5,222,110,112
Texas,Hemphill County,6,239,112,127
Texas,Hemphill County,7,288,157,131
Texas,Hemphill County,8,258,119,139
Texas,Hemphill County,9,261,129,132
Texas,Hemphill County,10,232,125,107
Texas,Hemphill County,11,281,156,125
Texas,Hemphill County,12,217,108,109
Texas,Hemphill County,13,231,117,114
Texas,Hemphill County,14,175,87,88
Texas,Hemphill County,15,124,58,66
Texas,Hemphill County,16,82,29,53
Texas,Hemphill County,17,70,34,36
Texas,Hemphill County,18,70,32,38
Texas,Henderson County,0,79290,38704,40586
Texas,Henderson County,1,4373,2291,2082
Texas,Henderson County,2,4894,2459,2435
Texas,Henderson County,3,5008,2610,2398
Texas,Henderson County,4,5071,2640,2431
Texas,Henderson County,5,4577,2351,2226
Texas,Henderson County,6,4290,2118,2172
Texas,Henderson County,7,4112,2013,2099
Texas,Henderson County,8,4103,2026,2077
Texas,Henderson County,9,4560,2128,2432
Texas,Henderson County,10,4809,2400,2409
Texas,Henderson County,11,5651,2736,2915
Texas,Henderson County,12,5826,2786,3040
Texas,Henderson County,13,5513,2611,2902
Texas,Henderson County,14,5287,2459,2828
Texas,Henderson County,15,4348,1996,2352
Texas,Henderson County,16,3111,1536,1575
Texas,Henderson County,17,2132,949,1183
Texas,Henderson County,18,1625,595,1030
Texas,Hidalgo County,0,831073,405322,425751
Texas,Hidalgo County,1,80466,41153,39313
Texas,Hidalgo County,2,76654,38662,37992
Texas,Hidalgo County,3,78210,39506,38704
Texas,Hidalgo County,4,70747,35787,34960
Texas,Hidalgo County,5,65403,32804,32599
Texas,Hidalgo County,6,55052,27535,27517
Texas,Hidalgo County,7,54746,26745,28001
Texas,Hidalgo County,8,54610,26172,28438
Texas,Hidalgo County,9,53527,25505,28022
Texas,Hidalgo County,10,46505,22007,24498
Texas,Hidalgo County,11,41400,19781,21619
Texas,Hidalgo County,12,36194,16711,19483
Texas,Hidalgo County,13,31339,14260,17079
Texas,Hidalgo County,14,27329,12569,14760
Texas,Hidalgo County,15,20970,9622,11348
Texas,Hidalgo County,16,16018,7108,8910
Texas,Hidalgo County,17,11359,5036,6323
Texas,Hidalgo County,18,10544,4359,6185
Texas,Hill County,0,34848,17127,17721
Texas,Hill County,1,2099,1075,1024
Texas,Hill County,2,2334,1158,1176
Texas,Hill County,3,2439,1230,1209
Texas,Hill County,4,2372,1209,1163
Texas,Hill County,5,1964,1024,940
Texas,Hill County,6,1882,893,989
Texas,Hill County,7,1901,929,972
Texas,Hill County,8,1791,873,918
Texas,Hill County,9,1894,930,964
Texas,Hill County,10,2105,1046,1059
Texas,Hill County,11,2387,1150,1237
Texas,Hill County,12,2368,1146,1222
Texas,Hill County,13,2301,1129,1172
Texas,Hill County,14,2207,1077,1130
Texas,Hill County,15,1825,924,901
Texas,Hill County,16,1250,638,612
Texas,Hill County,17,854,382,472
Texas,Hill County,18,875,314,561
Texas,Hockley County,0,23577,11658,11919
Texas,Hockley County,1,1755,917,838
Texas,Hockley County,2,1804,901,903
Texas,Hockley County,3,1785,909,876
Texas,Hockley County,4,1939,946,993
Texas,Hockley County,5,1984,1052,932
Texas,Hockley County,6,1564,797,767
Texas,Hockley County,7,1562,785,777
Texas,Hockley County,8,1295,649,646
Texas,Hockley County,9,1247,583,664
Texas,Hockley County,10,1297,640,657
Texas,Hockley County,11,1508,710,798
Texas,Hockley County,12,1411,747,664
Texas,Hockley County,13,1236,619,617
Texas,Hockley County,14,1017,490,527
Texas,Hockley County,15,781,345,436
Texas,Hockley County,16,620,265,355
Texas,Hockley County,17,429,174,255
Texas,Hockley County,18,343,129,214
Texas,Hood County,0,53921,26480,27441
Texas,Hood County,1,2787,1437,1350
Texas,Hood County,2,3136,1630,1506
Texas,Hood County,3,3152,1606,1546
Texas,Hood County,4,3065,1682,1383
Texas,Hood County,5,2718,1376,1342
Texas,Hood County,6,2819,1439,1380
Texas,Hood County,7,2833,1406,1427
Texas,Hood County,8,2547,1247,1300
Texas,Hood County,9,2808,1396,1412
Texas,Hood County,10,3066,1480,1586
Texas,Hood County,11,3809,1877,1932
Texas,Hood County,12,4091,1932,2159
Texas,Hood County,13,4110,1914,2196
Texas,Hood County,14,4080,1946,2134
Texas,Hood County,15,3355,1647,1708
Texas,Hood County,16,2510,1209,1301
Texas,Hood County,17,1518,717,801
Texas,Hood County,18,1517,539,978
Texas,Hopkins County,0,35921,17723,18198
Texas,Hopkins County,1,2391,1230,1161
Texas,Hopkins County,2,2541,1318,1223
Texas,Hopkins County,3,2623,1378,1245
Texas,Hopkins County,4,2292,1196,1096
Texas,Hopkins County,5,2229,1122,1107
Texas,Hopkins County,6,2105,1057,1048
Texas,Hopkins County,7,2078,1041,1037
Texas,Hopkins County,8,1993,973,1020
Texas,Hopkins County,9,2190,1048,1142
Texas,Hopkins County,10,2222,1083,1139
Texas,Hopkins County,11,2463,1240,1223
Texas,Hopkins County,12,2430,1212,1218
Texas,Hopkins County,13,2175,1068,1107
Texas,Hopkins County,14,2003,944,1059
Texas,Hopkins County,15,1547,719,828
Texas,Hopkins County,16,1122,531,591
Texas,Hopkins County,17,791,333,458
Texas,Hopkins County,18,726,230,496
Texas,Houston County,0,22741,12038,10703
Texas,Houston County,1,1165,568,597
Texas,Houston County,2,1304,680,624
Texas,Houston County,3,1240,625,615
Texas,Houston County,4,1160,599,561
Texas,Houston County,5,1321,685,636
Texas,Houston County,6,1203,678,525
Texas,Houston County,7,1397,829,568
Texas,Houston County,8,1303,774,529
Texas,Houston County,9,1485,935,550
Texas,Houston County,10,1576,956,620
Texas,Houston County,11,1746,1005,741
Texas,Houston County,12,1628,814,814
Texas,Houston County,13,1525,733,792
Texas,Houston County,14,1404,668,736
Texas,Houston County,15,1145,564,581
Texas,Houston County,16,894,415,479
Texas,Houston County,17,636,291,345
Texas,Houston County,18,609,219,390
Texas,Howard County,0,36651,20865,15786
Texas,Howard County,1,2212,1093,1119
Texas,Howard County,2,2340,1209,1131
Texas,Howard County,3,2182,1120,1062
Texas,Howard County,4,2365,1342,1023
Texas,Howard County,5,2923,1759,1164
Texas,Howard County,6,2865,1779,1086
Texas,Howard County,7,2691,1600,1091
Texas,Howard County,8,2094,1189,905
Texas,Howard County,9,2379,1454,925
Texas,Howard County,10,2702,1767,935
Texas,Howard County,11,3148,2131,1017
Texas,Howard County,12,2421,1406,1015
Texas,Howard County,13,1829,913,916
Texas,Howard County,14,1387,707,680
Texas,Howard County,15,1001,458,543
Texas,Howard County,16,842,396,446
Texas,Howard County,17,701,303,398
Texas,Howard County,18,569,239,330
Texas,Hudspeth County,0,3211,1627,1584
Texas,Hudspeth County,1,207,95,112
Texas,Hudspeth County,2,195,99,96
Texas,Hudspeth County,3,236,114,122
Texas,Hudspeth County,4,255,128,127
Texas,Hudspeth County,5,219,115,104
Texas,Hudspeth County,6,156,77,79
Texas,Hudspeth County,7,170,106,64
Texas,Hudspeth County,8,152,69,83
Texas,Hudspeth County,9,195,108,87
Texas,Hudspeth County,10,186,93,93
Texas,Hudspeth County,11,236,118,118
Texas,Hudspeth County,12,247,117,130
Texas,Hudspeth County,13,205,102,103
Texas,Hudspeth County,14,193,109,84
Texas,Hudspeth County,15,160,88,72
Texas,Hudspeth County,16,83,40,43
Texas,Hudspeth County,17,61,23,38
Texas,Hudspeth County,18,55,26,29
Texas,Hunt County,0,88493,43718,44775
Texas,Hunt County,1,5444,2762,2682
Texas,Hunt County,2,5845,3024,2821
Texas,Hunt County,3,6110,3165,2945
Texas,Hunt County,4,6317,3207,3110
Texas,Hunt County,5,6197,3125,3072
Texas,Hunt County,6,5535,2755,2780
Texas,Hunt County,7,5160,2575,2585
Texas,Hunt County,8,4956,2432,2524
Texas,Hunt County,9,5453,2667,2786
Texas,Hunt County,10,5849,2878,2971
Texas,Hunt County,11,6581,3265,3316
Texas,Hunt County,12,6220,3098,3122
Texas,Hunt County,13,5237,2557,2680
Texas,Hunt County,14,4537,2196,2341
Texas,Hunt County,15,3534,1650,1884
Texas,Hunt County,16,2479,1166,1313
Texas,Hunt County,17,1630,685,945
Texas,Hunt County,18,1409,511,898
Texas,Hutchinson County,0,21773,10888,10885
Texas,Hutchinson County,1,1582,774,808
Texas,Hutchinson County,2,1589,782,807
Texas,Hutchinson County,3,1607,821,786
Texas,Hutchinson County,4,1498,745,753
Texas,Hutchinson County,5,1305,680,625
Texas,Hutchinson County,6,1253,631,622
Texas,Hutchinson County,7,1408,728,680
Texas,Hutchinson County,8,1371,685,686
Texas,Hutchinson County,9,1312,633,679
Texas,Hutchinson County,10,1149,599,550
Texas,Hutchinson County,11,1497,767,730
Texas,Hutchinson County,12,1586,813,773
Texas,Hutchinson County,13,1413,718,695
Texas,Hutchinson County,14,992,499,493
Texas,Hutchinson County,15,737,370,367
Texas,Hutchinson County,16,593,270,323
Texas,Hutchinson County,17,479,198,281
Texas,Hutchinson County,18,402,175,227
Texas,Irion County,0,1574,816,758
Texas,Irion County,1,100,58,42
Texas,Irion County,2,77,42,35
Texas,Irion County,3,107,56,51
Texas,Irion County,4,111,57,54
Texas,Irion County,5,79,46,33
Texas,Irion County,6,96,46,50
Texas,Irion County,7,83,50,33
Texas,Irion County,8,75,42,33
Texas,Irion County,9,87,46,41
Texas,Irion County,10,91,45,46
Texas,Irion County,11,150,81,69
Texas,Irion County,12,123,55,68
Texas,Irion County,13,107,52,55
Texas,Irion County,14,85,44,41
Texas,Irion County,15,85,44,41
Texas,Irion County,16,45,23,22
Texas,Irion County,17,48,22,26
Texas,Irion County,18,25,7,18
Texas,Jack County,0,8855,4951,3904
Texas,Jack County,1,532,271,261
Texas,Jack County,2,500,266,234
Texas,Jack County,3,550,286,264
Texas,Jack County,4,579,310,269
Texas,Jack County,5,641,434,207
Texas,Jack County,6,628,414,214
Texas,Jack County,7,552,355,197
Texas,Jack County,8,523,304,219
Texas,Jack County,9,544,314,230
Texas,Jack County,10,598,351,247
Texas,Jack County,11,714,419,295
Texas,Jack County,12,557,300,257
Texas,Jack County,13,492,252,240
Texas,Jack County,14,475,234,241
Texas,Jack County,15,360,168,192
Texas,Jack County,16,275,126,149
Texas,Jack County,17,182,84,98
Texas,Jack County,18,153,63,90
Texas,Jackson County,0,14739,7358,7381
Texas,Jackson County,1,1023,511,512
Texas,Jackson County,2,1131,531,600
Texas,Jackson County,3,1049,547,502
Texas,Jackson County,4,967,529,438
Texas,Jackson County,5,875,457,418
Texas,Jackson County,6,816,424,392
Texas,Jackson County,7,958,466,492
Texas,Jackson County,8,827,423,404
Texas,Jackson County,9,842,420,422
Texas,Jackson County,10,821,432,389
Texas,Jackson County,11,1016,510,506
Texas,Jackson County,12,1020,523,497
Texas,Jackson County,13,935,479,456
Texas,Jackson County,14,702,345,357
Texas,Jackson County,15,607,278,329
Texas,Jackson County,16,467,217,250
Texas,Jackson County,17,379,145,234
Texas,Jackson County,18,304,121,183
Texas,Jasper County,0,35552,17483,18069
Texas,Jasper County,1,2368,1186,1182
Texas,Jasper County,2,2430,1221,1209
Texas,Jasper County,3,2457,1260,1197
Texas,Jasper County,4,2214,1135,1079
Texas,Jasper County,5,2029,1073,956
Texas,Jasper County,6,1954,968,986
Texas,Jasper County,7,2067,1052,1015
Texas,Jasper County,8,1873,956,917
Texas,Jasper County,9,2015,977,1038
Texas,Jasper County,10,2223,1106,1117
Texas,Jasper County,11,2564,1252,1312
Texas,Jasper County,12,2544,1250,1294
Texas,Jasper County,13,2337,1130,1207
Texas,Jasper County,14,2079,982,1097
Texas,Jasper County,15,1682,785,897
Texas,Jasper County,16,1241,552,689
Texas,Jasper County,17,805,362,443
Texas,Jasper County,18,670,236,434
Texas,Jeff Davis County,0,2204,1109,1095
Texas,Jeff Davis County,1,41,21,20
Texas,Jeff Davis County,2,58,25,33
Texas,Jeff Davis County,3,64,32,32
Texas,Jeff Davis County,4,138,87,51
Texas,Jeff Davis County,5,84,42,42
Texas,Jeff Davis County,6,81,44,37
Texas,Jeff Davis County,7,93,47,46
Texas,Jeff Davis County,8,104,45,59
Texas,Jeff Davis County,9,98,49,49
Texas,Jeff Davis County,10,123,59,64
Texas,Jeff Davis County,11,190,102,88
Texas,Jeff Davis County,12,210,104,106
Texas,Jeff Davis County,13,261,124,137
Texas,Jeff Davis County,14,235,120,115
Texas,Jeff Davis County,15,188,101,87
Texas,Jeff Davis County,16,90,48,42
Texas,Jeff Davis County,17,65,33,32
Texas,Jeff Davis County,18,81,26,55
Texas,Jefferson County,0,252235,129090,123145
Texas,Jefferson County,1,17246,8702,8544
Texas,Jefferson County,2,16875,8547,8328
Texas,Jefferson County,3,15923,8077,7846
Texas,Jefferson County,4,16335,8283,8052
Texas,Jefferson County,5,19199,10306,8893
Texas,Jefferson County,6,18621,10307,8314
Texas,Jefferson County,7,18294,10138,8156
Texas,Jefferson County,8,15981,8851,7130
Texas,Jefferson County,9,15321,8222,7099
Texas,Jefferson County,10,15547,8252,7295
Texas,Jefferson County,11,17637,9102,8535
Texas,Jefferson County,12,17376,8645,8731
Texas,Jefferson County,13,14024,7006,7018
Texas,Jefferson County,14,10556,5104,5452
Texas,Jefferson County,15,7706,3413,4293
Texas,Jefferson County,16,5901,2514,3387
Texas,Jefferson County,17,4753,1922,2831
Texas,Jefferson County,18,4940,1699,3241
Texas,Jim Hogg County,0,5255,2638,2617
Texas,Jim Hogg County,1,472,236,236
Texas,Jim Hogg County,2,449,223,226
Texas,Jim Hogg County,3,420,229,191
Texas,Jim Hogg County,4,359,182,177
Texas,Jim Hogg County,5,310,166,144
Texas,Jim Hogg County,6,346,180,166
Texas,Jim Hogg County,7,317,177,140
Texas,Jim Hogg County,8,318,163,155
Texas,Jim Hogg County,9,270,139,131
Texas,Jim Hogg County,10,297,154,143
Texas,Jim Hogg County,11,303,149,154
Texas,Jim Hogg County,12,272,148,124
Texas,Jim Hogg County,13,290,125,165
Texas,Jim Hogg County,14,297,141,156
Texas,Jim Hogg County,15,201,92,109
Texas,Jim Hogg County,16,171,73,98
Texas,Jim Hogg County,17,104,43,61
Texas,Jim Hogg County,18,59,18,41
Texas,Jim Wells County,0,41353,20438,20915
Texas,Jim Wells County,1,3333,1758,1575
Texas,Jim Wells County,2,3337,1713,1624
Texas,Jim Wells County,3,3069,1604,1465
Texas,Jim Wells County,4,3069,1560,1509
Texas,Jim Wells County,5,2940,1478,1462
Texas,Jim Wells County,6,2671,1353,1318
Texas,Jim Wells County,7,2684,1363,1321
Texas,Jim Wells County,8,2366,1165,1201
Texas,Jim Wells County,9,2378,1178,1200
Texas,Jim Wells County,10,2352,1107,1245
Texas,Jim Wells County,11,2570,1254,1316
Texas,Jim Wells County,12,2543,1209,1334
Texas,Jim Wells County,13,2217,1095,1122
Texas,Jim Wells County,14,1959,976,983
Texas,Jim Wells County,15,1363,613,750
Texas,Jim Wells County,16,1088,471,617
Texas,Jim Wells County,17,743,315,428
Texas,Jim Wells County,18,671,226,445
Texas,Johnson County,0,157456,78661,78795
Texas,Johnson County,1,10227,5283,4944
Texas,Johnson County,2,11793,6038,5755
Texas,Johnson County,3,12132,6224,5908
Texas,Johnson County,4,11420,5882,5538
Texas,Johnson County,5,9903,5191,4712
Texas,Johnson County,6,9699,4919,4780
Texas,Johnson County,7,10242,5187,5055
Texas,Johnson County,8,9803,4866,4937
Texas,Johnson County,9,10582,5263,5319
Texas,Johnson County,10,10619,5411,5208
Texas,Johnson County,11,11359,5727,5632
Texas,Johnson County,12,10358,5126,5232
Texas,Johnson County,13,8571,4168,4403
Texas,Johnson County,14,7465,3525,3940
Texas,Johnson County,15,5305,2516,2789
Texas,Johnson County,16,3736,1727,2009
Texas,Johnson County,17,2346,1006,1340
Texas,Johnson County,18,1896,602,1294
Texas,Jones County,0,19936,12542,7394
Texas,Jones County,1,947,484,463
Texas,Jones County,2,931,474,457
Texas,Jones County,3,1045,525,520
Texas,Jones County,4,1028,586,442
Texas,Jones County,5,1554,1186,368
Texas,Jones County,6,1683,1316,367
Texas,Jones County,7,1673,1243,430
Texas,Jones County,8,1479,1117,362
Texas,Jones County,9,1518,1062,456
Texas,Jones County,10,1437,1031,406
Texas,Jones County,11,1449,888,561
Texas,Jones County,12,1280,712,568
Texas,Jones County,13,1047,565,482
Texas,Jones County,14,892,471,421
Texas,Jones County,15,730,343,387
Texas,Jones County,16,540,249,291
Texas,Jones County,17,355,146,209
Texas,Jones County,18,348,144,204
Texas,Karnes County,0,14906,8696,6210
Texas,Karnes County,1,863,436,427
Texas,Karnes County,2,888,447,441
Texas,Karnes County,3,900,446,454
Texas,Karnes County,4,881,489,392
Texas,Karnes County,5,1199,831,368
Texas,Karnes County,6,1295,938,357
Texas,Karnes County,7,1228,864,364
Texas,Karnes County,8,1024,693,331
Texas,Karnes County,9,931,595,336
Texas,Karnes County,10,909,550,359
Texas,Karnes County,11,929,563,366
Texas,Karnes County,12,912,463,449
Texas,Karnes County,13,779,393,386
Texas,Karnes County,14,649,324,325
Texas,Karnes County,15,446,224,222
Texas,Karnes County,16,454,201,253
Texas,Karnes County,17,319,133,186
Texas,Karnes County,18,300,106,194
Texas,Kaufman County,0,111236,54707,56529
Texas,Kaufman County,1,7691,3796,3895
Texas,Kaufman County,2,8688,4334,4354
Texas,Kaufman County,3,9075,4655,4420
Texas,Kaufman County,4,8063,4254,3809
Texas,Kaufman County,5,6354,3231,3123
Texas,Kaufman County,6,6661,3240,3421
Texas,Kaufman County,7,7676,3705,3971
Texas,Kaufman County,8,7613,3740,3873
Texas,Kaufman County,9,7940,3867,4073
Texas,Kaufman County,10,7421,3637,3784
Texas,Kaufman County,11,7817,3897,3920
Texas,Kaufman County,12,7230,3566,3664
Texas,Kaufman County,13,5890,2888,3002
Texas,Kaufman County,14,4783,2314,2469
Texas,Kaufman County,15,3466,1587,1879
Texas,Kaufman County,16,2224,1050,1174
Texas,Kaufman County,17,1452,576,876
Texas,Kaufman County,18,1192,370,822
Texas,Kendall County,0,38880,18988,19892
Texas,Kendall County,1,1919,934,985
Texas,Kendall County,2,2413,1200,1213
Texas,Kendall County,3,2928,1495,1433
Texas,Kendall County,4,2845,1494,1351
Texas,Kendall County,5,2045,1077,968
Texas,Kendall County,6,1684,852,832
Texas,Kendall County,7,1929,992,937
Texas,Kendall County,8,2072,1019,1053
Texas,Kendall County,9,2430,1170,1260
Texas,Kendall County,10,2585,1266,1319
Texas,Kendall County,11,3016,1409,1607
Texas,Kendall County,12,2872,1360,1512
Texas,Kendall County,13,2702,1328,1374
Texas,Kendall County,14,2574,1250,1324
Texas,Kendall County,15,1810,852,958
Texas,Kendall County,16,1214,611,603
Texas,Kendall County,17,869,387,482
Texas,Kendall County,18,973,292,681
Texas,Kenedy County,0,400,207,193
Texas,Kenedy County,1,29,15,14
Texas,Kenedy County,2,32,16,16
Texas,Kenedy County,3,26,13,13
Texas,Kenedy County,4,23,14,9
Texas,Kenedy County,5,25,16,9
Texas,Kenedy County,6,29,14,15
Texas,Kenedy County,7,31,16,15
Texas,Kenedy County,8,16,6,10
Texas,Kenedy County,9,19,10,9
Texas,Kenedy County,10,26,12,14
Texas,Kenedy County,11,29,16,13
Texas,Kenedy County,12,30,15,15
Texas,Kenedy County,13,24,16,8
Texas,Kenedy County,14,22,11,11
Texas,Kenedy County,15,10,6,4
Texas,Kenedy County,16,9,4,5
Texas,Kenedy County,17,9,1,8
Texas,Kenedy County,18,11,6,5
Texas,Kent County,0,785,387,398
Texas,Kent County,1,27,19,8
Texas,Kent County,2,46,27,19
Texas,Kent County,3,59,29,30
Texas,Kent County,4,57,27,30
Texas,Kent County,5,23,10,13
Texas,Kent County,6,40,23,17
Texas,Kent County,7,47,23,24
Texas,Kent County,8,28,12,16
Texas,Kent County,9,42,26,16
Texas,Kent County,10,47,24,23
Texas,Kent County,11,54,28,26
Texas,Kent County,12,65,38,27
Texas,Kent County,13,39,18,21
Texas,Kent County,14,62,31,31
Texas,Kent County,15,40,13,27
Texas,Kent County,16,33,11,22
Texas,Kent County,17,45,16,29
Texas,Kent County,18,31,12,19
Texas,Kerr County,0,50562,24391,26171
Texas,Kerr County,1,2583,1284,1299
Texas,Kerr County,2,2636,1363,1273
Texas,Kerr County,3,2791,1454,1337
Texas,Kerr County,4,3100,1627,1473
Texas,Kerr County,5,2971,1505,1466
Texas,Kerr County,6,2509,1240,1269
Texas,Kerr County,7,2374,1154,1220
Texas,Kerr County,8,2194,1059,1135
Texas,Kerr County,9,2384,1139,1245
Texas,Kerr County,10,2718,1317,1401
Texas,Kerr County,11,3395,1594,1801
Texas,Kerr County,12,3660,1711,1949
Texas,Kerr County,13,3715,1756,1959
Texas,Kerr County,14,3846,1824,2022
Texas,Kerr County,15,3270,1531,1739
Texas,Kerr County,16,2564,1199,1365
Texas,Kerr County,17,1887,858,1029
Texas,Kerr County,18,1965,776,1189
Texas,Kimble County,0,4438,2190,2248
Texas,Kimble County,1,218,128,90
Texas,Kimble County,2,230,118,112
Texas,Kimble County,3,238,124,114
Texas,Kimble County,4,252,121,131
Texas,Kimble County,5,192,98,94
Texas,Kimble County,6,192,112,80
Texas,Kimble County,7,201,102,99
Texas,Kimble County,8,227,103,124
Texas,Kimble County,9,237,107,130
Texas,Kimble County,10,213,110,103
Texas,Kimble County,11,327,164,163
Texas,Kimble County,12,349,174,175
Texas,Kimble County,13,386,178,208
Texas,Kimble County,14,372,180,192
Texas,Kimble County,15,294,147,147
Texas,Kimble County,16,230,111,119
Texas,Kimble County,17,135,62,73
Texas,Kimble County,18,145,51,94
Texas,King County,0,262,130,132
Texas,King County,1,20,11,9
Texas,King County,2,14,6,8
Texas,King County,3,12,6,6
Texas,King County,4,11,6,5
Texas,King County,5,14,8,6
Texas,King County,6,11,6,5
Texas,King County,7,18,8,10
Texas,King County,8,12,8,4
Texas,King County,9,19,9,10
Texas,King County,10,22,7,15
Texas,King County,11,17,4,13
Texas,King County,12,25,15,10
Texas,King County,13,21,13,8
Texas,King County,14,10,8,2
Texas,King County,15,15,7,8
Texas,King County,16,9,2,7
Texas,King County,17,7,4,3
Texas,King County,18,5,2,3
Texas,Kinney County,0,3526,1977,1549
Texas,Kinney County,1,159,86,73
Texas,Kinney County,2,169,98,71
Texas,Kinney County,3,209,122,87
Texas,Kinney County,4,233,128,105
Texas,Kinney County,5,227,156,71
Texas,Kinney County,6,170,121,49
Texas,Kinney County,7,213,136,77
Texas,Kinney County,8,192,114,78
Texas,Kinney County,9,225,127,98
Texas,Kinney County,10,195,106,89
Texas,Kinney County,11,181,98,83
Texas,Kinney County,12,233,126,107
Texas,Kinney County,13,228,104,124
Texas,Kinney County,14,242,131,111
Texas,Kinney County,15,206,105,101
Texas,Kinney County,16,191,85,106
Texas,Kinney County,17,143,78,65
Texas,Kinney County,18,110,56,54
Texas,Kleberg County,0,32190,16494,15696
Texas,Kleberg County,1,2349,1239,1110
Texas,Kleberg County,2,2203,1153,1050
Texas,Kleberg County,3,2078,1051,1027
Texas,Kleberg County,4,3127,1700,1427
Texas,Kleberg County,5,4891,2548,2343
Texas,Kleberg County,6,2415,1394,1021
Texas,Kleberg County,7,2038,1092,946
Texas,Kleberg County,8,1572,823,749
Texas,Kleberg County,9,1584,804,780
Texas,Kleberg County,10,1444,683,761
Texas,Kleberg County,11,1604,816,788
Texas,Kleberg County,12,1535,746,789
Texas,Kleberg County,13,1367,676,691
Texas,Kleberg County,14,1305,621,684
Texas,Kleberg County,15,946,421,525
Texas,Kleberg County,16,768,343,425
Texas,Kleberg County,17,471,203,268
Texas,Kleberg County,18,493,181,312
Texas,Knox County,0,3858,1916,1942
Texas,Knox County,1,288,133,155
Texas,Knox County,2,288,146,142
Texas,Knox County,3,264,137,127
Texas,Knox County,4,260,128,132
Texas,Knox County,5,202,94,108
Texas,Knox County,6,201,106,95
Texas,Knox County,7,208,104,104
Texas,Knox County,8,206,125,81
Texas,Knox County,9,205,89,116
Texas,Knox County,10,206,108,98
Texas,Knox County,11,243,134,109
Texas,Knox County,12,274,153,121
Texas,Knox County,13,213,114,99
Texas,Knox County,14,203,100,103
Texas,Knox County,15,167,76,91
Texas,Knox County,16,181,65,116
Texas,Knox County,17,125,59,66
Texas,Knox County,18,124,45,79
Texas,Lamar County,0,49523,23936,25587
Texas,Lamar County,1,3229,1668,1561
Texas,Lamar County,2,3235,1647,1588
Texas,Lamar County,3,3211,1652,1559
Texas,Lamar County,4,3223,1637,1586
Texas,Lamar County,5,3270,1633,1637
Texas,Lamar County,6,2906,1436,1470
Texas,Lamar County,7,2756,1335,1421
Texas,Lamar County,8,2694,1306,1388
Texas,Lamar County,9,2962,1390,1572
Texas,Lamar County,10,3208,1569,1639
Texas,Lamar County,11,3443,1618,1825
Texas,Lamar County,12,3294,1607,1687
Texas,Lamar County,13,2974,1426,1548
Texas,Lamar County,14,2916,1357,1559
Texas,Lamar County,15,2387,1105,1282
Texas,Lamar County,16,1611,727,884
Texas,Lamar County,17,1111,462,649
Texas,Lamar County,18,1093,361,732
Texas,Lamb County,0,13574,6792,6782
Texas,Lamb County,1,1129,613,516
Texas,Lamb County,2,1030,534,496
Texas,Lamb County,3,1039,527,512
Texas,Lamb County,4,1020,567,453
Texas,Lamb County,5,816,431,385
Texas,Lamb County,6,757,365,392
Texas,Lamb County,7,803,410,393
Texas,Lamb County,8,775,385,390
Texas,Lamb County,9,695,342,353
Texas,Lamb County,10,824,406,418
Texas,Lamb County,11,905,442,463
Texas,Lamb County,12,862,440,422
Texas,Lamb County,13,707,372,335
Texas,Lamb County,14,573,261,312
Texas,Lamb County,15,539,244,295
Texas,Lamb County,16,465,207,258
Texas,Lamb County,17,357,145,212
Texas,Lamb County,18,278,101,177
Texas,Lampasas County,0,20156,9913,10243
Texas,Lampasas County,1,1199,617,582
Texas,Lampasas County,2,1289,640,649
Texas,Lampasas County,3,1347,695,652
Texas,Lampasas County,4,1389,717,672
Texas,Lampasas County,5,1083,552,531
Texas,Lampasas County,6,1040,534,506
Texas,Lampasas County,7,1101,527,574
Texas,Lampasas County,8,1094,532,562
Texas,Lampasas County,9,1294,632,662
Texas,Lampasas County,10,1375,666,709
Texas,Lampasas County,11,1529,789,740
Texas,Lampasas County,12,1482,717,765
Texas,Lampasas County,13,1296,606,690
Texas,Lampasas County,14,1195,588,607
Texas,Lampasas County,15,933,430,503
Texas,Lampasas County,16,645,305,340
Texas,Lampasas County,17,417,199,218
Texas,Lampasas County,18,448,167,281
Texas,La Salle County,0,7474,4390,3084
Texas,La Salle County,1,504,230,274
Texas,La Salle County,2,406,222,184
Texas,La Salle County,3,397,186,211
Texas,La Salle County,4,438,253,185
Texas,La Salle County,5,1164,904,260
Texas,La Salle County,6,796,601,195
Texas,La Salle County,7,491,314,177
Texas,La Salle County,8,393,224,169
Texas,La Salle County,9,433,246,187
Texas,La Salle County,10,432,235,197
Texas,La Salle County,11,369,196,173
Texas,La Salle County,12,339,156,183
Texas,La Salle County,13,329,155,174
Texas,La Salle County,14,327,167,160
Texas,La Salle County,15,246,116,130
Texas,La Salle County,16,183,87,96
Texas,La Salle County,17,134,63,71
Texas,La Salle County,18,93,35,58
Texas,Lavaca County,0,19721,9610,10111
Texas,Lavaca County,1,1183,585,598
Texas,Lavaca County,2,1380,677,703
Texas,Lavaca County,3,1312,661,651
Texas,Lavaca County,4,1183,616,567
Texas,Lavaca County,5,1031,538,493
Texas,Lavaca County,6,972,464,508
Texas,Lavaca County,7,1003,490,513
Texas,Lavaca County,8,984,491,493
Texas,Lavaca County,9,1069,526,543
Texas,Lavaca County,10,1140,584,556
Texas,Lavaca County,11,1372,705,667
Texas,Lavaca County,12,1382,680,702
Texas,Lavaca County,13,1398,678,720
Texas,Lavaca County,14,1271,608,663
Texas,Lavaca County,15,984,479,505
Texas,Lavaca County,16,776,348,428
Texas,Lavaca County,17,581,261,320
Texas,Lavaca County,18,700,219,481
Texas,Lee County,0,16742,8420,8322
Texas,Lee County,1,949,485,464
Texas,Lee County,2,1038,484,554
Texas,Lee County,3,994,485,509
Texas,Lee County,4,1301,818,483
Texas,Lee County,5,942,510,432
Texas,Lee County,6,928,448,480
Texas,Lee County,7,917,470,447
Texas,Lee County,8,933,453,480
Texas,Lee County,9,951,464,487
Texas,Lee County,10,1071,517,554
Texas,Lee County,11,1327,649,678
Texas,Lee County,12,1360,692,668
Texas,Lee County,13,1070,562,508
Texas,Lee County,14,928,471,457
Texas,Lee County,15,733,361,372
Texas,Lee County,16,556,240,316
Texas,Lee County,17,380,174,206
Texas,Lee County,18,364,137,227
Texas,Leon County,0,16861,8368,8493
Texas,Leon County,1,1126,551,575
Texas,Leon County,2,1011,529,482
Texas,Leon County,3,996,486,510
Texas,Leon County,4,950,515,435
Texas,Leon County,5,840,432,408
Texas,Leon County,6,814,405,409
Texas,Leon County,7,902,449,453
Texas,Leon County,8,810,407,403
Texas,Leon County,9,867,430,437
Texas,Leon County,10,904,436,468
Texas,Leon County,11,1201,594,607
Texas,Leon County,12,1244,621,623
Texas,Leon County,13,1249,630,619
Texas,Leon County,14,1249,584,665
Texas,Leon County,15,1074,535,539
Texas,Leon County,16,767,370,397
Texas,Leon County,17,456,231,225
Texas,Leon County,18,401,163,238
Texas,Liberty County,0,78117,38445,39672
Texas,Liberty County,1,5311,2703,2608
Texas,Liberty County,2,5491,2745,2746
Texas,Liberty County,3,5408,2707,2701
Texas,Liberty County,4,5242,2731,2511
Texas,Liberty County,5,5527,2824,2703
Texas,Liberty County,6,5411,2669,2742
Texas,Liberty County,7,5182,2510,2672
Texas,Liberty County,8,4863,2270,2593
Texas,Liberty County,9,5236,2508,2728
Texas,Liberty County,10,5245,2590,2655
Texas,Liberty County,11,5580,2776,2804
Texas,Liberty County,12,5188,2573,2615
Texas,Liberty County,13,4499,2243,2256
Texas,Liberty County,14,3665,1832,1833
Texas,Liberty County,15,2582,1222,1360
Texas,Liberty County,16,1639,781,858
Texas,Liberty County,17,1141,477,664
Texas,Liberty County,18,907,284,623
Texas,Limestone County,0,23524,12214,11310
Texas,Limestone County,1,1482,784,698
Texas,Limestone County,2,1517,787,730
Texas,Limestone County,3,1486,771,715
Texas,Limestone County,4,1520,868,652
Texas,Limestone County,5,1523,879,644
Texas,Limestone County,6,1598,927,671
Texas,Limestone County,7,1426,800,626
Texas,Limestone County,8,1425,811,614
Texas,Limestone County,9,1337,692,645
Texas,Limestone County,10,1298,631,667
Texas,Limestone County,11,1620,832,788
Texas,Limestone County,12,1634,774,860
Texas,Limestone County,13,1536,728,808
Texas,Limestone County,14,1363,687,676
Texas,Limestone County,15,1045,505,540
Texas,Limestone County,16,718,332,386
Texas,Limestone County,17,505,218,287
Texas,Limestone County,18,491,188,303
Texas,Lipscomb County,0,3553,1818,1735
Texas,Lipscomb County,1,222,110,112
Texas,Lipscomb County,2,295,148,147
Texas,Lipscomb County,3,266,139,127
Texas,Lipscomb County,4,271,132,139
Texas,Lipscomb County,5,205,111,94
Texas,Lipscomb County,6,233,137,96
Texas,Lipscomb County,7,257,152,105
Texas,Lipscomb County,8,197,94,103
Texas,Lipscomb County,9,187,93,94
Texas,Lipscomb County,10,198,103,95
Texas,Lipscomb County,11,255,128,127
Texas,Lipscomb County,12,233,116,117
Texas,Lipscomb County,13,223,117,106
Texas,Lipscomb County,14,143,73,70
Texas,Lipscomb County,15,121,54,67
Texas,Lipscomb County,16,102,47,55
Texas,Lipscomb County,17,73,35,38
Texas,Lipscomb County,18,72,29,43
Texas,Live Oak County,0,12091,6501,5590
Texas,Live Oak County,1,594,267,327
Texas,Live Oak County,2,642,329,313
Texas,Live Oak County,3,747,367,380
Texas,Live Oak County,4,688,350,338
Texas,Live Oak County,5,729,415,314
Texas,Live Oak County,6,795,507,288
Texas,Live Oak County,7,855,554,301
Texas,Live Oak County,8,754,465,289
Texas,Live Oak County,9,676,401,275
Texas,Live Oak County,10,723,417,306
Texas,Live Oak County,11,890,459,431
Texas,Live Oak County,12,847,418,429
Texas,Live Oak County,13,757,379,378
Texas,Live Oak County,14,733,365,368
Texas,Live Oak County,15,625,341,284
Texas,Live Oak County,16,448,213,235
Texas,Live Oak County,17,332,150,182
Texas,Live Oak County,18,256,104,152
Texas,Llano County,0,19510,9425,10085
Texas,Llano County,1,830,453,377
Texas,Llano County,2,831,412,419
Texas,Llano County,3,851,425,426
Texas,Llano County,4,838,444,394
Texas,Llano County,5,747,374,373
Texas,Llano County,6,684,341,343
Texas,Llano County,7,739,393,346
Texas,Llano County,8,703,333,370
Texas,Llano County,9,849,416,433
Texas,Llano County,10,987,483,504
Texas,Llano County,11,1352,648,704
Texas,Llano County,12,1596,730,866
Texas,Llano County,13,1887,856,1031
Texas,Llano County,14,1970,912,1058
Texas,Llano County,15,1727,856,871
Texas,Llano County,16,1272,642,630
Texas,Llano County,17,887,410,477
Texas,Llano County,18,760,297,463
Texas,Loving County,0,86,50,36
Texas,Loving County,1,8,4,4
Texas,Loving County,2,10,5,5
Texas,Loving County,3,6,3,3
Texas,Loving County,4,2,1,1
Texas,Loving County,5,1,1,0
Texas,Loving County,6,8,5,3
Texas,Loving County,7,4,1,3
Texas,Loving County,8,2,1,1
Texas,Loving County,9,1,0,1
Texas,Loving County,10,8,4,4
Texas,Loving County,11,4,3,1
Texas,Loving County,12,10,7,3
Texas,Loving County,13,9,4,5
Texas,Loving County,14,8,7,1
Texas,Loving County,15,3,2,1
Texas,Loving County,16,2,2,0
Texas,Loving County,17,0,0,0
Texas,Loving County,18,0,0,0
Texas,Lubbock County,0,293974,145281,148693
Texas,Lubbock County,1,20046,10263,9783
Texas,Lubbock County,2,20483,10472,10011
Texas,Lubbock County,3,19454,9780,9674
Texas,Lubbock County,4,23901,12045,11856
Texas,Lubbock County,5,37888,19615,18273
Texas,Lubbock County,6,22226,11541,10685
Texas,Lubbock County,7,20665,10524,10141
Texas,Lubbock County,8,16871,8456,8415
Texas,Lubbock County,9,15591,7559,8032
Texas,Lubbock County,10,15072,7449,7623
Texas,Lubbock County,11,16997,8220,8777
Texas,Lubbock County,12,16287,7886,8401
Texas,Lubbock County,13,13897,6567,7330
Texas,Lubbock County,14,10930,5100,5830
Texas,Lubbock County,15,8127,3640,4487
Texas,Lubbock County,16,6423,2760,3663
Texas,Lubbock County,17,4620,1880,2740
Texas,Lubbock County,18,4496,1524,2972
Texas,Lynn County,0,5771,2911,2860
Texas,Lynn County,1,412,199,213
Texas,Lynn County,2,463,233,230
Texas,Lynn County,3,439,228,211
Texas,Lynn County,4,408,198,210
Texas,Lynn County,5,329,181,148
Texas,Lynn County,6,306,174,132
Texas,Lynn County,7,346,168,178
Texas,Lynn County,8,338,176,162
Texas,Lynn County,9,281,143,138
Texas,Lynn County,10,369,182,187
Texas,Lynn County,11,428,216,212
Texas,Lynn County,12,413,226,187
Texas,Lynn County,13,327,172,155
Texas,Lynn County,14,258,138,120
Texas,Lynn County,15,220,89,131
Texas,Lynn County,16,209,91,118
Texas,Lynn County,17,114,55,59
Texas,Lynn County,18,111,42,69
Texas,McCulloch County,0,8199,4085,4114
Texas,McCulloch County,1,508,270,238
Texas,McCulloch County,2,524,274,250
Texas,McCulloch County,3,511,275,236
Texas,McCulloch County,4,558,283,275
Texas,McCulloch County,5,426,237,189
Texas,McCulloch County,6,412,211,201
Texas,McCulloch County,7,438,226,212
Texas,McCulloch County,8,417,213,204
Texas,McCulloch County,9,435,226,209
Texas,McCulloch County,10,474,219,255
Texas,McCulloch County,11,536,268,268
Texas,McCulloch County,12,602,270,332
Texas,McCulloch County,13,575,294,281
Texas,McCulloch County,14,565,275,290
Texas,McCulloch County,15,437,219,218
Texas,McCulloch County,16,319,140,179
Texas,McCulloch County,17,230,97,133
Texas,McCulloch County,18,232,88,144
Texas,McLennan County,0,243441,118822,124619
Texas,McLennan County,1,17358,8913,8445
Texas,McLennan County,2,16486,8494,7992
Texas,McLennan County,3,16414,8338,8076
Texas,McLennan County,4,20802,10475,10327
Texas,McLennan County,5,25962,13094,12868
Texas,McLennan County,6,15869,7825,8044
Texas,McLennan County,7,15337,7544,7793
Texas,McLennan County,8,13529,6598,6931
Texas,McLennan County,9,13297,6457,6840
Texas,McLennan County,10,13537,6414,7123
Texas,McLennan County,11,14924,7400,7524
Texas,McLennan County,12,14663,7097,7566
Texas,McLennan County,13,12608,6029,6579
Texas,McLennan County,14,10328,4870,5458
Texas,McLennan County,15,7449,3398,4051
Texas,McLennan County,16,5811,2573,3238
Texas,McLennan County,17,4419,1788,2631
Texas,McLennan County,18,4648,1515,3133
Texas,McMullen County,0,805,412,393
Texas,McMullen County,1,33,13,20
Texas,McMullen County,2,45,27,18
Texas,McMullen County,3,48,17,31
Texas,McMullen County,4,56,30,26
Texas,McMullen County,5,40,25,15
Texas,McMullen County,6,46,29,17
Texas,McMullen County,7,40,19,21
Texas,McMullen County,8,31,14,17
Texas,McMullen County,9,47,27,20
Texas,McMullen County,10,64,29,35
Texas,McMullen County,11,54,27,27
Texas,McMullen County,12,62,32,30
Texas,McMullen County,13,55,29,26
Texas,McMullen County,14,43,21,22
Texas,McMullen County,15,39,22,17
Texas,McMullen County,16,51,25,26
Texas,McMullen County,17,39,17,22
Texas,McMullen County,18,12,9,3
Texas,Madison County,0,13861,8033,5828
Texas,Madison County,1,784,401,383
Texas,Madison County,2,830,416,414
Texas,Madison County,3,837,437,400
Texas,Madison County,4,872,465,407
Texas,Madison County,5,1286,920,366
Texas,Madison County,6,1368,1028,340
Texas,Madison County,7,1054,729,325
Texas,Madison County,8,972,655,317
Texas,Madison County,9,842,497,345
Texas,Madison County,10,769,434,335
Texas,Madison County,11,755,379,376
Texas,Madison County,12,731,365,366
Texas,Madison County,13,720,341,379
Texas,Madison County,14,646,316,330
Texas,Madison County,15,524,266,258
Texas,Madison County,16,405,189,216
Texas,Madison County,17,239,115,124
Texas,Madison County,18,227,80,147
Texas,Marion County,0,10149,4962,5187
Texas,Marion County,1,459,233,226
Texas,Marion County,2,522,263,259
Texas,Marion County,3,536,275,261
Texas,Marion County,4,550,315,235
Texas,Marion County,5,483,276,207
Texas,Marion County,6,458,211,247
Texas,Marion County,7,501,229,272
Texas,Marion County,8,460,220,240
Texas,Marion County,9,539,247,292
Texas,Marion County,10,654,300,354
Texas,Marion County,11,853,416,437
Texas,Marion County,12,907,466,441
Texas,Marion County,13,833,392,441
Texas,Marion County,14,835,395,440
Texas,Marion County,15,595,285,310
Texas,Marion County,16,461,220,241
Texas,Marion County,17,270,130,140
Texas,Marion County,18,233,89,144
Texas,Martin County,0,5460,2719,2741
Texas,Martin County,1,487,236,251
Texas,Martin County,2,475,235,240
Texas,Martin County,3,433,204,229
Texas,Martin County,4,400,214,186
Texas,Martin County,5,384,205,179
Texas,Martin County,6,414,205,209
Texas,Martin County,7,346,188,158
Texas,Martin County,8,271,149,122
Texas,Martin County,9,321,163,158
Texas,Martin County,10,343,174,169
Texas,Martin County,11,381,191,190
Texas,Martin County,12,310,148,162
Texas,Martin County,13,230,108,122
Texas,Martin County,14,239,109,130
Texas,Martin County,15,163,68,95
Texas,Martin County,16,114,55,59
Texas,Martin County,17,75,36,39
Texas,Martin County,18,74,31,43
Texas,Mason County,0,4071,2023,2048
Texas,Mason County,1,165,82,83
Texas,Mason County,2,256,138,118
Texas,Mason County,3,229,120,109
Texas,Mason County,4,260,135,125
Texas,Mason County,5,169,106,63
Texas,Mason County,6,165,85,80
Texas,Mason County,7,175,81,94
Texas,Mason County,8,198,99,99
Texas,Mason County,9,204,94,110
Texas,Mason County,10,218,104,114
Texas,Mason County,11,285,152,133
Texas,Mason County,12,302,153,149
Texas,Mason County,13,330,161,169
Texas,Mason County,14,356,170,186
Texas,Mason County,15,288,137,151
Texas,Mason County,16,202,98,104
Texas,Mason County,17,137,60,77
Texas,Mason County,18,132,48,84
Texas,Matagorda County,0,36519,18190,18329
Texas,Matagorda County,1,2589,1344,1245
Texas,Matagorda County,2,2614,1350,1264
Texas,Matagorda County,3,2567,1346,1221
Texas,Matagorda County,4,2413,1248,1165
Texas,Matagorda County,5,2426,1246,1180
Texas,Matagorda County,6,2253,1114,1139
Texas,Matagorda County,7,2118,1065,1053
Texas,Matagorda County,8,1943,962,981
Texas,Matagorda County,9,1939,900,1039
Texas,Matagorda County,10,2116,1040,1076
Texas,Matagorda County,11,2713,1310,1403
Texas,Matagorda County,12,2709,1417,1292
Texas,Matagorda County,13,2338,1204,1134
Texas,Matagorda County,14,1883,940,943
Texas,Matagorda County,15,1430,693,737
Texas,Matagorda County,16,1057,496,561
Texas,Matagorda County,17,728,299,429
Texas,Matagorda County,18,683,216,467
Texas,Maverick County,0,57023,28172,28851
Texas,Maverick County,1,5152,2635,2517
Texas,Maverick County,2,4904,2484,2420
Texas,Maverick County,3,5092,2586,2506
Texas,Maverick County,4,5009,2577,2432
Texas,Maverick County,5,4633,2515,2118
Texas,Maverick County,6,3725,2026,1699
Texas,Maverick County,7,3429,1729,1700
Texas,Maverick County,8,3310,1573,1737
Texas,Maverick County,9,3552,1662,1890
Texas,Maverick County,10,3244,1580,1664
Texas,Maverick County,11,3024,1465,1559
Texas,Maverick County,12,2838,1315,1523
Texas,Maverick County,13,2599,1198,1401
Texas,Maverick County,14,2095,939,1156
Texas,Maverick County,15,1629,715,914
Texas,Maverick County,16,1217,539,678
Texas,Maverick County,17,823,342,481
Texas,Maverick County,18,748,292,456
Texas,Medina County,0,47894,24729,23165
Texas,Medina County,1,2642,1349,1293
Texas,Medina County,2,3170,1600,1570
Texas,Medina County,3,3490,1750,1740
Texas,Medina County,4,3622,1979,1643
Texas,Medina County,5,3444,2145,1299
Texas,Medina County,6,3051,1750,1301
Texas,Medina County,7,2632,1398,1234
Texas,Medina County,8,2538,1303,1235
Texas,Medina County,9,3031,1504,1527
Texas,Medina County,10,3197,1626,1571
Texas,Medina County,11,3500,1800,1700
Texas,Medina County,12,3279,1629,1650
Texas,Medina County,13,2872,1409,1463
Texas,Medina County,14,2589,1291,1298
Texas,Medina County,15,1831,894,937
Texas,Medina County,16,1256,582,674
Texas,Medina County,17,918,420,498
Texas,Medina County,18,832,300,532
Texas,Menard County,0,2147,1073,1074
Texas,Menard County,1,102,59,43
Texas,Menard County,2,113,62,51
Texas,Menard County,3,96,47,49
Texas,Menard County,4,118,68,50
Texas,Menard County,5,85,45,40
Texas,Menard County,6,85,47,38
Texas,Menard County,7,100,47,53
Texas,Menard County,8,77,41,36
Texas,Menard County,9,86,26,60
Texas,Menard County,10,114,57,57
Texas,Menard County,11,171,81,90
Texas,Menard County,12,191,94,97
Texas,Menard County,13,162,74,88
Texas,Menard County,14,168,89,79
Texas,Menard County,15,182,101,81
Texas,Menard County,16,89,41,48
Texas,Menard County,17,88,46,42
Texas,Menard County,18,120,48,72
Texas,Midland County,0,155830,78184,77646
Texas,Midland County,1,13070,6686,6384
Texas,Midland County,2,12355,6357,5998
Texas,Midland County,3,11183,5733,5450
Texas,Midland County,4,10239,5311,4928
Texas,Midland County,5,12013,6180,5833
Texas,Midland County,6,13760,7195,6565
Texas,Midland County,7,12594,6568,6026
Texas,Midland County,8,9731,5079,4652
Texas,Midland County,9,9029,4610,4419
Texas,Midland County,10,8533,4186,4347
Texas,Midland County,11,9859,4787,5072
Texas,Midland County,12,10025,4984,5041
Texas,Midland County,13,7606,3706,3900
Texas,Midland County,14,4930,2414,2516
Texas,Midland County,15,3397,1493,1904
Texas,Midland County,16,2807,1158,1649
Texas,Midland County,17,2303,908,1395
Texas,Midland County,18,2396,829,1567
Texas,Milam County,0,24256,12046,12210
Texas,Milam County,1,1530,790,740
Texas,Milam County,2,1691,873,818
Texas,Milam County,3,1725,907,818
Texas,Milam County,4,1682,919,763
Texas,Milam County,5,1400,719,681
Texas,Milam County,6,1189,581,608
Texas,Milam County,7,1237,619,618
Texas,Milam County,8,1279,609,670
Texas,Milam County,9,1345,675,670
Texas,Milam County,10,1416,687,729
Texas,Milam County,11,1718,845,873
Texas,Milam County,12,1676,826,850
Texas,Milam County,13,1665,792,873
Texas,Milam County,14,1491,774,717
Texas,Milam County,15,1086,548,538
Texas,Milam County,16,850,386,464
Texas,Milam County,17,622,254,368
Texas,Milam County,18,654,242,412
Texas,Mills County,0,4870,2386,2484
Texas,Mills County,1,238,112,126
Texas,Mills County,2,314,157,157
Texas,Mills County,3,330,178,152
Texas,Mills County,4,316,149,167
Texas,Mills County,5,236,132,104
Texas,Mills County,6,191,88,103
Texas,Mills County,7,212,101,111
Texas,Mills County,8,232,115,117
Texas,Mills County,9,249,110,139
Texas,Mills County,10,288,153,135
Texas,Mills County,11,311,155,156
Texas,Mills County,12,346,169,177
Texas,Mills County,13,382,187,195
Texas,Mills County,14,361,173,188
Texas,Mills County,15,305,157,148
Texas,Mills County,16,217,110,107
Texas,Mills County,17,167,73,94
Texas,Mills County,18,175,67,108
Texas,Mitchell County,0,9076,5457,3619
Texas,Mitchell County,1,479,242,237
Texas,Mitchell County,2,485,236,249
Texas,Mitchell County,3,531,265,266
Texas,Mitchell County,4,545,307,238
Texas,Mitchell County,5,921,711,210
Texas,Mitchell County,6,835,640,195
Texas,Mitchell County,7,735,511,224
Texas,Mitchell County,8,636,453,183
Texas,Mitchell County,9,590,374,216
Texas,Mitchell County,10,571,376,195
Texas,Mitchell County,11,526,304,222
Texas,Mitchell County,12,473,245,228
Texas,Mitchell County,13,501,241,260
Texas,Mitchell County,14,376,187,189
Texas,Mitchell County,15,304,131,173
Texas,Mitchell County,16,238,110,128
Texas,Mitchell County,17,167,62,105
Texas,Mitchell County,18,163,62,101
Texas,Montague County,0,19416,9554,9862
Texas,Montague County,1,1158,612,546
Texas,Montague County,2,1256,660,596
Texas,Montague County,3,1257,644,613
Texas,Montague County,4,1179,538,641
Texas,Montague County,5,982,502,480
Texas,Montague County,6,1037,516,521
Texas,Montague County,7,1051,515,536
Texas,Montague County,8,965,489,476
Texas,Montague County,9,1089,551,538
Texas,Montague County,10,1191,601,590
Texas,Montague County,11,1409,714,695
Texas,Montague County,12,1412,686,726
Texas,Montague County,13,1259,607,652
Texas,Montague County,14,1327,643,684
Texas,Montague County,15,1021,504,517
Texas,Montague County,16,771,346,425
Texas,Montague County,17,570,262,308
Texas,Montague County,18,482,164,318
Texas,Montgomery County,0,518947,257125,261822
Texas,Montgomery County,1,35181,18109,17072
Texas,Montgomery County,2,39304,20036,19268
Texas,Montgomery County,3,40586,20680,19906
Texas,Montgomery County,4,36329,18762,17567
Texas,Montgomery County,5,31371,16094,15277
Texas,Montgomery County,6,31419,15780,15639
Texas,Montgomery County,7,34111,16955,17156
Texas,Montgomery County,8,34443,17117,17326
Texas,Montgomery County,9,37128,18111,19017
Texas,Montgomery County,10,35948,17829,18119
Texas,Montgomery County,11,37131,18277,18854
Texas,Montgomery County,12,34846,17212,17634
Texas,Montgomery County,13,28621,13855,14766
Texas,Montgomery County,14,23380,11275,12105
Texas,Montgomery County,15,16114,7549,8565
Texas,Montgomery County,16,10271,4709,5562
Texas,Montgomery County,17,6700,2776,3924
Texas,Montgomery County,18,6064,1999,4065
Texas,Moore County,0,22148,11539,10609
Texas,Moore County,1,2106,1073,1033
Texas,Moore County,2,1971,1024,947
Texas,Moore County,3,1807,962,845
Texas,Moore County,4,1687,918,769
Texas,Moore County,5,1667,905,762
Texas,Moore County,6,1489,845,644
Texas,Moore County,7,1575,820,755
Texas,Moore County,8,1425,747,678
Texas,Moore County,9,1261,691,570
Texas,Moore County,10,1289,682,607
Texas,Moore County,11,1319,675,644
Texas,Moore County,12,1281,633,648
Texas,Moore County,13,1014,522,492
Texas,Moore County,14,715,349,366
Texas,Moore County,15,562,251,311
Texas,Moore County,16,411,184,227
Texas,Moore County,17,323,162,161
Texas,Moore County,18,246,96,150
Texas,Morris County,0,12743,6113,6630
Texas,Morris County,1,802,384,418
Texas,Morris County,2,802,423,379
Texas,Morris County,3,807,422,385
Texas,Morris County,4,786,400,386
Texas,Morris County,5,755,377,378
Texas,Morris County,6,695,346,349
Texas,Morris County,7,739,369,370
Texas,Morris County,8,653,302,351
Texas,Morris County,9,705,330,375
Texas,Morris County,10,639,298,341
Texas,Morris County,11,861,415,446
Texas,Morris County,12,974,427,547
Texas,Morris County,13,845,416,429
Texas,Morris County,14,805,380,425
Texas,Morris County,15,634,302,332
Texas,Morris County,16,562,261,301
Texas,Morris County,17,352,149,203
Texas,Morris County,18,327,112,215
Texas,Motley County,0,1153,595,558
Texas,Motley County,1,43,25,18
Texas,Motley County,2,65,39,26
Texas,Motley County,3,71,38,33
Texas,Motley County,4,77,45,32
Texas,Motley County,5,38,21,17
Texas,Motley County,6,65,34,31
Texas,Motley County,7,53,33,20
Texas,Motley County,8,60,29,31
Texas,Motley County,9,60,27,33
Texas,Motley County,10,38,21,17
Texas,Motley County,11,88,46,42
Texas,Motley County,12,77,42,35
Texas,Motley County,13,90,36,54
Texas,Motley County,14,77,43,34
Texas,Motley County,15,105,45,60
Texas,Motley County,16,59,27,32
Texas,Motley County,17,43,15,28
Texas,Motley County,18,44,29,15
Texas,Nacogdoches County,0,65301,31137,34164
Texas,Nacogdoches County,1,4704,2368,2336
Texas,Nacogdoches County,2,4256,2191,2065
Texas,Nacogdoches County,3,4044,2104,1940
Texas,Nacogdoches County,4,6310,2751,3559
Texas,Nacogdoches County,5,9113,4218,4895
Texas,Nacogdoches County,6,3948,1964,1984
Texas,Nacogdoches County,7,3745,1856,1889
Texas,Nacogdoches County,8,3227,1530,1697
Texas,Nacogdoches County,9,3174,1554,1620
Texas,Nacogdoches County,10,3316,1610,1706
Texas,Nacogdoches County,11,3706,1803,1903
Texas,Nacogdoches County,12,3709,1754,1955
Texas,Nacogdoches County,13,3504,1699,1805
Texas,Nacogdoches County,14,2832,1377,1455
Texas,Nacogdoches County,15,2094,962,1132
Texas,Nacogdoches County,16,1472,616,856
Texas,Nacogdoches County,17,1075,409,666
Texas,Nacogdoches County,18,1072,371,701
Texas,Navarro County,0,48195,23861,24334
Texas,Navarro County,1,3515,1768,1747
Texas,Navarro County,2,3397,1720,1677
Texas,Navarro County,3,3547,1893,1654
Texas,Navarro County,4,3503,1935,1568
Texas,Navarro County,5,3040,1547,1493
Texas,Navarro County,6,2769,1346,1423
Texas,Navarro County,7,2725,1339,1386
Texas,Navarro County,8,2670,1312,1358
Texas,Navarro County,9,2899,1436,1463
Texas,Navarro County,10,2955,1468,1487
Texas,Navarro County,11,3361,1674,1687
Texas,Navarro County,12,3168,1558,1610
Texas,Navarro County,13,2838,1371,1467
Texas,Navarro County,14,2602,1265,1337
Texas,Navarro County,15,1963,912,1051
Texas,Navarro County,16,1350,617,733
Texas,Navarro County,17,937,388,549
Texas,Navarro County,18,956,312,644
Texas,Newton County,0,14138,7293,6845
Texas,Newton County,1,786,385,401
Texas,Newton County,2,787,393,394
Texas,Newton County,3,905,448,457
Texas,Newton County,4,937,518,419
Texas,Newton County,5,963,573,390
Texas,Newton County,6,838,498,340
Texas,Newton County,7,775,425,350
Texas,Newton County,8,802,420,382
Texas,Newton County,9,857,441,416
Texas,Newton County,10,927,472,455
Texas,Newton County,11,1087,556,531
Texas,Newton County,12,1026,514,512
Texas,Newton County,13,952,460,492
Texas,Newton County,14,876,417,459
Texas,Newton County,15,652,336,316
Texas,Newton County,16,437,219,218
Texas,Newton County,17,283,129,154
Texas,Newton County,18,248,89,159
Texas,Nolan County,0,15093,7586,7507
Texas,Nolan County,1,995,551,444
Texas,Nolan County,2,1166,608,558
Texas,Nolan County,3,1119,585,534
Texas,Nolan County,4,1031,572,459
Texas,Nolan County,5,987,560,427
Texas,Nolan County,6,879,448,431
Texas,Nolan County,7,920,470,450
Texas,Nolan County,8,836,422,414
Texas,Nolan County,9,860,417,443
Texas,Nolan County,10,872,431,441
Texas,Nolan County,11,943,454,489
Texas,Nolan County,12,1002,491,511
Texas,Nolan County,13,936,458,478
Texas,Nolan County,14,802,394,408
Texas,Nolan County,15,629,289,340
Texas,Nolan County,16,456,205,251
Texas,Nolan County,17,315,133,182
Texas,Nolan County,18,345,98,247
Texas,Nueces County,0,356221,175515,180706
Texas,Nueces County,1,24174,12166,12008
Texas,Nueces County,2,25099,12900,12199
Texas,Nueces County,3,25617,13014,12603
Texas,Nueces County,4,24661,12436,12225
Texas,Nueces County,5,26974,13730,13244
Texas,Nueces County,6,26607,13560,13047
Texas,Nueces County,7,25325,12969,12356
Texas,Nueces County,8,22115,10904,11211
Texas,Nueces County,9,21865,10774,11091
Texas,Nueces County,10,20662,10219,10443
Texas,Nueces County,11,23953,11666,12287
Texas,Nueces County,12,23216,11293,11923
Texas,Nueces County,13,19597,9531,10066
Texas,Nueces County,14,15786,7617,8169
Texas,Nueces County,15,10831,5031,5800
Texas,Nueces County,16,7860,3322,4538
Texas,Nueces County,17,5866,2300,3566
Texas,Nueces County,18,6013,2083,3930
Texas,Ochiltree County,0,10758,5474,5284
Texas,Ochiltree County,1,957,483,474
Texas,Ochiltree County,2,1039,531,508
Texas,Ochiltree County,3,905,449,456
Texas,Ochiltree County,4,774,425,349
Texas,Ochiltree County,5,749,386,363
Texas,Ochiltree County,6,713,348,365
Texas,Ochiltree County,7,737,388,349
Texas,Ochiltree County,8,738,378,360
Texas,Ochiltree County,9,637,355,282
Texas,Ochiltree County,10,600,307,293
Texas,Ochiltree County,11,698,360,338
Texas,Ochiltree County,12,639,330,309
Texas,Ochiltree County,13,463,229,234
Texas,Ochiltree County,14,376,198,178
Texas,Ochiltree County,15,272,110,162
Texas,Ochiltree County,16,192,91,101
Texas,Ochiltree County,17,152,67,85
Texas,Ochiltree County,18,117,39,78
Texas,Oldham County,0,2070,1058,1012
Texas,Oldham County,1,83,34,49
Texas,Oldham County,2,95,51,44
Texas,Oldham County,3,222,135,87
Texas,Oldham County,4,249,162,87
Texas,Oldham County,5,74,33,41
Texas,Oldham County,6,95,45,50
Texas,Oldham County,7,144,63,81
Texas,Oldham County,8,121,64,57
Texas,Oldham County,9,145,72,73
Texas,Oldham County,10,117,45,72
Texas,Oldham County,11,159,90,69
Texas,Oldham County,12,167,81,86
Texas,Oldham County,13,111,53,58
Texas,Oldham County,14,101,54,47
Texas,Oldham County,15,66,29,37
Texas,Oldham County,16,59,25,34
Texas,Oldham County,17,34,12,22
Texas,Oldham County,18,28,10,18
Texas,Orange County,0,83433,41339,42094
Texas,Orange County,1,5607,2852,2755
Texas,Orange County,2,5611,2886,2725
Texas,Orange County,3,5839,3027,2812
Texas,Orange County,4,5405,2779,2626
Texas,Orange County,5,5459,2827,2632
Texas,Orange County,6,5281,2629,2652
Texas,Orange County,7,5222,2626,2596
Texas,Orange County,8,4939,2428,2511
Texas,Orange County,9,5205,2586,2619
Texas,Orange County,10,5226,2643,2583
Texas,Orange County,11,6134,3031,3103
Texas,Orange County,12,5958,2931,3027
Texas,Orange County,13,4968,2408,2560
Texas,Orange County,14,4028,1943,2085
Texas,Orange County,15,3156,1499,1657
Texas,Orange County,16,2332,1034,1298
Texas,Orange County,17,1629,695,934
Texas,Orange County,18,1434,515,919
Texas,Palo Pinto County,0,28096,13782,14314
Texas,Palo Pinto County,1,1841,965,876
Texas,Palo Pinto County,2,1897,967,930
Texas,Palo Pinto County,3,1857,918,939
Texas,Palo Pinto County,4,1885,1005,880
Texas,Palo Pinto County,5,1720,880,840
Texas,Palo Pinto County,6,1610,818,792
Texas,Palo Pinto County,7,1493,713,780
Texas,Palo Pinto County,8,1486,704,782
Texas,Palo Pinto County,9,1630,772,858
Texas,Palo Pinto County,10,1652,808,844
Texas,Palo Pinto County,11,2023,986,1037
Texas,Palo Pinto County,12,2041,981,1060
Texas,Palo Pinto County,13,1836,899,937
Texas,Palo Pinto County,14,1745,847,898
Texas,Palo Pinto County,15,1339,657,682
Texas,Palo Pinto County,16,921,439,482
Texas,Palo Pinto County,17,620,264,356
Texas,Palo Pinto County,18,500,159,341
Texas,Panola County,0,23769,11770,11999
Texas,Panola County,1,1524,765,759
Texas,Panola County,2,1620,863,757
Texas,Panola County,3,1634,871,763
Texas,Panola County,4,1593,777,816
Texas,Panola County,5,1480,783,697
Texas,Panola County,6,1343,696,647
Texas,Panola County,7,1483,757,726
Texas,Panola County,8,1407,677,730
Texas,Panola County,9,1366,683,683
Texas,Panola County,10,1284,604,680
Texas,Panola County,11,1667,830,837
Texas,Panola County,12,1706,823,883
Texas,Panola County,13,1634,816,818
Texas,Panola County,14,1284,634,650
Texas,Panola County,15,1003,458,545
Texas,Panola County,16,784,354,430
Texas,Panola County,17,554,229,325
Texas,Panola County,18,403,150,253
Texas,Parker County,0,123164,61541,61623
Texas,Parker County,1,6991,3599,3392
Texas,Parker County,2,8602,4371,4231
Texas,Parker County,3,8940,4567,4373
Texas,Parker County,4,8683,4457,4226
Texas,Parker County,5,7379,3879,3500
Texas,Parker County,6,6726,3438,3288
Texas,Parker County,7,7071,3511,3560
Texas,Parker County,8,7101,3534,3567
Texas,Parker County,9,8167,3919,4248
Texas,Parker County,10,8525,4222,4303
Texas,Parker County,11,10031,5111,4920
Texas,Parker County,12,9050,4502,4548
Texas,Parker County,13,7677,3758,3919
Texas,Parker County,14,6655,3296,3359
Texas,Parker County,15,4742,2356,2386
Texas,Parker County,16,3122,1506,1616
Texas,Parker County,17,2030,906,1124
Texas,Parker County,18,1672,609,1063
Texas,Parmer County,0,9908,5119,4789
Texas,Parmer County,1,817,438,379
Texas,Parmer County,2,820,425,395
Texas,Parmer County,3,794,406,388
Texas,Parmer County,4,755,397,358
Texas,Parmer County,5,709,404,305
Texas,Parmer County,6,635,337,298
Texas,Parmer County,7,659,363,296
Texas,Parmer County,8,529,273,256
Texas,Parmer County,9,571,295,276
Texas,Parmer County,10,605,288,317
Texas,Parmer County,11,657,324,333
Texas,Parmer County,12,613,337,276
Texas,Parmer County,13,485,245,240
Texas,Parmer County,14,381,196,185
Texas,Parmer County,15,304,152,152
Texas,Parmer County,16,252,118,134
Texas,Parmer County,17,154,67,87
Texas,Parmer County,18,168,54,114
Texas,Pecos County,0,15893,9006,6887
Texas,Pecos County,1,1205,599,606
Texas,Pecos County,2,1156,577,579
Texas,Pecos County,3,971,485,486
Texas,Pecos County,4,904,477,427
Texas,Pecos County,5,1091,656,435
Texas,Pecos County,6,1209,740,469
Texas,Pecos County,7,1259,783,476
Texas,Pecos County,8,1087,719,368
Texas,Pecos County,9,1078,663,415
Texas,Pecos County,10,1098,690,408
Texas,Pecos County,11,1092,643,449
Texas,Pecos County,12,981,555,426
Texas,Pecos County,13,793,426,367
Texas,Pecos County,14,642,337,305
Texas,Pecos County,15,490,231,259
Texas,Pecos County,16,398,210,188
Texas,Pecos County,17,243,122,121
Texas,Pecos County,18,196,93,103
Texas,Polk County,0,46079,24695,21384
Texas,Polk County,1,2576,1312,1264
Texas,Polk County,2,2663,1401,1262
Texas,Polk County,3,2591,1331,1260
Texas,Polk County,4,2567,1350,1217
Texas,Polk County,5,2775,1622,1153
Texas,Polk County,6,2620,1539,1081
Texas,Polk County,7,2714,1652,1062
Texas,Polk County,8,2584,1548,1036
Texas,Polk County,9,2752,1594,1158
Texas,Polk County,10,2883,1660,1223
Texas,Polk County,11,3257,1689,1568
Texas,Polk County,12,3478,1743,1735
Texas,Polk County,13,3444,1713,1731
Texas,Polk County,14,3462,1716,1746
Texas,Polk County,15,2466,1293,1173
Texas,Polk County,16,1525,754,771
Texas,Polk County,17,980,473,507
Texas,Polk County,18,742,305,437
Texas,Potter County,0,121627,62394,59233
Texas,Potter County,1,10151,5212,4939
Texas,Potter County,2,9635,4922,4713
Texas,Potter County,3,8746,4390,4356
Texas,Potter County,4,7829,4032,3797
Texas,Potter County,5,8689,4427,4262
Texas,Potter County,6,9444,4949,4495
Texas,Potter County,7,9267,5063,4204
Texas,Potter County,8,7785,4209,3576
Texas,Potter County,9,7518,4132,3386
Texas,Potter County,10,7442,4134,3308
Texas,Potter County,11,7700,4035,3665
Texas,Potter County,12,7358,3730,3628
Texas,Potter County,13,5994,3038,2956
Texas,Potter County,14,4514,2140,2374
Texas,Potter County,15,3244,1542,1702
Texas,Potter County,16,2403,991,1412
Texas,Potter County,17,1871,773,1098
Texas,Potter County,18,2037,675,1362
Texas,Presidio County,0,6976,3483,3493
Texas,Presidio County,1,492,268,224
Texas,Presidio County,2,499,255,244
Texas,Presidio County,3,501,262,239
Texas,Presidio County,4,535,272,263
Texas,Presidio County,5,405,215,190
Texas,Presidio County,6,366,193,173
Texas,Presidio County,7,356,178,178
Texas,Presidio County,8,363,162,201
Texas,Presidio County,9,413,193,220
Texas,Presidio County,10,397,197,200
Texas,Presidio County,11,405,203,202
Texas,Presidio County,12,392,193,199
Texas,Presidio County,13,387,185,202
Texas,Presidio County,14,424,217,207
Texas,Presidio County,15,354,179,175
Texas,Presidio County,16,277,136,141
Texas,Presidio County,17,180,92,88
Texas,Presidio County,18,230,83,147
Texas,Rains County,0,11032,5515,5517
Texas,Rains County,1,555,296,259
Texas,Rains County,2,590,303,287
Texas,Rains County,3,638,328,310
Texas,Rains County,4,671,371,300
Texas,Rains County,5,520,266,254
Texas,Rains County,6,516,269,247
Texas,Rains County,7,529,256,273
Texas,Rains County,8,520,256,264
Texas,Rains County,9,623,300,323
Texas,Rains County,10,693,361,332
Texas,Rains County,11,821,415,406
Texas,Rains County,12,888,420,468
Texas,Rains County,13,861,393,468
Texas,Rains County,14,908,454,454
Texas,Rains County,15,694,358,336
Texas,Rains County,16,475,229,246
Texas,Rains County,17,300,141,159
Texas,Rains County,18,230,99,131
Texas,Randall County,0,128220,63080,65140
Texas,Randall County,1,8459,4453,4006
Texas,Randall County,2,8738,4410,4328
Texas,Randall County,3,8727,4469,4258
Texas,Randall County,4,9175,4681,4494
Texas,Randall County,5,9442,4770,4672
Texas,Randall County,6,9636,4852,4784
Texas,Randall County,7,9378,4726,4652
Texas,Randall County,8,8272,4217,4055
Texas,Randall County,9,7651,3739,3912
Texas,Randall County,10,7202,3495,3707
Texas,Randall County,11,8312,4047,4265
Texas,Randall County,12,8525,4056,4469
Texas,Randall County,13,7312,3491,3821
Texas,Randall County,14,5743,2750,2993
Texas,Randall County,15,4248,1923,2325
Texas,Randall County,16,3186,1363,1823
Texas,Randall County,17,2369,986,1383
Texas,Randall County,18,1845,652,1193
Texas,Reagan County,0,3755,1962,1793
Texas,Reagan County,1,316,156,160
Texas,Reagan County,2,324,181,143
Texas,Reagan County,3,292,133,159
Texas,Reagan County,4,327,172,155
Texas,Reagan County,5,225,133,92
Texas,Reagan County,6,248,128,120
Texas,Reagan County,7,262,141,121
Texas,Reagan County,8,233,142,91
Texas,Reagan County,9,211,101,110
Texas,Reagan County,10,250,127,123
Texas,Reagan County,11,255,141,114
Texas,Reagan County,12,243,121,122
Texas,Reagan County,13,184,97,87
Texas,Reagan County,14,135,71,64
Texas,Reagan County,15,73,37,36
Texas,Reagan County,16,85,41,44
Texas,Reagan County,17,59,27,32
Texas,Reagan County,18,33,13,20
Texas,Real County,0,3371,1666,1705
Texas,Real County,1,176,99,77
Texas,Real County,2,150,71,79
Texas,Real County,3,155,84,71
Texas,Real County,4,163,80,83
Texas,Real County,5,183,92,91
Texas,Real County,6,123,67,56
Texas,Real County,7,139,56,83
Texas,Real County,8,143,70,73
Texas,Real County,9,165,74,91
Texas,Real County,10,179,88,91
Texas,Real County,11,242,116,126
Texas,Real County,12,285,144,141
Texas,Real County,13,306,141,165
Texas,Real County,14,315,153,162
Texas,Real County,15,249,129,120
Texas,Real County,16,208,111,97
Texas,Real County,17,111,59,52
Texas,Real County,18,79,32,47
Texas,Red River County,0,12446,6017,6429
Texas,Red River County,1,647,298,349
Texas,Red River County,2,689,354,335
Texas,Red River County,3,735,404,331
Texas,Red River County,4,701,362,339
Texas,Red River County,5,674,349,325
Texas,Red River County,6,626,319,307
Texas,Red River County,7,655,323,332
Texas,Red River County,8,601,279,322
Texas,Red River County,9,734,360,374
Texas,Red River County,10,757,357,400
Texas,Red River County,11,922,453,469
Texas,Red River County,12,930,436,494
Texas,Red River County,13,934,468,466
Texas,Red River County,14,851,392,459
Texas,Red River County,15,751,357,394
Texas,Red River County,16,547,242,305
Texas,Red River County,17,348,141,207
Texas,Red River County,18,344,123,221
Texas,Reeves County,0,14349,8627,5722
Texas,Reeves County,1,868,415,453
Texas,Reeves County,2,963,463,500
Texas,Reeves County,3,890,479,411
Texas,Reeves County,4,875,464,411
Texas,Reeves County,5,1421,1032,389
Texas,Reeves County,6,1088,746,342
Texas,Reeves County,7,1223,868,355
Texas,Reeves County,8,1219,910,309
Texas,Reeves County,9,940,629,311
Texas,Reeves County,10,977,664,313
Texas,Reeves County,11,808,473,335
Texas,Reeves County,12,752,388,364
Texas,Reeves County,13,603,323,280
Texas,Reeves County,14,500,234,266
Texas,Reeves County,15,455,208,247
Texas,Reeves County,16,325,140,185
Texas,Reeves County,17,239,108,131
Texas,Reeves County,18,203,83,120
Texas,Refugio County,0,7302,3611,3691
Texas,Refugio County,1,440,227,213
Texas,Refugio County,2,477,220,257
Texas,Refugio County,3,487,241,246
Texas,Refugio County,4,445,249,196
Texas,Refugio County,5,481,252,229
Texas,Refugio County,6,369,195,174
Texas,Refugio County,7,386,192,194
Texas,Refugio County,8,354,163,191
Texas,Refugio County,9,426,210,216
Texas,Refugio County,10,434,199,235
Texas,Refugio County,11,518,267,251
Texas,Refugio County,12,545,280,265
Texas,Refugio County,13,430,232,198
Texas,Refugio County,14,450,208,242
Texas,Refugio County,15,378,173,205
Texas,Refugio County,16,303,156,147
Texas,Refugio County,17,196,72,124
Texas,Refugio County,18,183,75,108
Texas,Roberts County,0,928,457,471
Texas,Roberts County,1,39,17,22
Texas,Roberts County,2,66,41,25
Texas,Roberts County,3,77,37,40
Texas,Roberts County,4,65,32,33
Texas,Roberts County,5,38,17,21
Texas,Roberts County,6,54,24,30
Texas,Roberts County,7,68,32,36
Texas,Roberts County,8,50,25,25
Texas,Roberts County,9,44,22,22
Texas,Roberts County,10,57,34,23
Texas,Roberts County,11,75,39,36
Texas,Roberts County,12,58,30,28
Texas,Roberts County,13,64,33,31
Texas,Roberts County,14,64,34,30
Texas,Roberts County,15,52,27,25
Texas,Roberts County,16,22,6,16
Texas,Roberts County,17,19,5,14
Texas,Roberts County,18,16,2,14
Texas,Robertson County,0,16500,8165,8335
Texas,Robertson County,1,1111,572,539
Texas,Robertson County,2,1150,602,548
Texas,Robertson County,3,1104,554,550
Texas,Robertson County,4,1045,545,500
Texas,Robertson County,5,1023,507,516
Texas,Robertson County,6,883,452,431
Texas,Robertson County,7,928,462,466
Texas,Robertson County,8,894,438,456
Texas,Robertson County,9,887,422,465
Texas,Robertson County,10,1020,490,530
Texas,Robertson County,11,1096,560,536
Texas,Robertson County,12,1221,619,602
Texas,Robertson County,13,1089,525,564
Texas,Robertson County,14,999,507,492
Texas,Robertson County,15,732,336,396
Texas,Robertson County,16,557,266,291
Texas,Robertson County,17,352,156,196
Texas,Robertson County,18,409,152,257
Texas,Rockwall County,0,87809,43019,44790
Texas,Rockwall County,1,5391,2765,2626
Texas,Rockwall County,2,6761,3395,3366
Texas,Rockwall County,3,7673,3870,3803
Texas,Rockwall County,4,6842,3563,3279
Texas,Rockwall County,5,4599,2376,2223
Texas,Rockwall County,6,4142,2004,2138
Texas,Rockwall County,7,5660,2751,2909
Texas,Rockwall County,8,6364,3034,3330
Texas,Rockwall County,9,6876,3323,3553
Texas,Rockwall County,10,6513,3297,3216
Texas,Rockwall County,11,6589,3226,3363
Texas,Rockwall County,12,5619,2677,2942
Texas,Rockwall County,13,4405,2149,2256
Texas,Rockwall County,14,3614,1729,1885
Texas,Rockwall County,15,2718,1262,1456
Texas,Rockwall County,16,1707,775,932
Texas,Rockwall County,17,1144,446,698
Texas,Rockwall County,18,1192,377,815
Texas,Runnels County,0,10416,5210,5206
Texas,Runnels County,1,571,292,279
Texas,Runnels County,2,706,364,342
Texas,Runnels County,3,751,382,369
Texas,Runnels County,4,736,385,351
Texas,Runnels County,5,534,280,254
Texas,Runnels County,6,546,286,260
Texas,Runnels County,7,606,308,298
Texas,Runnels County,8,492,242,250
Texas,Runnels County,9,575,277,298
Texas,Runnels County,10,632,311,321
Texas,Runnels County,11,706,371,335
Texas,Runnels County,12,709,348,361
Texas,Runnels County,13,703,370,333
Texas,Runnels County,14,614,289,325
Texas,Runnels County,15,522,236,286
Texas,Runnels County,16,409,192,217
Texas,Runnels County,17,305,143,162
Texas,Runnels County,18,299,134,165
Texas,Rusk County,0,53923,28544,25379
Texas,Rusk County,1,3514,1849,1665
Texas,Rusk County,2,3519,1752,1767
Texas,Rusk County,3,3460,1734,1726
Texas,Rusk County,4,3192,1686,1506
Texas,Rusk County,5,3706,2242,1464
Texas,Rusk County,6,3652,2137,1515
Texas,Rusk County,7,3680,2067,1613
Texas,Rusk County,8,3423,1861,1562
Texas,Rusk County,9,3481,2007,1474
Texas,Rusk County,10,3429,1962,1467
Texas,Rusk County,11,3824,2014,1810
Texas,Rusk County,12,3679,1931,1748
Texas,Rusk County,13,3214,1604,1610
Texas,Rusk County,14,2736,1341,1395
Texas,Rusk County,15,1979,935,1044
Texas,Rusk County,16,1396,632,764
Texas,Rusk County,17,1000,413,587
Texas,Rusk County,18,1039,377,662
Texas,Sabine County,0,10350,5102,5248
Texas,Sabine County,1,440,217,223
Texas,Sabine County,2,539,279,260
Texas,Sabine County,3,578,296,282
Texas,Sabine County,4,559,267,292
Texas,Sabine County,5,478,236,242
Texas,Sabine County,6,446,220,226
Texas,Sabine County,7,417,183,234
Texas,Sabine County,8,420,206,214
Texas,Sabine County,9,485,239,246
Texas,Sabine County,10,585,279,306
Texas,Sabine County,11,761,381,380
Texas,Sabine County,12,835,413,422
Texas,Sabine County,13,850,418,432
Texas,Sabine County,14,948,469,479
Texas,Sabine County,15,843,446,397
Texas,Sabine County,16,525,272,253
Texas,Sabine County,17,339,160,179
Texas,Sabine County,18,302,121,181
Texas,San Augustine County,0,8610,4196,4414
Texas,San Augustine County,1,515,258,257
Texas,San Augustine County,2,481,249,232
Texas,San Augustine County,3,470,238,232
Texas,San Augustine County,4,440,230,210
Texas,San Augustine County,5,461,225,236
Texas,San Augustine County,6,426,214,212
Texas,San Augustine County,7,362,162,200
Texas,San Augustine County,8,387,196,191
Texas,San Augustine County,9,425,209,216
Texas,San Augustine County,10,506,255,251
Texas,San Augustine County,11,639,308,331
Texas,San Augustine County,12,686,350,336
Texas,San Augustine County,13,636,325,311
Texas,San Augustine County,14,648,314,334
Texas,San Augustine County,15,548,267,281
Texas,San Augustine County,16,381,182,199
Texas,San Augustine County,17,286,113,173
Texas,San Augustine County,18,313,101,212
Texas,San Jacinto County,0,27099,13658,13441
Texas,San Jacinto County,1,1489,816,673
Texas,San Jacinto County,2,1649,892,757
Texas,San Jacinto County,3,1811,924,887
Texas,San Jacinto County,4,1721,903,818
Texas,San Jacinto County,5,1510,770,740
Texas,San Jacinto County,6,1349,701,648
Texas,San Jacinto County,7,1310,643,667
Texas,San Jacinto County,8,1371,654,717
Texas,San Jacinto County,9,1553,776,777
Texas,San Jacinto County,10,1572,752,820
Texas,San Jacinto County,11,2046,1030,1016
Texas,San Jacinto County,12,2264,1140,1124
Texas,San Jacinto County,13,2044,982,1062
Texas,San Jacinto County,14,1843,928,915
Texas,San Jacinto County,15,1480,752,728
Texas,San Jacinto County,16,991,482,509
Texas,San Jacinto County,17,641,321,320
Texas,San Jacinto County,18,455,192,263
Texas,San Patricio County,0,66915,33575,33340
Texas,San Patricio County,1,4780,2469,2311
Texas,San Patricio County,2,5017,2537,2480
Texas,San Patricio County,3,5283,2742,2541
Texas,San Patricio County,4,5006,2609,2397
Texas,San Patricio County,5,4500,2401,2099
Texas,San Patricio County,6,4300,2254,2046
Texas,San Patricio County,7,4394,2165,2229
Texas,San Patricio County,8,4038,2056,1982
Texas,San Patricio County,9,4076,2000,2076
Texas,San Patricio County,10,4023,1990,2033
Texas,San Patricio County,11,4425,2177,2248
Texas,San Patricio County,12,4004,2029,1975
Texas,San Patricio County,13,3567,1794,1773
Texas,San Patricio County,14,3241,1567,1674
Texas,San Patricio County,15,2391,1132,1259
Texas,San Patricio County,16,1707,787,920
Texas,San Patricio County,17,1179,491,688
Texas,San Patricio County,18,984,375,609
Texas,San Saba County,0,5622,2938,2684
Texas,San Saba County,1,324,157,167
Texas,San Saba County,2,297,139,158
Texas,San Saba County,3,346,190,156
Texas,San Saba County,4,343,178,165
Texas,San Saba County,5,378,248,130
Texas,San Saba County,6,377,255,122
Texas,San Saba County,7,338,217,121
Texas,San Saba County,8,220,104,116
Texas,San Saba County,9,269,126,143
Texas,San Saba County,10,306,165,141
Texas,San Saba County,11,343,162,181
Texas,San Saba County,12,373,161,212
Texas,San Saba County,13,427,221,206
Texas,San Saba County,14,409,201,208
Texas,San Saba County,15,328,179,149
Texas,San Saba County,16,210,101,109
Texas,San Saba County,17,179,75,104
Texas,San Saba County,18,155,59,96
Texas,Schleicher County,0,3162,1616,1546
Texas,Schleicher County,1,184,91,93
Texas,Schleicher County,2,289,156,133
Texas,Schleicher County,3,285,142,143
Texas,Schleicher County,4,235,131,104
Texas,Schleicher County,5,156,75,81
Texas,Schleicher County,6,186,90,96
Texas,Schleicher County,7,237,119,118
Texas,Schleicher County,8,144,79,65
Texas,Schleicher County,9,192,94,98
Texas,Schleicher County,10,164,79,85
Texas,Schleicher County,11,211,101,110
Texas,Schleicher County,12,177,97,80
Texas,Schleicher County,13,223,120,103
Texas,Schleicher County,14,174,90,84
Texas,Schleicher County,15,118,56,62
Texas,Schleicher County,16,80,35,45
Texas,Schleicher County,17,73,40,33
Texas,Schleicher County,18,34,21,13
Texas,Scurry County,0,17328,9354,7974
Texas,Scurry County,1,1294,686,608
Texas,Scurry County,2,1260,700,560
Texas,Scurry County,3,1169,573,596
Texas,Scurry County,4,1156,610,546
Texas,Scurry County,5,1290,731,559
Texas,Scurry County,6,1158,698,460
Texas,Scurry County,7,1259,717,542
Texas,Scurry County,8,1067,608,459
Texas,Scurry County,9,1049,644,405
Texas,Scurry County,10,1055,609,446
Texas,Scurry County,11,1138,638,500
Texas,Scurry County,12,1115,611,504
Texas,Scurry County,13,942,489,453
Texas,Scurry County,14,686,335,351
Texas,Scurry County,15,531,239,292
Texas,Scurry County,16,443,195,248
Texas,Scurry County,17,376,163,213
Texas,Scurry County,18,340,108,232
Texas,Shackelford County,0,3343,1633,1710
Texas,Shackelford County,1,191,106,85
Texas,Shackelford County,2,218,121,97
Texas,Shackelford County,3,243,111,132
Texas,Shackelford County,4,204,95,109
Texas,Shackelford County,5,196,97,99
Texas,Shackelford County,6,180,94,86
Texas,Shackelford County,7,149,73,76
Texas,Shackelford County,8,169,76,93
Texas,Shackelford County,9,204,103,101
Texas,Shackelford County,10,195,110,85
Texas,Shackelford County,11,282,130,152
Texas,Shackelford County,12,277,138,139
Texas,Shackelford County,13,216,90,126
Texas,Shackelford County,14,189,98,91
Texas,Shackelford County,15,142,68,74
Texas,Shackelford County,16,120,58,62
Texas,Shackelford County,17,95,40,55
Texas,Shackelford County,18,73,25,48
Texas,Shelby County,0,25515,12618,12897
Texas,Shelby County,1,1825,888,937
Texas,Shelby County,2,1899,974,925
Texas,Shelby County,3,1900,986,914
Texas,Shelby County,4,1667,855,812
Texas,Shelby County,5,1609,810,799
Texas,Shelby County,6,1513,764,749
Texas,Shelby County,7,1490,759,731
Texas,Shelby County,8,1494,713,781
Texas,Shelby County,9,1531,748,783
Texas,Shelby County,10,1573,769,804
Texas,Shelby County,11,1707,889,818
Texas,Shelby County,12,1699,837,862
Texas,Shelby County,13,1491,729,762
Texas,Shelby County,14,1273,626,647
Texas,Shelby County,15,1069,493,576
Texas,Shelby County,16,800,388,412
Texas,Shelby County,17,513,215,298
Texas,Shelby County,18,462,175,287
Texas,Sherman County,0,3084,1613,1471
Texas,Sherman County,1,217,130,87
Texas,Sherman County,2,248,135,113
Texas,Sherman County,3,259,124,135
Texas,Sherman County,4,231,123,108
Texas,Sherman County,5,191,110,81
Texas,Sherman County,6,158,81,77
Texas,Sherman County,7,184,88,96
Texas,Sherman County,8,166,94,72
Texas,Sherman County,9,210,97,113
Texas,Sherman County,10,221,106,115
Texas,Sherman County,11,220,122,98
Texas,Sherman County,12,212,120,92
Texas,Sherman County,13,135,70,65
Texas,Sherman County,14,132,71,61
Texas,Sherman County,15,106,57,49
Texas,Sherman County,16,69,36,33
Texas,Sherman County,17,68,25,43
Texas,Sherman County,18,57,24,33
Texas,Smith County,0,218842,105732,113110
Texas,Smith County,1,15245,7738,7507
Texas,Smith County,2,15143,7721,7422
Texas,Smith County,3,15122,7749,7373
Texas,Smith County,4,15080,7724,7356
Texas,Smith County,5,16073,7961,8112
Texas,Smith County,6,15328,7396,7932
Texas,Smith County,7,14100,6883,7217
Texas,Smith County,8,12593,6063,6530
Texas,Smith County,9,13218,6262,6956
Texas,Smith County,10,12728,6129,6599
Texas,Smith County,11,14006,6708,7298
Texas,Smith County,12,13895,6601,7294
Texas,Smith County,13,12341,5878,6463
Texas,Smith County,14,10597,4891,5706
Texas,Smith County,15,8236,3742,4494
Texas,Smith County,16,6186,2776,3410
Texas,Smith County,17,4586,1885,2701
Texas,Smith County,18,4365,1625,2740
Texas,Somervell County,0,8694,4287,4407
Texas,Somervell County,1,440,212,228
Texas,Somervell County,2,557,290,267
Texas,Somervell County,3,611,293,318
Texas,Somervell County,4,668,375,293
Texas,Somervell County,5,510,239,271
Texas,Somervell County,6,442,215,227
Texas,Somervell County,7,454,231,223
Texas,Somervell County,8,500,239,261
Texas,Somervell County,9,521,252,269
Texas,Somervell County,10,570,280,290
Texas,Somervell County,11,642,324,318
Texas,Somervell County,12,618,308,310
Texas,Somervell County,13,589,290,299
Texas,Somervell County,14,538,266,272
Texas,Somervell County,15,394,201,193
Texas,Somervell County,16,258,131,127
Texas,Somervell County,17,187,74,113
Texas,Somervell County,18,195,67,128
Texas,Starr County,0,62955,30603,32352
Texas,Starr County,1,6524,3247,3277
Texas,Starr County,2,5339,2665,2674
Texas,Starr County,3,5619,2806,2813
Texas,Starr County,4,5459,2741,2718
Texas,Starr County,5,5155,2655,2500
Texas,Starr County,6,4107,2087,2020
Texas,Starr County,7,3860,1950,1910
Texas,Starr County,8,3786,1815,1971
Texas,Starr County,9,3917,1890,2027
Texas,Starr County,10,3575,1643,1932
Texas,Starr County,11,3244,1564,1680
Texas,Starr County,12,2781,1279,1502
Texas,Starr County,13,2472,1088,1384
Texas,Starr County,14,2293,1006,1287
Texas,Starr County,15,1755,829,926
Texas,Starr County,16,1425,640,785
Texas,Starr County,17,851,397,454
Texas,Starr County,18,793,301,492
Texas,Stephens County,0,9405,4922,4483
Texas,Stephens County,1,505,251,254
Texas,Stephens County,2,620,326,294
Texas,Stephens County,3,595,294,301
Texas,Stephens County,4,593,322,271
Texas,Stephens County,5,676,444,232
Texas,Stephens County,6,602,363,239
Texas,Stephens County,7,594,340,254
Texas,Stephens County,8,525,279,246
Texas,Stephens County,9,495,267,228
Texas,Stephens County,10,500,278,222
Texas,Stephens County,11,691,340,351
Texas,Stephens County,12,603,295,308
Texas,Stephens County,13,613,303,310
Texas,Stephens County,14,529,263,266
Texas,Stephens County,15,462,228,234
Texas,Stephens County,16,316,137,179
Texas,Stephens County,17,249,98,151
Texas,Stephens County,18,237,94,143
Texas,Sterling County,0,1339,699,640
Texas,Sterling County,1,73,38,35
Texas,Sterling County,2,122,67,55
Texas,Sterling County,3,100,54,46
Texas,Sterling County,4,90,50,40
Texas,Sterling County,5,68,42,26
Texas,Sterling County,6,89,48,41
Texas,Sterling County,7,96,48,48
Texas,Sterling County,8,79,40,39
Texas,Sterling County,9,64,32,32
Texas,Sterling County,10,79,37,42
Texas,Sterling County,11,84,50,34
Texas,Sterling County,12,99,49,50
Texas,Sterling County,13,73,40,33
Texas,Sterling County,14,76,47,29
Texas,Sterling County,15,39,13,26
Texas,Sterling County,16,42,19,23
Texas,Sterling County,17,37,17,20
Texas,Sterling County,18,29,8,21
Texas,Stonewall County,0,1403,675,728
Texas,Stonewall County,1,77,44,33
Texas,Stonewall County,2,87,39,48
Texas,Stonewall County,3,100,45,55
Texas,Stonewall County,4,74,28,46
Texas,Stonewall County,5,55,32,23
Texas,Stonewall County,6,55,29,26
Texas,Stonewall County,7,75,34,41
Texas,Stonewall County,8,63,27,36
Texas,Stonewall County,9,71,29,42
Texas,Stonewall County,10,77,48,29
Texas,Stonewall County,11,107,58,49
Texas,Stonewall County,12,108,54,54
Texas,Stonewall County,13,92,49,43
Texas,Stonewall County,14,85,34,51
Texas,Stonewall County,15,70,36,34
Texas,Stonewall County,16,67,28,39
Texas,Stonewall County,17,75,34,41
Texas,Stonewall County,18,65,27,38
Texas,Sutton County,0,3972,1997,1975
Texas,Sutton County,1,309,150,159
Texas,Sutton County,2,259,127,132
Texas,Sutton County,3,278,115,163
Texas,Sutton County,4,263,151,112
Texas,Sutton County,5,261,146,115
Texas,Sutton County,6,239,118,121
Texas,Sutton County,7,229,127,102
Texas,Sutton County,8,205,93,112
Texas,Sutton County,9,255,126,129
Texas,Sutton County,10,244,127,117
Texas,Sutton County,11,293,144,149
Texas,Sutton County,12,258,127,131
Texas,Sutton County,13,241,115,126
Texas,Sutton County,14,221,120,101
Texas,Sutton County,15,147,78,69
Texas,Sutton County,16,111,67,44
Texas,Sutton County,17,97,45,52
Texas,Sutton County,18,62,21,41
Texas,Swisher County,0,7581,3965,3616
Texas,Swisher County,1,514,246,268
Texas,Swisher County,2,553,265,288
Texas,Swisher County,3,557,283,274
Texas,Swisher County,4,480,244,236
Texas,Swisher County,5,525,322,203
Texas,Swisher County,6,511,323,188
Texas,Swisher County,7,487,300,187
Texas,Swisher County,8,412,234,178
Texas,Swisher County,9,373,202,171
Texas,Swisher County,10,457,246,211
Texas,Swisher County,11,458,237,221
Texas,Swisher County,12,444,231,213
Texas,Swisher County,13,435,222,213
Texas,Swisher County,14,364,181,183
Texas,Swisher County,15,333,159,174
Texas,Swisher County,16,261,107,154
Texas,Swisher County,17,216,92,124
Texas,Swisher County,18,201,71,130
Texas,Tarrant County,0,1945360,951765,993595
Texas,Tarrant County,1,142129,71744,70385
Texas,Tarrant County,2,149903,76525,73378
Texas,Tarrant County,3,149541,76125,73416
Texas,Tarrant County,4,135926,68990,66936
Texas,Tarrant County,5,133717,66831,66886
Texas,Tarrant County,6,143502,70449,73053
Texas,Tarrant County,7,143441,70309,73132
Texas,Tarrant County,8,132879,64509,68370
Texas,Tarrant County,9,137562,66968,70594
Texas,Tarrant County,10,131263,64436,66827
Texas,Tarrant County,11,135015,66379,68636
Texas,Tarrant County,12,118900,58276,60624
Texas,Tarrant County,13,92803,44064,48739
Texas,Tarrant County,14,71891,33721,38170
Texas,Tarrant County,15,48068,21913,26155
Texas,Tarrant County,16,32608,13825,18783
Texas,Tarrant County,17,23147,9215,13932
Texas,Tarrant County,18,23065,7486,15579
Texas,Taylor County,0,135143,66046,69097
Texas,Taylor County,1,9924,4938,4986
Texas,Taylor County,2,9532,4909,4623
Texas,Taylor County,3,8734,4422,4312
Texas,Taylor County,4,10236,5096,5140
Texas,Taylor County,5,14839,7600,7239
Texas,Taylor County,6,10237,5245,4992
Texas,Taylor County,7,9280,4684,4596
Texas,Taylor County,8,7306,3626,3680
Texas,Taylor County,9,6839,3365,3474
Texas,Taylor County,10,6868,3347,3521
Texas,Taylor County,11,8224,3972,4252
Texas,Taylor County,12,7864,3773,4091
Texas,Taylor County,13,6495,3066,3429
Texas,Taylor County,14,5540,2562,2978
Texas,Taylor County,15,4415,1976,2439
Texas,Taylor County,16,3487,1498,1989
Texas,Taylor County,17,2721,1061,1660
Texas,Taylor County,18,2602,906,1696
Texas,Terrell County,0,927,493,434
Texas,Terrell County,1,54,26,28
Texas,Terrell County,2,46,27,19
Texas,Terrell County,3,52,35,17
Texas,Terrell County,4,49,28,21
Texas,Terrell County,5,56,34,22
Texas,Terrell County,6,58,36,22
Texas,Terrell County,7,55,25,30
Texas,Terrell County,8,71,36,35
Texas,Terrell County,9,52,29,23
Texas,Terrell County,10,42,18,24
Texas,Terrell County,11,55,33,22
Texas,Terrell County,12,54,28,26
Texas,Terrell County,13,70,36,34
Texas,Terrell County,14,74,37,37
Texas,Terrell County,15,45,21,24
Texas,Terrell County,16,35,17,18
Texas,Terrell County,17,33,17,16
Texas,Terrell County,18,26,10,16
Texas,Terry County,0,12739,6728,6011
Texas,Terry County,1,1007,515,492
Texas,Terry County,2,1003,514,489
Texas,Terry County,3,909,448,461
Texas,Terry County,4,816,436,380
Texas,Terry County,5,937,572,365
Texas,Terry County,6,977,596,381
Texas,Terry County,7,857,507,350
Texas,Terry County,8,718,412,306
Texas,Terry County,9,674,369,305
Texas,Terry County,10,750,376,374
Texas,Terry County,11,813,451,362
Texas,Terry County,12,794,398,396
Texas,Terry County,13,628,310,318
Texas,Terry County,14,540,267,273
Texas,Terry County,15,458,221,237
Texas,Terry County,16,369,146,223
Texas,Terry County,17,257,106,151
Texas,Terry County,18,232,84,148
Texas,Throckmorton County,0,1608,788,820
Texas,Throckmorton County,1,75,35,40
Texas,Throckmorton County,2,107,56,51
Texas,Throckmorton County,3,99,47,52
Texas,Throckmorton County,4,101,64,37
Texas,Throckmorton County,5,74,41,33
Texas,Throckmorton County,6,75,34,41
Texas,Throckmorton County,7,92,48,44
Texas,Throckmorton County,8,60,30,30
Texas,Throckmorton County,9,84,37,47
Texas,Throckmorton County,10,92,39,53
Texas,Throckmorton County,11,124,59,65
Texas,Throckmorton County,12,112,58,54
Texas,Throckmorton County,13,106,56,50
Texas,Throckmorton County,14,100,47,53
Texas,Throckmorton County,15,102,50,52
Texas,Throckmorton County,16,89,42,47
Texas,Throckmorton County,17,63,26,37
Texas,Throckmorton County,18,53,19,34
Texas,Titus County,0,32506,16081,16425
Texas,Titus County,1,2615,1361,1254
Texas,Titus County,2,2833,1413,1420
Texas,Titus County,3,2539,1276,1263
Texas,Titus County,4,2475,1254,1221
Texas,Titus County,5,2330,1222,1108
Texas,Titus County,6,1998,965,1033
Texas,Titus County,7,1929,948,981
Texas,Titus County,8,1955,977,978
Texas,Titus County,9,2079,1034,1045
Texas,Titus County,10,1984,995,989
Texas,Titus County,11,2025,1013,1012
Texas,Titus County,12,1801,877,924
Texas,Titus County,13,1666,828,838
Texas,Titus County,14,1422,681,741
Texas,Titus County,15,1033,482,551
Texas,Titus County,16,786,364,422
Texas,Titus County,17,499,200,299
Texas,Titus County,18,537,191,346
Texas,Tom Green County,0,116608,57965,58643
Texas,Tom Green County,1,7900,4065,3835
Texas,Tom Green County,2,7973,4061,3912
Texas,Tom Green County,3,7345,3790,3555
Texas,Tom Green County,4,8381,4361,4020
Texas,Tom Green County,5,10688,5743,4945
Texas,Tom Green County,6,9665,5177,4488
Texas,Tom Green County,7,8404,4296,4108
Texas,Tom Green County,8,6330,3199,3131
Texas,Tom Green County,9,6119,2961,3158
Texas,Tom Green County,10,6166,2925,3241
Texas,Tom Green County,11,7169,3431,3738
Texas,Tom Green County,12,7180,3380,3800
Texas,Tom Green County,13,6434,3090,3344
Texas,Tom Green County,14,5154,2454,2700
Texas,Tom Green County,15,3926,1835,2091
Texas,Tom Green County,16,3117,1340,1777
Texas,Tom Green County,17,2378,1031,1347
Texas,Tom Green County,18,2279,826,1453
Texas,Travis County,0,1151145,579894,571251
Texas,Travis County,1,79118,40831,38287
Texas,Travis County,2,75937,38620,37317
Texas,Travis County,3,71037,36077,34960
Texas,Travis County,4,69866,35574,34292
Texas,Travis County,5,84272,42667,41605
Texas,Travis County,6,118594,60672,57922
Texas,Travis County,7,109949,56887,53062
Texas,Travis County,8,94224,48659,45565
Texas,Travis County,9,87138,45252,41886
Texas,Travis County,10,73998,37847,36151
Texas,Travis County,11,71808,36118,35690
Texas,Travis County,12,64683,31824,32859
Texas,Travis County,13,53436,25683,27753
Texas,Travis County,14,37296,17938,19358
Texas,Travis County,15,22633,10564,12069
Texas,Travis County,16,14658,6370,8288
Texas,Travis County,17,10704,4463,6241
Texas,Travis County,18,11794,3848,7946
Texas,Trinity County,0,14224,6851,7373
Texas,Trinity County,1,670,342,328
Texas,Trinity County,2,793,410,383
Texas,Trinity County,3,811,390,421
Texas,Trinity County,4,781,385,396
Texas,Trinity County,5,692,353,339
Texas,Trinity County,6,642,291,351
Texas,Trinity County,7,680,336,344
Texas,Trinity County,8,668,315,353
Texas,Trinity County,9,766,369,397
Texas,Trinity County,10,783,392,391
Texas,Trinity County,11,1053,498,555
Texas,Trinity County,12,1108,486,622
Texas,Trinity County,13,1180,541,639
Texas,Trinity County,14,1138,589,549
Texas,Trinity County,15,935,440,495
Texas,Trinity County,16,689,348,341
Texas,Trinity County,17,472,207,265
Texas,Trinity County,18,363,159,204
Texas,Tyler County,0,21418,11584,9834
Texas,Tyler County,1,1138,604,534
Texas,Tyler County,2,1152,590,562
Texas,Tyler County,3,1159,587,572
Texas,Tyler County,4,1132,598,534
Texas,Tyler County,5,1487,1010,477
Texas,Tyler County,6,1468,1033,435
Texas,Tyler County,7,1369,871,498
Texas,Tyler County,8,1237,745,492
Texas,Tyler County,9,1183,676,507
Texas,Tyler County,10,1331,698,633
Texas,Tyler County,11,1420,683,737
Texas,Tyler County,12,1477,754,723
Texas,Tyler County,13,1457,709,748
Texas,Tyler County,14,1347,635,712
Texas,Tyler County,15,1205,574,631
Texas,Tyler County,16,821,402,419
Texas,Tyler County,17,579,253,326
Texas,Tyler County,18,456,162,294
Texas,Upshur County,0,40354,19968,20386
Texas,Upshur County,1,2537,1297,1240
Texas,Upshur County,2,2692,1385,1307
Texas,Upshur County,3,2810,1481,1329
Texas,Upshur County,4,2587,1403,1184
Texas,Upshur County,5,2412,1263,1149
Texas,Upshur County,6,2191,1043,1148
Texas,Upshur County,7,2369,1157,1212
Texas,Upshur County,8,2175,1059,1116
Texas,Upshur County,9,2324,1177,1147
Texas,Upshur County,10,2468,1222,1246
Texas,Upshur County,11,3096,1437,1659
Texas,Upshur County,12,3136,1563,1573
Texas,Upshur County,13,2656,1290,1366
Texas,Upshur County,14,2273,1128,1145
Texas,Upshur County,15,1780,826,954
Texas,Upshur County,16,1278,595,683
Texas,Upshur County,17,846,378,468
Texas,Upshur County,18,724,264,460
Texas,Upton County,0,3454,1760,1694
Texas,Upton County,1,284,161,123
Texas,Upton County,2,259,113,146
Texas,Upton County,3,271,128,143
Texas,Upton County,4,244,130,114
Texas,Upton County,5,211,114,97
Texas,Upton County,6,218,106,112
Texas,Upton County,7,244,141,103
Texas,Upton County,8,202,109,93
Texas,Upton County,9,199,99,100
Texas,Upton County,10,180,89,91
Texas,Upton County,11,206,98,108
Texas,Upton County,12,260,142,118
Texas,Upton County,13,200,95,105
Texas,Upton County,14,123,66,57
Texas,Upton County,15,115,65,50
Texas,Upton County,16,100,47,53
Texas,Upton County,17,76,38,38
Texas,Upton County,18,62,19,43
Texas,Uvalde County,0,27117,13373,13744
Texas,Uvalde County,1,2058,1016,1042
Texas,Uvalde County,2,2081,1039,1042
Texas,Uvalde County,3,2138,1092,1046
Texas,Uvalde County,4,2128,1097,1031
Texas,Uvalde County,5,2106,1086,1020
Texas,Uvalde County,6,1757,916,841
Texas,Uvalde County,7,1570,786,784
Texas,Uvalde County,8,1548,774,774
Texas,Uvalde County,9,1551,740,811
Texas,Uvalde County,10,1475,740,735
Texas,Uvalde County,11,1516,716,800
Texas,Uvalde County,12,1521,779,742
Texas,Uvalde County,13,1322,635,687
Texas,Uvalde County,14,1426,653,773
Texas,Uvalde County,15,997,468,529
Texas,Uvalde County,16,762,359,403
Texas,Uvalde County,17,552,242,310
Texas,Uvalde County,18,609,235,374
Texas,Val Verde County,0,48974,24879,24095
Texas,Val Verde County,1,4051,2008,2043
Texas,Val Verde County,2,3986,2049,1937
Texas,Val Verde County,3,3820,1950,1870
Texas,Val Verde County,4,3711,1921,1790
Texas,Val Verde County,5,4105,2395,1710
Texas,Val Verde County,6,3600,2036,1564
Texas,Val Verde County,7,3198,1660,1538
Texas,Val Verde County,8,2818,1465,1353
Texas,Val Verde County,9,2966,1479,1487
Texas,Val Verde County,10,2758,1395,1363
Texas,Val Verde County,11,2657,1302,1355
Texas,Val Verde County,12,2332,1112,1220
Texas,Val Verde County,13,2214,995,1219
Texas,Val Verde County,14,2176,1063,1113
Texas,Val Verde County,15,1618,759,859
Texas,Val Verde County,16,1242,576,666
Texas,Val Verde County,17,931,419,512
Texas,Val Verde County,18,791,295,496
Texas,Van Zandt County,0,52910,25961,26949
Texas,Van Zandt County,1,2939,1505,1434
Texas,Van Zandt County,2,3329,1684,1645
Texas,Van Zandt County,3,3739,1860,1879
Texas,Van Zandt County,4,3586,1842,1744
Texas,Van Zandt County,5,2811,1450,1361
Texas,Van Zandt County,6,2579,1284,1295
Texas,Van Zandt County,7,2746,1331,1415
Texas,Van Zandt County,8,2873,1494,1379
Texas,Van Zandt County,9,3137,1501,1636
Texas,Van Zandt County,10,3354,1580,1774
Texas,Van Zandt County,11,3864,1976,1888
Texas,Van Zandt County,12,3856,1861,1995
Texas,Van Zandt County,13,3607,1699,1908
Texas,Van Zandt County,14,3344,1606,1738
Texas,Van Zandt County,15,2734,1326,1408
Texas,Van Zandt County,16,2028,1017,1011
Texas,Van Zandt County,17,1295,565,730
Texas,Van Zandt County,18,1089,380,709
Texas,Victoria County,0,91081,44734,46347
Texas,Victoria County,1,6597,3324,3273
Texas,Victoria County,2,6650,3458,3192
Texas,Victoria County,3,6459,3237,3222
Texas,Victoria County,4,6130,3087,3043
Texas,Victoria County,5,6328,3200,3128
Texas,Victoria County,6,6491,3306,3185
Texas,Victoria County,7,6298,3140,3158
Texas,Victoria County,8,5297,2664,2633
Texas,Victoria County,9,5295,2610,2685
Texas,Victoria County,10,5070,2461,2609
Texas,Victoria County,11,5949,2898,3051
Texas,Victoria County,12,6116,3002,3114
Texas,Victoria County,13,5128,2466,2662
Texas,Victoria County,14,4401,2087,2314
Texas,Victoria County,15,3093,1375,1718
Texas,Victoria County,16,2348,1040,1308
Texas,Victoria County,17,1760,747,1013
Texas,Victoria County,18,1671,632,1039
Texas,Walker County,0,69789,41029,28760
Texas,Walker County,1,2956,1464,1492
Texas,Walker County,2,3057,1546,1511
Texas,Walker County,3,2855,1474,1381
Texas,Walker County,4,5204,2554,2650
Texas,Walker County,5,10546,5443,5103
Texas,Walker County,6,5391,3594,1797
Texas,Walker County,7,4859,3306,1553
Texas,Walker County,8,4444,3080,1364
Texas,Walker County,9,4856,3434,1422
Texas,Walker County,10,5017,3572,1445
Texas,Walker County,11,4893,3232,1661
Texas,Walker County,12,4161,2501,1660
Texas,Walker County,13,3593,1948,1645
Texas,Walker County,14,2744,1479,1265
Texas,Walker County,15,1995,1024,971
Texas,Walker County,16,1388,677,711
Texas,Walker County,17,899,366,533
Texas,Walker County,18,931,335,596
Texas,Waller County,0,46820,23306,23514
Texas,Waller County,1,2942,1526,1416
Texas,Waller County,2,3293,1641,1652
Texas,Waller County,3,3105,1568,1537
Texas,Waller County,4,5219,2473,2746
Texas,Waller County,5,6387,3157,3230
Texas,Waller County,6,2275,1248,1027
Texas,Waller County,7,2422,1223,1199
Texas,Waller County,8,2323,1212,1111
Texas,Waller County,9,2466,1168,1298
Texas,Waller County,10,2707,1339,1368
Texas,Waller County,11,2969,1489,1480
Texas,Waller County,12,2919,1516,1403
Texas,Waller County,13,2387,1195,1192
Texas,Waller County,14,2000,951,1049
Texas,Waller County,15,1423,722,701
Texas,Waller County,16,872,403,469
Texas,Waller County,17,584,263,321
Texas,Waller County,18,527,212,315
Texas,Ward County,0,11625,5778,5847
Texas,Ward County,1,926,475,451
Texas,Ward County,2,922,440,482
Texas,Ward County,3,909,461,448
Texas,Ward County,4,804,409,395
Texas,Ward County,5,793,406,387
Texas,Ward County,6,812,426,386
Texas,Ward County,7,839,440,399
Texas,Ward County,8,681,366,315
Texas,Ward County,9,635,314,321
Texas,Ward County,10,652,342,310
Texas,Ward County,11,721,342,379
Texas,Ward County,12,722,346,376
Texas,Ward County,13,569,277,292
Texas,Ward County,14,514,245,269
Texas,Ward County,15,379,185,194
Texas,Ward County,16,297,137,160
Texas,Ward County,17,243,108,135
Texas,Ward County,18,207,59,148
Texas,Washington County,0,34438,16963,17475
Texas,Washington County,1,2049,1072,977
Texas,Washington County,2,2053,1052,1001
Texas,Washington County,3,2092,1146,946
Texas,Washington County,4,2711,1316,1395
Texas,Washington County,5,2331,1214,1117
Texas,Washington County,6,1805,938,867
Texas,Washington County,7,1790,855,935
Texas,Washington County,8,1729,871,858
Texas,Washington County,9,1885,956,929
Texas,Washington County,10,1960,963,997
Texas,Washington County,11,2413,1208,1205
Texas,Washington County,12,2462,1209,1253
Texas,Washington County,13,2351,1119,1232
Texas,Washington County,14,1982,983,999
Texas,Washington County,15,1573,752,821
Texas,Washington County,16,1216,544,672
Texas,Washington County,17,939,399,540
Texas,Washington County,18,1097,366,731
Texas,Webb County,0,266673,130192,136481
Texas,Webb County,1,26585,13665,12920
Texas,Webb County,2,24768,12507,12261
Texas,Webb County,3,25048,12832,12216
Texas,Webb County,4,23480,11827,11653
Texas,Webb County,5,21691,10953,10738
Texas,Webb County,6,17809,8887,8922
Texas,Webb County,7,17889,8813,9076
Texas,Webb County,8,17561,8530,9031
Texas,Webb County,9,17704,8492,9212
Texas,Webb County,10,15682,7407,8275
Texas,Webb County,11,13836,6570,7266
Texas,Webb County,12,12048,5620,6428
Texas,Webb County,13,9496,4361,5135
Texas,Webb County,14,7943,3654,4289
Texas,Webb County,15,5523,2412,3111
Texas,Webb County,16,4017,1650,2367
Texas,Webb County,17,2743,1046,1697
Texas,Webb County,18,2850,966,1884
Texas,Wharton County,0,41168,20309,20859
Texas,Wharton County,1,2741,1396,1345
Texas,Wharton County,2,3052,1596,1456
Texas,Wharton County,3,3145,1588,1557
Texas,Wharton County,4,2746,1397,1349
Texas,Wharton County,5,2820,1500,1320
Texas,Wharton County,6,2442,1248,1194
Texas,Wharton County,7,2582,1262,1320
Texas,Wharton County,8,2277,1112,1165
Texas,Wharton County,9,2257,1128,1129
Texas,Wharton County,10,2468,1205,1263
Texas,Wharton County,11,2781,1370,1411
Texas,Wharton County,12,2842,1401,1441
Texas,Wharton County,13,2531,1275,1256
Texas,Wharton County,14,1955,923,1032
Texas,Wharton County,15,1505,700,805
Texas,Wharton County,16,1220,504,716
Texas,Wharton County,17,938,382,556
Texas,Wharton County,18,866,322,544
Texas,Wheeler County,0,5714,2917,2797
Texas,Wheeler County,1,396,241,155
Texas,Wheeler County,2,449,244,205
Texas,Wheeler County,3,409,227,182
Texas,Wheeler County,4,374,185,189
Texas,Wheeler County,5,339,177,162
Texas,Wheeler County,6,315,157,158
Texas,Wheeler County,7,374,180,194
Texas,Wheeler County,8,313,160,153
Texas,Wheeler County,9,330,155,175
Texas,Wheeler County,10,296,155,141
Texas,Wheeler County,11,377,187,190
Texas,Wheeler County,12,426,208,218
Texas,Wheeler County,13,333,178,155
Texas,Wheeler County,14,298,154,144
Texas,Wheeler County,15,253,119,134
Texas,Wheeler County,16,182,83,99
Texas,Wheeler County,17,153,74,79
Texas,Wheeler County,18,97,33,64
Texas,Wichita County,0,132355,68294,64061
Texas,Wichita County,1,8777,4547,4230
Texas,Wichita County,2,8600,4474,4126
Texas,Wichita County,3,8006,3975,4031
Texas,Wichita County,4,10169,5768,4401
Texas,Wichita County,5,12578,7407,5171
Texas,Wichita County,6,10635,5722,4913
Texas,Wichita County,7,9357,5057,4300
Texas,Wichita County,8,7559,4081,3478
Texas,Wichita County,9,7283,3765,3518
Texas,Wichita County,10,7229,3833,3396
Texas,Wichita County,11,8530,4332,4198
Texas,Wichita County,12,8475,4186,4289
Texas,Wichita County,13,6938,3398,3540
Texas,Wichita County,14,5462,2605,2857
Texas,Wichita County,15,4193,1826,2367
Texas,Wichita County,16,3418,1410,2008
Texas,Wichita County,17,2691,1106,1585
Texas,Wichita County,18,2455,802,1653
Texas,Wilbarger County,0,12973,6363,6610
Texas,Wilbarger County,1,868,409,459
Texas,Wilbarger County,2,833,386,447
Texas,Wilbarger County,3,836,431,405
Texas,Wilbarger County,4,885,495,390
Texas,Wilbarger County,5,906,465,441
Texas,Wilbarger County,6,866,426,440
Texas,Wilbarger County,7,794,395,399
Texas,Wilbarger County,8,721,359,362
Texas,Wilbarger County,9,706,354,352
Texas,Wilbarger County,10,700,361,339
Texas,Wilbarger County,11,923,444,479
Texas,Wilbarger County,12,930,486,444
Texas,Wilbarger County,13,818,401,417
Texas,Wilbarger County,14,700,333,367
Texas,Wilbarger County,15,520,232,288
Texas,Wilbarger County,16,380,191,189
Texas,Wilbarger County,17,295,105,190
Texas,Wilbarger County,18,292,90,202
Texas,Willacy County,0,21903,11962,9941
Texas,Willacy County,1,1432,741,691
Texas,Willacy County,2,1569,786,783
Texas,Willacy County,3,1585,821,764
Texas,Willacy County,4,1737,963,774
Texas,Willacy County,5,2127,1368,759
Texas,Willacy County,6,1806,1170,636
Texas,Willacy County,7,1567,993,574
Texas,Willacy County,8,1512,917,595
Texas,Willacy County,9,1311,738,573
Texas,Willacy County,10,1194,640,554
Texas,Willacy County,11,1185,600,585
Texas,Willacy County,12,1097,528,569
Texas,Willacy County,13,1025,467,558
Texas,Willacy County,14,860,421,439
Texas,Willacy County,15,704,317,387
Texas,Willacy County,16,456,219,237
Texas,Willacy County,17,381,143,238
Texas,Willacy County,18,355,130,225
Texas,Williamson County,0,489250,240418,248832
Texas,Williamson County,1,33376,16866,16510
Texas,Williamson County,2,38346,19556,18790
Texas,Williamson County,3,38976,19882,19094
Texas,Williamson County,4,33484,16989,16495
Texas,Williamson County,5,27277,13707,13570
Texas,Williamson County,6,30475,14997,15478
Texas,Williamson County,7,37951,18568,19383
Texas,Williamson County,8,40224,19802,20422
Texas,Williamson County,9,40019,20123,19896
Texas,Williamson County,10,34213,17147,17066
Texas,Williamson County,11,32109,15855,16254
Texas,Williamson County,12,26811,12831,13980
Texas,Williamson County,13,22675,10461,12214
Texas,Williamson County,14,19517,8895,10622
Texas,Williamson County,15,13751,6398,7353
Texas,Williamson County,16,8841,4052,4789
Texas,Williamson County,17,5685,2445,3240
Texas,Williamson County,18,5520,1844,3676
Texas,Wilson County,0,46402,23267,23135
Texas,Wilson County,1,2633,1301,1332
Texas,Wilson County,2,3082,1577,1505
Texas,Wilson County,3,3601,1861,1740
Texas,Wilson County,4,3353,1751,1602
Texas,Wilson County,5,2616,1388,1228
Texas,Wilson County,6,2411,1236,1175
Texas,Wilson County,7,2735,1343,1392
Texas,Wilson County,8,2584,1282,1302
Texas,Wilson County,9,3153,1557,1596
Texas,Wilson County,10,3312,1648,1664
Texas,Wilson County,11,3681,1820,1861
Texas,Wilson County,12,3416,1707,1709
Texas,Wilson County,13,2928,1416,1512
Texas,Wilson County,14,2542,1306,1236
Texas,Wilson County,15,1646,849,797
Texas,Wilson County,16,1108,532,576
Texas,Wilson County,17,787,391,396
Texas,Wilson County,18,814,302,512
Texas,Winkler County,0,7821,4016,3805
Texas,Winkler County,1,634,311,323
Texas,Winkler County,2,721,381,340
Texas,Winkler County,3,639,338,301
Texas,Winkler County,4,608,317,291
Texas,Winkler County,5,548,302,246
Texas,Winkler County,6,519,280,239
Texas,Winkler County,7,538,282,256
Texas,Winkler County,8,475,241,234
Texas,Winkler County,9,465,232,233
Texas,Winkler County,10,446,221,225
Texas,Winkler County,11,548,298,250
Texas,Winkler County,12,446,230,216
Texas,Winkler County,13,383,188,195
Texas,Winkler County,14,303,142,161
Texas,Winkler County,15,195,96,99
Texas,Winkler County,16,156,79,77
Texas,Winkler County,17,114,44,70
Texas,Winkler County,18,83,34,49
Texas,Wise County,0,61638,31046,30592
Texas,Wise County,1,4027,2096,1931
Texas,Wise County,2,4266,2197,2069
Texas,Wise County,3,4429,2262,2167
Texas,Wise County,4,4173,2210,1963
Texas,Wise County,5,3754,1971,1783
Texas,Wise County,6,3634,1809,1825
Texas,Wise County,7,3759,1928,1831
Texas,Wise County,8,3498,1769,1729
Texas,Wise County,9,3985,1994,1991
Texas,Wise County,10,4242,2094,2148
Texas,Wise County,11,4914,2411,2503
Texas,Wise County,12,4550,2371,2179
Texas,Wise County,13,3561,1765,1796
Texas,Wise County,14,3109,1519,1590
Texas,Wise County,15,2426,1165,1261
Texas,Wise County,16,1541,743,798
Texas,Wise County,17,979,475,504
Texas,Wise County,18,791,267,524
Texas,Wood County,0,42852,21173,21679
Texas,Wood County,1,2097,1078,1019
Texas,Wood County,2,2329,1189,1140
Texas,Wood County,3,2472,1263,1209
Texas,Wood County,4,2533,1300,1233
Texas,Wood County,5,2357,1265,1092
Texas,Wood County,6,1899,981,918
Texas,Wood County,7,2059,1079,980
Texas,Wood County,8,1912,968,944
Texas,Wood County,9,2144,1075,1069
Texas,Wood County,10,2325,1185,1140
Texas,Wood County,11,2958,1410,1548
Texas,Wood County,12,3136,1521,1615
Texas,Wood County,13,3258,1523,1735
Texas,Wood County,14,3576,1712,1864
Texas,Wood County,15,3144,1520,1624
Texas,Wood County,16,2195,1116,1079
Texas,Wood County,17,1328,595,733
Texas,Wood County,18,1130,393,737
Texas,Yoakum County,0,8286,4093,4193
Texas,Yoakum County,1,785,398,387
Texas,Yoakum County,2,756,355,401
Texas,Yoakum County,3,717,340,377
Texas,Yoakum County,4,630,329,301
Texas,Yoakum County,5,543,269,274
Texas,Yoakum County,6,541,273,268
Texas,Yoakum County,7,537,267,270
Texas,Yoakum County,8,469,256,213
Texas,Yoakum County,9,418,196,222
Texas,Yoakum County,10,479,238,241
Texas,Yoakum County,11,526,275,251
Texas,Yoakum County,12,510,260,250
Texas,Yoakum County,13,389,190,199
Texas,Yoakum County,14,310,154,156
Texas,Yoakum County,15,253,128,125
Texas,Yoakum County,16,171,72,99
Texas,Yoakum County,17,158,64,94
Texas,Yoakum County,18,94,29,65
Texas,Young County,0,18350,9069,9281
Texas,Young County,1,1229,652,577
Texas,Young County,2,1176,604,572
Texas,Young County,3,1261,623,638
Texas,Young County,4,1134,611,523
Texas,Young County,5,1017,530,487
Texas,Young County,6,1028,503,525
Texas,Young County,7,1017,515,502
Texas,Young County,8,973,476,497
Texas,Young County,9,1038,494,544
Texas,Young County,10,1064,543,521
Texas,Young County,11,1274,652,622
Texas,Young County,12,1325,655,670
Texas,Young County,13,1248,636,612
Texas,Young County,14,1021,487,534
Texas,Young County,15,850,400,450
Texas,Young County,16,660,306,354
Texas,Young County,17,504,208,296
Texas,Young County,18,531,174,357
Texas,Zapata County,0,14319,7213,7106
Texas,Zapata County,1,1448,786,662
Texas,Zapata County,2,1419,784,635
Texas,Zapata County,3,1185,621,564
Texas,Zapata County,4,1181,591,590
Texas,Zapata County,5,1100,556,544
Texas,Zapata County,6,1000,495,505
Texas,Zapata County,7,899,460,439
Texas,Zapata County,8,905,440,465
Texas,Zapata County,9,797,380,417
Texas,Zapata County,10,753,356,397
Texas,Zapata County,11,733,355,378
Texas,Zapata County,12,649,339,310
Texas,Zapata County,13,589,283,306
Texas,Zapata County,14,579,264,315
Texas,Zapata County,15,429,205,224
Texas,Zapata County,16,300,152,148
Texas,Zapata County,17,170,69,101
Texas,Zapata County,18,183,77,106
Texas,Zavala County,0,12267,6150,6117
Texas,Zavala County,1,1088,572,516
Texas,Zavala County,2,1061,538,523
Texas,Zavala County,3,1007,486,521
Texas,Zavala County,4,1006,500,506
Texas,Zavala County,5,1135,669,466
Texas,Zavala County,6,806,437,369
Texas,Zavala County,7,721,366,355
Texas,Zavala County,8,644,322,322
Texas,Zavala County,9,709,343,366
Texas,Zavala County,10,658,313,345
Texas,Zavala County,11,656,338,318
Texas,Zavala County,12,635,302,333
Texas,Zavala County,13,610,301,309
Texas,Zavala County,14,503,224,279
Texas,Zavala County,15,353,157,196
Texas,Zavala County,16,264,111,153
Texas,Zavala County,17,205,81,124
Texas,Zavala County,18,206,90,116
Utah,Beaver County,0,6461,3313,3148
Utah,Beaver County,1,527,263,264
Utah,Beaver County,2,565,289,276
Utah,Beaver County,3,620,328,292
Utah,Beaver County,4,549,299,250
Utah,Beaver County,5,388,211,177
Utah,Beaver County,6,300,148,152
Utah,Beaver County,7,410,209,201
Utah,Beaver County,8,418,211,207
Utah,Beaver County,9,363,186,177
Utah,Beaver County,10,307,169,138
Utah,Beaver County,11,365,189,176
Utah,Beaver County,12,407,194,213
Utah,Beaver County,13,360,189,171
Utah,Beaver County,14,279,136,143
Utah,Beaver County,15,240,114,126
Utah,Beaver County,16,143,75,68
Utah,Beaver County,17,130,58,72
Utah,Beaver County,18,90,45,45
Utah,Box Elder County,0,51518,26046,25472
Utah,Box Elder County,1,4425,2328,2097
Utah,Box Elder County,2,4961,2558,2403
Utah,Box Elder County,3,4716,2388,2328
Utah,Box Elder County,4,4083,2221,1862
Utah,Box Elder County,5,3153,1672,1481
Utah,Box Elder County,6,2886,1355,1531
Utah,Box Elder County,7,3610,1831,1779
Utah,Box Elder County,8,3553,1748,1805
Utah,Box Elder County,9,2821,1453,1368
Utah,Box Elder County,10,2502,1235,1267
Utah,Box Elder County,11,3058,1541,1517
Utah,Box Elder County,12,2970,1492,1478
Utah,Box Elder County,13,2486,1243,1243
Utah,Box Elder County,14,1827,926,901
Utah,Box Elder County,15,1538,700,838
Utah,Box Elder County,16,1319,638,681
Utah,Box Elder County,17,922,420,502
Utah,Box Elder County,18,688,297,391
Utah,Cache County,0,118343,59032,59311
Utah,Cache County,1,10966,5561,5405
Utah,Cache County,2,10466,5286,5180
Utah,Cache County,3,9911,5082,4829
Utah,Cache County,4,10562,4914,5648
Utah,Cache County,5,17232,8421,8811
Utah,Cache County,6,8777,4833,3944
Utah,Cache County,7,8120,4173,3947
Utah,Cache County,8,7319,3721,3598
Utah,Cache County,9,5804,2872,2932
Utah,Cache County,10,4885,2535,2350
Utah,Cache County,11,5039,2449,2590
Utah,Cache County,12,4825,2362,2463
Utah,Cache County,13,4241,2090,2151
Utah,Cache County,14,3214,1567,1647
Utah,Cache County,15,2488,1181,1307
Utah,Cache County,16,1868,897,971
Utah,Cache County,17,1333,613,720
Utah,Cache County,18,1293,475,818
Utah,Carbon County,0,20660,10266,10394
Utah,Carbon County,1,1590,811,779
Utah,Carbon County,2,1636,834,802
Utah,Carbon County,3,1458,717,741
Utah,Carbon County,4,1422,707,715
Utah,Carbon County,5,1396,721,675
Utah,Carbon County,6,1261,618,643
Utah,Carbon County,7,1394,705,689
Utah,Carbon County,8,1283,645,638
Utah,Carbon County,9,1094,566,528
Utah,Carbon County,10,970,470,500
Utah,Carbon County,11,1228,589,639
Utah,Carbon County,12,1470,746,724
Utah,Carbon County,13,1297,650,647
Utah,Carbon County,14,1079,557,522
Utah,Carbon County,15,723,349,374
Utah,Carbon County,16,557,248,309
Utah,Carbon County,17,390,177,213
Utah,Carbon County,18,412,156,256
Utah,Daggett County,0,1117,624,493
Utah,Daggett County,1,58,32,26
Utah,Daggett County,2,79,45,34
Utah,Daggett County,3,83,45,38
Utah,Daggett County,4,59,31,28
Utah,Daggett County,5,44,28,16
Utah,Daggett County,6,61,38,23
Utah,Daggett County,7,80,47,33
Utah,Daggett County,8,65,35,30
Utah,Daggett County,9,60,34,26
Utah,Daggett County,10,47,27,20
Utah,Daggett County,11,83,37,46
Utah,Daggett County,12,71,42,29
Utah,Daggett County,13,90,50,40
Utah,Daggett County,14,90,41,49
Utah,Daggett County,15,59,39,20
Utah,Daggett County,16,38,20,18
Utah,Daggett County,17,29,20,9
Utah,Daggett County,18,21,13,8
Utah,Davis County,0,329692,166063,163629
Utah,Davis County,1,29473,15191,14282
Utah,Davis County,2,32588,16889,15699
Utah,Davis County,3,30618,15879,14739
Utah,Davis County,4,25918,13573,12345
Utah,Davis County,5,22397,11781,10616
Utah,Davis County,6,21963,10733,11230
Utah,Davis County,7,26010,12983,13027
Utah,Davis County,8,25113,12636,12477
Utah,Davis County,9,20308,10233,10075
Utah,Davis County,10,17190,8542,8648
Utah,Davis County,11,17928,8931,8997
Utah,Davis County,12,16657,8256,8401
Utah,Davis County,13,13375,6551,6824
Utah,Davis County,14,10223,4911,5312
Utah,Davis County,15,7289,3423,3866
Utah,Davis County,16,5222,2369,2853
Utah,Davis County,17,3843,1788,2055
Utah,Davis County,18,3577,1394,2183
Utah,Duchesne County,0,20380,10405,9975
Utah,Duchesne County,1,2128,1076,1052
Utah,Duchesne County,2,2008,1000,1008
Utah,Duchesne County,3,1822,960,862
Utah,Duchesne County,4,1490,762,728
Utah,Duchesne County,5,1281,652,629
Utah,Duchesne County,6,1408,714,694
Utah,Duchesne County,7,1589,825,764
Utah,Duchesne County,8,1383,743,640
Utah,Duchesne County,9,1060,551,509
Utah,Duchesne County,10,935,471,464
Utah,Duchesne County,11,1066,533,533
Utah,Duchesne County,12,1103,581,522
Utah,Duchesne County,13,879,455,424
Utah,Duchesne County,14,699,353,346
Utah,Duchesne County,15,597,299,298
Utah,Duchesne County,16,397,197,200
Utah,Duchesne County,17,294,143,151
Utah,Duchesne County,18,241,90,151
Utah,Emery County,0,10631,5401,5230
Utah,Emery County,1,803,433,370
Utah,Emery County,2,976,531,445
Utah,Emery County,3,967,493,474
Utah,Emery County,4,814,430,384
Utah,Emery County,5,533,282,251
Utah,Emery County,6,500,220,280
Utah,Emery County,7,714,343,371
Utah,Emery County,8,687,357,330
Utah,Emery County,9,561,277,284
Utah,Emery County,10,491,258,233
Utah,Emery County,11,657,314,343
Utah,Emery County,12,717,366,351
Utah,Emery County,13,659,330,329
Utah,Emery County,14,535,278,257
Utah,Emery County,15,408,211,197
Utah,Emery County,16,270,129,141
Utah,Emery County,17,186,87,99
Utah,Emery County,18,153,62,91
Utah,Garfield County,0,5024,2622,2402
Utah,Garfield County,1,308,150,158
Utah,Garfield County,2,353,202,151
Utah,Garfield County,3,339,172,167
Utah,Garfield County,4,381,214,167
Utah,Garfield County,5,246,140,106
Utah,Garfield County,6,235,138,97
Utah,Garfield County,7,323,175,148
Utah,Garfield County,8,262,152,110
Utah,Garfield County,9,266,125,141
Utah,Garfield County,10,241,126,115
Utah,Garfield County,11,346,171,175
Utah,Garfield County,12,338,174,164
Utah,Garfield County,13,429,214,215
Utah,Garfield County,14,338,183,155
Utah,Garfield County,15,217,112,105
Utah,Garfield County,16,175,88,87
Utah,Garfield County,17,123,52,71
Utah,Garfield County,18,104,34,70
Utah,Grand County,0,9429,4704,4725
Utah,Grand County,1,650,340,310
Utah,Grand County,2,562,270,292
Utah,Grand County,3,588,286,302
Utah,Grand County,4,529,286,243
Utah,Grand County,5,457,243,214
Utah,Grand County,6,563,253,310
Utah,Grand County,7,670,338,332
Utah,Grand County,8,606,288,318
Utah,Grand County,9,622,301,321
Utah,Grand County,10,532,273,259
Utah,Grand County,11,688,357,331
Utah,Grand County,12,737,373,364
Utah,Grand County,13,727,372,355
Utah,Grand County,14,547,285,262
Utah,Grand County,15,344,165,179
Utah,Grand County,16,246,120,126
Utah,Grand County,17,199,94,105
Utah,Grand County,18,162,60,102
Utah,Iron County,0,47269,23627,23642
Utah,Iron County,1,3970,2109,1861
Utah,Iron County,2,3840,1958,1882
Utah,Iron County,3,3742,1884,1858
Utah,Iron County,4,4203,1948,2255
Utah,Iron County,5,5633,2788,2845
Utah,Iron County,6,3117,1657,1460
Utah,Iron County,7,3098,1581,1517
Utah,Iron County,8,2850,1442,1408
Utah,Iron County,9,2397,1203,1194
Utah,Iron County,10,2129,1018,1111
Utah,Iron County,11,2235,1135,1100
Utah,Iron County,12,2410,1167,1243
Utah,Iron County,13,2238,1090,1148
Utah,Iron County,14,1846,925,921
Utah,Iron County,15,1464,700,764
Utah,Iron County,16,984,517,467
Utah,Iron County,17,643,320,323
Utah,Iron County,18,470,185,285
Utah,Juab County,0,10486,5357,5129
Utah,Juab County,1,933,494,439
Utah,Juab County,2,1046,581,465
Utah,Juab County,3,1059,562,497
Utah,Juab County,4,949,507,442
Utah,Juab County,5,638,330,308
Utah,Juab County,6,541,250,291
Utah,Juab County,7,689,349,340
Utah,Juab County,8,725,356,369
Utah,Juab County,9,621,292,329
Utah,Juab County,10,521,287,234
Utah,Juab County,11,549,273,276
Utah,Juab County,12,515,273,242
Utah,Juab County,13,474,229,245
Utah,Juab County,14,416,197,219
Utah,Juab County,15,302,137,165
Utah,Juab County,16,229,120,109
Utah,Juab County,17,147,69,78
Utah,Juab County,18,132,51,81
Utah,Kane County,0,7254,3624,3630
Utah,Kane County,1,419,208,211
Utah,Kane County,2,506,257,249
Utah,Kane County,3,457,234,223
Utah,Kane County,4,458,227,231
Utah,Kane County,5,358,212,146
Utah,Kane County,6,387,198,189
Utah,Kane County,7,421,200,221
Utah,Kane County,8,400,220,180
Utah,Kane County,9,330,159,171
Utah,Kane County,10,349,165,184
Utah,Kane County,11,462,222,240
Utah,Kane County,12,535,236,299
Utah,Kane County,13,609,302,307
Utah,Kane County,14,549,273,276
Utah,Kane County,15,447,232,215
Utah,Kane County,16,276,153,123
Utah,Kane County,17,143,75,68
Utah,Kane County,18,148,51,97
Utah,Millard County,0,12606,6425,6181
Utah,Millard County,1,1034,544,490
Utah,Millard County,2,1136,569,567
Utah,Millard County,3,1089,550,539
Utah,Millard County,4,1058,565,493
Utah,Millard County,5,684,362,322
Utah,Millard County,6,600,297,303
Utah,Millard County,7,754,412,342
Utah,Millard County,8,723,372,351
Utah,Millard County,9,630,329,301
Utah,Millard County,10,594,294,300
Utah,Millard County,11,735,347,388
Utah,Millard County,12,818,416,402
Utah,Millard County,13,723,365,358
Utah,Millard County,14,621,327,294
Utah,Millard County,15,530,269,261
Utah,Millard County,16,335,168,167
Utah,Millard County,17,260,108,152
Utah,Millard County,18,282,131,151
Utah,Morgan County,0,10608,5397,5211
Utah,Morgan County,1,895,465,430
Utah,Morgan County,2,1121,583,538
Utah,Morgan County,3,1068,573,495
Utah,Morgan County,4,959,501,458
Utah,Morgan County,5,595,322,273
Utah,Morgan County,6,438,219,219
Utah,Morgan County,7,580,270,310
Utah,Morgan County,8,725,363,362
Utah,Morgan County,9,664,324,340
Utah,Morgan County,10,599,293,306
Utah,Morgan County,11,628,327,301
Utah,Morgan County,12,629,340,289
Utah,Morgan County,13,507,242,265
Utah,Morgan County,14,374,175,199
Utah,Morgan County,15,364,176,188
Utah,Morgan County,16,229,115,114
Utah,Morgan County,17,132,65,67
Utah,Morgan County,18,101,44,57
Utah,Piute County,0,1484,765,719
Utah,Piute County,1,54,22,32
Utah,Piute County,2,106,51,55
Utah,Piute County,3,148,84,64
Utah,Piute County,4,112,67,45
Utah,Piute County,5,63,35,28
Utah,Piute County,6,44,25,19
Utah,Piute County,7,59,31,28
Utah,Piute County,8,76,42,34
Utah,Piute County,9,69,35,34
Utah,Piute County,10,66,33,33
Utah,Piute County,11,87,49,38
Utah,Piute County,12,113,60,53
Utah,Piute County,13,120,49,71
Utah,Piute County,14,117,57,60
Utah,Piute County,15,87,46,41
Utah,Piute County,16,73,38,35
Utah,Piute County,17,46,23,23
Utah,Piute County,18,44,18,26
Utah,Rich County,0,2293,1176,1117
Utah,Rich County,1,161,83,78
Utah,Rich County,2,200,106,94
Utah,Rich County,3,192,89,103
Utah,Rich County,4,179,97,82
Utah,Rich County,5,105,56,49
Utah,Rich County,6,108,50,58
Utah,Rich County,7,141,72,69
Utah,Rich County,8,133,64,69
Utah,Rich County,9,126,66,60
Utah,Rich County,10,108,53,55
Utah,Rich County,11,132,63,69
Utah,Rich County,12,154,80,74
Utah,Rich County,13,147,82,65
Utah,Rich County,14,127,60,67
Utah,Rich County,15,123,64,59
Utah,Rich County,16,67,41,26
Utah,Rich County,17,42,27,15
Utah,Rich County,18,48,23,25
Utah,Salt Lake County,0,1091742,547969,543773
Utah,Salt Lake County,1,88259,45000,43259
Utah,Salt Lake County,2,88945,45710,43235
Utah,Salt Lake County,3,84613,43152,41461
Utah,Salt Lake County,4,74458,38117,36341
Utah,Salt Lake County,5,79376,39983,39393
Utah,Salt Lake County,6,90091,45451,44640
Utah,Salt Lake County,7,92164,47252,44912
Utah,Salt Lake County,8,83116,42571,40545
Utah,Salt Lake County,9,71444,36808,34636
Utah,Salt Lake County,10,61609,31515,30094
Utah,Salt Lake County,11,62579,31012,31567
Utah,Salt Lake County,12,59556,29517,30039
Utah,Salt Lake County,13,50622,24752,25870
Utah,Salt Lake County,14,36849,17749,19100
Utah,Salt Lake County,15,25402,11666,13736
Utah,Salt Lake County,16,17268,7616,9652
Utah,Salt Lake County,17,12465,5273,7192
Utah,Salt Lake County,18,12926,4825,8101
Utah,San Juan County,0,15251,7592,7659
Utah,San Juan County,1,1231,580,651
Utah,San Juan County,2,1389,739,650
Utah,San Juan County,3,1426,747,679
Utah,San Juan County,4,1444,757,687
Utah,San Juan County,5,1062,564,498
Utah,San Juan County,6,876,431,445
Utah,San Juan County,7,841,416,425
Utah,San Juan County,8,839,408,431
Utah,San Juan County,9,871,439,432
Utah,San Juan County,10,821,427,394
Utah,San Juan County,11,950,471,479
Utah,San Juan County,12,904,414,490
Utah,San Juan County,13,777,369,408
Utah,San Juan County,14,620,307,313
Utah,San Juan County,15,462,221,241
Utah,San Juan County,16,333,143,190
Utah,San Juan County,17,202,78,124
Utah,San Juan County,18,203,81,122
Utah,Sanpete County,0,28477,14898,13579
Utah,Sanpete County,1,1839,891,948
Utah,Sanpete County,2,2243,1112,1131
Utah,Sanpete County,3,2222,1161,1061
Utah,Sanpete County,4,3019,1482,1537
Utah,Sanpete County,5,3056,1652,1404
Utah,Sanpete County,6,1628,906,722
Utah,Sanpete County,7,1778,1011,767
Utah,Sanpete County,8,1782,983,799
Utah,Sanpete County,9,1585,925,660
Utah,Sanpete County,10,1378,786,592
Utah,Sanpete County,11,1495,785,710
Utah,Sanpete County,12,1365,698,667
Utah,Sanpete County,13,1442,722,720
Utah,Sanpete County,14,1190,594,596
Utah,Sanpete County,15,984,486,498
Utah,Sanpete County,16,692,338,354
Utah,Sanpete County,17,413,207,206
Utah,Sanpete County,18,366,159,207
Utah,Sevier County,0,20773,10573,10200
Utah,Sevier County,1,1452,744,708
Utah,Sevier County,2,1805,936,869
Utah,Sevier County,3,1880,979,901
Utah,Sevier County,4,1662,907,755
Utah,Sevier County,5,1167,627,540
Utah,Sevier County,6,1055,502,553
Utah,Sevier County,7,1384,691,693
Utah,Sevier County,8,1452,765,687
Utah,Sevier County,9,1132,597,535
Utah,Sevier County,10,958,493,465
Utah,Sevier County,11,1245,594,651
Utah,Sevier County,12,1209,605,604
Utah,Sevier County,13,1108,545,563
Utah,Sevier County,14,963,444,519
Utah,Sevier County,15,839,430,409
Utah,Sevier County,16,642,323,319
Utah,Sevier County,17,451,221,230
Utah,Sevier County,18,369,170,199
Utah,Summit County,0,39105,19998,19107
Utah,Summit County,1,2363,1165,1198
Utah,Summit County,2,2825,1406,1419
Utah,Summit County,3,3253,1702,1551
Utah,Summit County,4,2752,1488,1264
Utah,Summit County,5,2149,1171,978
Utah,Summit County,6,2296,1196,1100
Utah,Summit County,7,2367,1169,1198
Utah,Summit County,8,2538,1334,1204
Utah,Summit County,9,2908,1455,1453
Utah,Summit County,10,3019,1463,1556
Utah,Summit County,11,3197,1588,1609
Utah,Summit County,12,3179,1612,1567
Utah,Summit County,13,2410,1245,1165
Utah,Summit County,14,1637,843,794
Utah,Summit County,15,1109,616,493
Utah,Summit County,16,542,281,261
Utah,Summit County,17,291,142,149
Utah,Summit County,18,270,122,148
Utah,Tooele County,0,61598,31094,30504
Utah,Tooele County,1,5258,2704,2554
Utah,Tooele County,2,6204,3145,3059
Utah,Tooele County,3,6310,3279,3031
Utah,Tooele County,4,5137,2609,2528
Utah,Tooele County,5,3543,1816,1727
Utah,Tooele County,6,3541,1706,1835
Utah,Tooele County,7,4679,2281,2398
Utah,Tooele County,8,4877,2448,2429
Utah,Tooele County,9,4343,2194,2149
Utah,Tooele County,10,3489,1821,1668
Utah,Tooele County,11,3409,1784,1625
Utah,Tooele County,12,3039,1565,1474
Utah,Tooele County,13,2484,1250,1234
Utah,Tooele County,14,1935,1001,934
Utah,Tooele County,15,1326,657,669
Utah,Tooele County,16,866,384,482
Utah,Tooele County,17,628,259,369
Utah,Tooele County,18,530,191,339
Utah,Uintah County,0,36867,18760,18107
Utah,Uintah County,1,3601,1856,1745
Utah,Uintah County,2,3857,1962,1895
Utah,Uintah County,3,3307,1704,1603
Utah,Uintah County,4,2572,1366,1206
Utah,Uintah County,5,2509,1286,1223
Utah,Uintah County,6,2872,1460,1412
Utah,Uintah County,7,3121,1606,1515
Utah,Uintah County,8,2639,1364,1275
Utah,Uintah County,9,2006,1054,952
Utah,Uintah County,10,1688,853,835
Utah,Uintah County,11,1917,938,979
Utah,Uintah County,12,1938,967,971
Utah,Uintah County,13,1494,767,727
Utah,Uintah County,14,1132,573,559
Utah,Uintah County,15,759,369,390
Utah,Uintah County,16,638,279,359
Utah,Uintah County,17,409,172,237
Utah,Uintah County,18,408,184,224
Utah,Utah County,0,560974,282528,278446
Utah,Utah County,1,56990,29544,27446
Utah,Utah County,2,56915,29283,27632
Utah,Utah County,3,52782,27041,25741
Utah,Utah County,4,51136,25228,25908
Utah,Utah County,5,70926,36072,34854
Utah,Utah County,6,39392,20247,19145
Utah,Utah County,7,41230,20917,20313
Utah,Utah County,8,38584,19588,18996
Utah,Utah County,9,29849,15090,14759
Utah,Utah County,10,24004,12198,11806
Utah,Utah County,11,22139,11112,11027
Utah,Utah County,12,20194,9888,10306
Utah,Utah County,13,16582,7984,8598
Utah,Utah County,14,13453,6355,7098
Utah,Utah County,15,10032,4660,5372
Utah,Utah County,16,7055,3262,3793
Utah,Utah County,17,5109,2247,2862
Utah,Utah County,18,4602,1812,2790
Utah,Wasatch County,0,27714,14243,13471
Utah,Wasatch County,1,2201,1147,1054
Utah,Wasatch County,2,2820,1479,1341
Utah,Wasatch County,3,2644,1386,1258
Utah,Wasatch County,4,2175,1153,1022
Utah,Wasatch County,5,1586,860,726
Utah,Wasatch County,6,1507,772,735
Utah,Wasatch County,7,1958,936,1022
Utah,Wasatch County,8,2161,1053,1108
Utah,Wasatch County,9,1908,1025,883
Utah,Wasatch County,10,1611,802,809
Utah,Wasatch County,11,1630,866,764
Utah,Wasatch County,12,1549,775,774
Utah,Wasatch County,13,1355,659,696
Utah,Wasatch County,14,1021,508,513
Utah,Wasatch County,15,697,364,333
Utah,Wasatch County,16,426,222,204
Utah,Wasatch County,17,277,146,131
Utah,Wasatch County,18,188,90,98
Utah,Washington County,0,151948,75169,76779
Utah,Washington County,1,11025,5817,5208
Utah,Washington County,2,12633,6539,6094
Utah,Washington County,3,12136,6176,5960
Utah,Washington County,4,11071,5813,5258
Utah,Washington County,5,9571,4678,4893
Utah,Washington County,6,9037,4412,4625
Utah,Washington County,7,9780,4906,4874
Utah,Washington County,8,8840,4503,4337
Utah,Washington County,9,7678,3843,3835
Utah,Washington County,10,6874,3381,3493
Utah,Washington County,11,7362,3478,3884
Utah,Washington County,12,7864,3603,4261
Utah,Washington County,13,8367,3825,4542
Utah,Washington County,14,8884,4238,4646
Utah,Washington County,15,7469,3580,3889
Utah,Washington County,16,5800,2844,2956
Utah,Washington County,17,4073,2014,2059
Utah,Washington County,18,3484,1519,1965
Utah,Wayne County,0,2723,1384,1339
Utah,Wayne County,1,167,83,84
Utah,Wayne County,2,199,101,98
Utah,Wayne County,3,237,117,120
Utah,Wayne County,4,207,106,101
Utah,Wayne County,5,130,75,55
Utah,Wayne County,6,103,49,54
Utah,Wayne County,7,161,84,77
Utah,Wayne County,8,146,81,65
Utah,Wayne County,9,151,69,82
Utah,Wayne County,10,125,70,55
Utah,Wayne County,11,188,93,95
Utah,Wayne County,12,185,85,100
Utah,Wayne County,13,212,119,93
Utah,Wayne County,14,184,98,86
Utah,Wayne County,15,140,72,68
Utah,Wayne County,16,77,37,40
Utah,Wayne County,17,52,20,32
Utah,Wayne County,18,59,25,34
Utah,Weber County,0,240475,120695,119780
Utah,Weber County,1,19351,9837,9514
Utah,Weber County,2,20212,10315,9897
Utah,Weber County,3,19472,9884,9588
Utah,Weber County,4,17062,8812,8250
Utah,Weber County,5,17319,8766,8553
Utah,Weber County,6,18165,9105,9060
Utah,Weber County,7,18745,9712,9033
Utah,Weber County,8,17025,8837,8188
Utah,Weber County,9,14359,7265,7094
Utah,Weber County,10,12844,6451,6393
Utah,Weber County,11,14315,7196,7119
Utah,Weber County,12,13721,6812,6909
Utah,Weber County,13,11183,5534,5649
Utah,Weber County,14,8916,4304,4612
Utah,Weber County,15,6296,2924,3372
Utah,Weber County,16,4649,2098,2551
Utah,Weber County,17,3454,1526,1928
Utah,Weber County,18,3387,1317,2070
Vermont,Addison County,0,37009,18537,18472
Vermont,Addison County,1,1580,826,754
Vermont,Addison County,2,1808,979,829
Vermont,Addison County,3,2002,1034,968
Vermont,Addison County,4,3190,1591,1599
Vermont,Addison County,5,3351,1773,1578
Vermont,Addison County,6,1688,885,803
Vermont,Addison County,7,1822,904,918
Vermont,Addison County,8,1882,935,947
Vermont,Addison County,9,2151,1045,1106
Vermont,Addison County,10,2556,1253,1303
Vermont,Addison County,11,2901,1485,1416
Vermont,Addison County,12,3035,1470,1565
Vermont,Addison County,13,2800,1387,1413
Vermont,Addison County,14,2280,1149,1131
Vermont,Addison County,15,1470,731,739
Vermont,Addison County,16,1007,492,515
Vermont,Addison County,17,684,301,383
Vermont,Addison County,18,802,297,505
Vermont,Bennington County,0,36445,17692,18753
Vermont,Bennington County,1,1718,883,835
Vermont,Bennington County,2,1934,1034,900
Vermont,Bennington County,3,2039,1096,943
Vermont,Bennington County,4,2452,1213,1239
Vermont,Bennington County,5,2352,1119,1233
Vermont,Bennington County,6,1625,811,814
Vermont,Bennington County,7,1752,855,897
Vermont,Bennington County,8,1685,811,874
Vermont,Bennington County,9,1970,955,1015
Vermont,Bennington County,10,2436,1180,1256
Vermont,Bennington County,11,2975,1426,1549
Vermont,Bennington County,12,2988,1468,1520
Vermont,Bennington County,13,2783,1351,1432
Vermont,Bennington County,14,2397,1170,1227
Vermont,Bennington County,15,1828,818,1010
Vermont,Bennington County,16,1293,609,684
Vermont,Bennington County,17,1045,457,588
Vermont,Bennington County,18,1173,436,737
Vermont,Caledonia County,0,30981,15405,15576
Vermont,Caledonia County,1,1472,713,759
Vermont,Caledonia County,2,1739,920,819
Vermont,Caledonia County,3,1866,954,912
Vermont,Caledonia County,4,2225,1202,1023
Vermont,Caledonia County,5,2004,1069,935
Vermont,Caledonia County,6,1630,849,781
Vermont,Caledonia County,7,1666,849,817
Vermont,Caledonia County,8,1654,808,846
Vermont,Caledonia County,9,1900,945,955
Vermont,Caledonia County,10,1961,993,968
Vermont,Caledonia County,11,2342,1112,1230
Vermont,Caledonia County,12,2533,1220,1313
Vermont,Caledonia County,13,2464,1199,1265
Vermont,Caledonia County,14,1938,961,977
Vermont,Caledonia County,15,1369,713,656
Vermont,Caledonia County,16,844,388,456
Vermont,Caledonia County,17,665,281,384
Vermont,Caledonia County,18,709,229,480
Vermont,Chittenden County,0,160531,78514,82017
Vermont,Chittenden County,1,7832,4172,3660
Vermont,Chittenden County,2,8157,4179,3978
Vermont,Chittenden County,3,8600,4487,4113
Vermont,Chittenden County,4,13537,6629,6908
Vermont,Chittenden County,5,17667,8835,8832
Vermont,Chittenden County,6,11338,5829,5509
Vermont,Chittenden County,7,10603,5249,5354
Vermont,Chittenden County,8,9166,4526,4640
Vermont,Chittenden County,9,9482,4664,4818
Vermont,Chittenden County,10,10343,5046,5297
Vermont,Chittenden County,11,11752,5636,6116
Vermont,Chittenden County,12,11559,5791,5768
Vermont,Chittenden County,13,9319,4434,4885
Vermont,Chittenden County,14,7178,3404,3774
Vermont,Chittenden County,15,4875,2208,2667
Vermont,Chittenden County,16,3341,1437,1904
Vermont,Chittenden County,17,2658,1005,1653
Vermont,Chittenden County,18,3124,983,2141
Vermont,Essex County,0,6125,3088,3037
Vermont,Essex County,1,264,136,128
Vermont,Essex County,2,264,136,128
Vermont,Essex County,3,324,170,154
Vermont,Essex County,4,334,182,152
Vermont,Essex County,5,278,123,155
Vermont,Essex County,6,251,120,131
Vermont,Essex County,7,257,125,132
Vermont,Essex County,8,273,146,127
Vermont,Essex County,9,379,186,193
Vermont,Essex County,10,428,220,208
Vermont,Essex County,11,523,265,258
Vermont,Essex County,12,600,293,307
Vermont,Essex County,13,523,282,241
Vermont,Essex County,14,501,252,249
Vermont,Essex County,15,370,191,179
Vermont,Essex County,16,218,115,103
Vermont,Essex County,17,195,84,111
Vermont,Essex County,18,143,62,81
Vermont,Franklin County,0,48642,24174,24468
Vermont,Franklin County,1,2941,1528,1413
Vermont,Franklin County,2,3019,1575,1444
Vermont,Franklin County,3,3209,1627,1582
Vermont,Franklin County,4,3143,1617,1526
Vermont,Franklin County,5,2724,1447,1277
Vermont,Franklin County,6,2804,1376,1428
Vermont,Franklin County,7,3061,1482,1579
Vermont,Franklin County,8,3031,1509,1522
Vermont,Franklin County,9,3345,1667,1678
Vermont,Franklin County,10,3591,1726,1865
Vermont,Franklin County,11,4028,2028,2000
Vermont,Franklin County,12,3826,1900,1926
Vermont,Franklin County,13,3171,1546,1625
Vermont,Franklin County,14,2418,1200,1218
Vermont,Franklin County,15,1647,821,826
Vermont,Franklin County,16,1039,488,551
Vermont,Franklin County,17,857,364,493
Vermont,Franklin County,18,788,273,515
Vermont,Grand Isle County,0,6994,3485,3509
Vermont,Grand Isle County,1,325,145,180
Vermont,Grand Isle County,2,346,162,184
Vermont,Grand Isle County,3,387,202,185
Vermont,Grand Isle County,4,399,209,190
Vermont,Grand Isle County,5,349,179,170
Vermont,Grand Isle County,6,344,186,158
Vermont,Grand Isle County,7,341,167,174
Vermont,Grand Isle County,8,378,182,196
Vermont,Grand Isle County,9,405,195,210
Vermont,Grand Isle County,10,508,244,264
Vermont,Grand Isle County,11,621,293,328
Vermont,Grand Isle County,12,677,355,322
Vermont,Grand Isle County,13,660,341,319
Vermont,Grand Isle County,14,538,283,255
Vermont,Grand Isle County,15,324,173,151
Vermont,Grand Isle County,16,192,91,101
Vermont,Grand Isle County,17,120,55,65
Vermont,Grand Isle County,18,80,23,57
Vermont,Lamoille County,0,25082,12507,12575
Vermont,Lamoille County,1,1311,623,688
Vermont,Lamoille County,2,1581,749,832
Vermont,Lamoille County,3,1484,777,707
Vermont,Lamoille County,4,1711,887,824
Vermont,Lamoille County,5,1635,850,785
Vermont,Lamoille County,6,1538,776,762
Vermont,Lamoille County,7,1531,759,772
Vermont,Lamoille County,8,1603,796,807
Vermont,Lamoille County,9,1656,885,771
Vermont,Lamoille County,10,1733,885,848
Vermont,Lamoille County,11,1924,928,996
Vermont,Lamoille County,12,1884,917,967
Vermont,Lamoille County,13,1680,834,846
Vermont,Lamoille County,14,1305,683,622
Vermont,Lamoille County,15,967,484,483
Vermont,Lamoille County,16,645,328,317
Vermont,Lamoille County,17,423,189,234
Vermont,Lamoille County,18,471,157,314
Vermont,Orange County,0,28859,14331,14528
Vermont,Orange County,1,1376,699,677
Vermont,Orange County,2,1516,753,763
Vermont,Orange County,3,1684,884,800
Vermont,Orange County,4,1849,979,870
Vermont,Orange County,5,1642,918,724
Vermont,Orange County,6,1383,688,695
Vermont,Orange County,7,1647,819,828
Vermont,Orange County,8,1517,739,778
Vermont,Orange County,9,1721,815,906
Vermont,Orange County,10,1982,992,990
Vermont,Orange County,11,2481,1194,1287
Vermont,Orange County,12,2601,1300,1301
Vermont,Orange County,13,2381,1173,1208
Vermont,Orange County,14,1898,948,950
Vermont,Orange County,15,1242,612,630
Vermont,Orange County,16,834,377,457
Vermont,Orange County,17,555,255,300
Vermont,Orange County,18,550,186,364
Vermont,Orleans County,0,27082,13601,13481
Vermont,Orleans County,1,1324,666,658
Vermont,Orleans County,2,1464,738,726
Vermont,Orleans County,3,1594,815,779
Vermont,Orleans County,4,1632,818,814
Vermont,Orleans County,5,1458,795,663
Vermont,Orleans County,6,1452,794,658
Vermont,Orleans County,7,1509,784,725
Vermont,Orleans County,8,1478,724,754
Vermont,Orleans County,9,1646,865,781
Vermont,Orleans County,10,1745,906,839
Vermont,Orleans County,11,2001,1015,986
Vermont,Orleans County,12,2154,1065,1089
Vermont,Orleans County,13,2116,1022,1094
Vermont,Orleans County,14,1868,951,917
Vermont,Orleans County,15,1398,702,696
Vermont,Orleans County,16,870,419,451
Vermont,Orleans County,17,605,249,356
Vermont,Orleans County,18,768,273,495
Vermont,Rutland County,0,60086,29532,30554
Vermont,Rutland County,1,2769,1367,1402
Vermont,Rutland County,2,2909,1502,1407
Vermont,Rutland County,3,3238,1680,1558
Vermont,Rutland County,4,3986,2002,1984
Vermont,Rutland County,5,3816,2001,1815
Vermont,Rutland County,6,3287,1677,1610
Vermont,Rutland County,7,3063,1549,1514
Vermont,Rutland County,8,2899,1473,1426
Vermont,Rutland County,9,3430,1682,1748
Vermont,Rutland County,10,4038,2016,2022
Vermont,Rutland County,11,5065,2466,2599
Vermont,Rutland County,12,5169,2507,2662
Vermont,Rutland County,13,4755,2342,2413
Vermont,Rutland County,14,4014,1990,2024
Vermont,Rutland County,15,2799,1331,1468
Vermont,Rutland County,16,1915,872,1043
Vermont,Rutland County,17,1381,582,799
Vermont,Rutland County,18,1553,493,1060
Vermont,Washington County,0,58998,29165,29833
Vermont,Washington County,1,2917,1600,1317
Vermont,Washington County,2,3132,1589,1543
Vermont,Washington County,3,3399,1693,1706
Vermont,Washington County,4,3877,2168,1709
Vermont,Washington County,5,3744,2132,1612
Vermont,Washington County,6,3130,1554,1576
Vermont,Washington County,7,3293,1597,1696
Vermont,Washington County,8,3487,1670,1817
Vermont,Washington County,9,3777,1852,1925
Vermont,Washington County,10,4151,2011,2140
Vermont,Washington County,11,4713,2301,2412
Vermont,Washington County,12,4863,2345,2518
Vermont,Washington County,13,4488,2176,2312
Vermont,Washington County,14,3521,1741,1780
Vermont,Washington County,15,2300,1076,1224
Vermont,Washington County,16,1627,736,891
Vermont,Washington County,17,1198,491,707
Vermont,Washington County,18,1381,433,948
Vermont,Windham County,0,43714,21424,22290
Vermont,Windham County,1,2017,1056,961
Vermont,Windham County,2,2198,1155,1043
Vermont,Windham County,3,2473,1251,1222
Vermont,Windham County,4,2618,1398,1220
Vermont,Windham County,5,2635,1386,1249
Vermont,Windham County,6,2201,1082,1119
Vermont,Windham County,7,2425,1184,1241
Vermont,Windham County,8,2251,1061,1190
Vermont,Windham County,9,2368,1148,1220
Vermont,Windham County,10,2853,1327,1526
Vermont,Windham County,11,3666,1756,1910
Vermont,Windham County,12,3846,1899,1947
Vermont,Windham County,13,3737,1847,1890
Vermont,Windham County,14,3021,1456,1565
Vermont,Windham County,15,2056,991,1065
Vermont,Windham County,16,1288,603,685
Vermont,Windham County,17,1010,454,556
Vermont,Windham County,18,1051,370,681
Vermont,Windsor County,0,56014,27394,28620
Vermont,Windsor County,1,2571,1335,1236
Vermont,Windsor County,2,2815,1408,1407
Vermont,Windsor County,3,3082,1560,1522
Vermont,Windsor County,4,3127,1633,1494
Vermont,Windsor County,5,2716,1356,1360
Vermont,Windsor County,6,2974,1485,1489
Vermont,Windsor County,7,3171,1578,1593
Vermont,Windsor County,8,2892,1452,1440
Vermont,Windsor County,9,3158,1580,1578
Vermont,Windsor County,10,3678,1807,1871
Vermont,Windsor County,11,4643,2181,2462
Vermont,Windsor County,12,5017,2429,2588
Vermont,Windsor County,13,4595,2229,2366
Vermont,Windsor County,14,3951,1903,2048
Vermont,Windsor County,15,2844,1426,1418
Vermont,Windsor County,16,1935,886,1049
Vermont,Windsor County,17,1331,608,723
Vermont,Windsor County,18,1514,538,976
Virginia,Accomack County,0,33021,16068,16953
Virginia,Accomack County,1,1996,1001,995
Virginia,Accomack County,2,1917,966,951
Virginia,Accomack County,3,1904,1000,904
Virginia,Accomack County,4,1671,889,782
Virginia,Accomack County,5,1828,891,937
Virginia,Accomack County,6,1757,915,842
Virginia,Accomack County,7,1774,926,848
Virginia,Accomack County,8,1622,788,834
Virginia,Accomack County,9,1770,858,912
Virginia,Accomack County,10,2028,974,1054
Virginia,Accomack County,11,2424,1154,1270
Virginia,Accomack County,12,2742,1310,1432
Virginia,Accomack County,13,2570,1221,1349
Virginia,Accomack County,14,2303,1081,1222
Virginia,Accomack County,15,1770,844,926
Virginia,Accomack County,16,1271,580,691
Virginia,Accomack County,17,866,378,488
Virginia,Accomack County,18,808,292,516
Virginia,Albemarle County,0,104489,49921,54568
Virginia,Albemarle County,1,5701,2925,2776
Virginia,Albemarle County,2,6112,3139,2973
Virginia,Albemarle County,3,6198,3088,3110
Virginia,Albemarle County,4,9105,4349,4756
Virginia,Albemarle County,5,7104,3495,3609
Virginia,Albemarle County,6,7106,3577,3529
Virginia,Albemarle County,7,6525,3225,3300
Virginia,Albemarle County,8,5891,2892,2999
Virginia,Albemarle County,9,5992,2957,3035
Virginia,Albemarle County,10,6423,3024,3399
Virginia,Albemarle County,11,7227,3338,3889
Virginia,Albemarle County,12,7305,3410,3895
Virginia,Albemarle County,13,6546,3027,3519
Virginia,Albemarle County,14,5466,2535,2931
Virginia,Albemarle County,15,3919,1792,2127
Virginia,Albemarle County,16,2873,1238,1635
Virginia,Albemarle County,17,2228,886,1342
Virginia,Albemarle County,18,2768,1024,1744
Virginia,Alleghany County,0,15820,7784,8036
Virginia,Alleghany County,1,684,373,311
Virginia,Alleghany County,2,774,423,351
Virginia,Alleghany County,3,916,462,454
Virginia,Alleghany County,4,981,524,457
Virginia,Alleghany County,5,858,435,423
Virginia,Alleghany County,6,688,344,344
Virginia,Alleghany County,7,721,345,376
Virginia,Alleghany County,8,735,381,354
Virginia,Alleghany County,9,981,466,515
Virginia,Alleghany County,10,1071,543,528
Virginia,Alleghany County,11,1188,571,617
Virginia,Alleghany County,12,1250,599,651
Virginia,Alleghany County,13,1125,575,550
Virginia,Alleghany County,14,1209,590,619
Virginia,Alleghany County,15,1044,503,541
Virginia,Alleghany County,16,702,338,364
Virginia,Alleghany County,17,451,182,269
Virginia,Alleghany County,18,442,130,312
Virginia,Amelia County,0,12855,6254,6601
Virginia,Amelia County,1,675,345,330
Virginia,Amelia County,2,762,364,398
Virginia,Amelia County,3,796,402,394
Virginia,Amelia County,4,735,379,356
Virginia,Amelia County,5,721,348,373
Virginia,Amelia County,6,734,352,382
Virginia,Amelia County,7,699,351,348
Virginia,Amelia County,8,635,312,323
Virginia,Amelia County,9,753,359,394
Virginia,Amelia County,10,929,470,459
Virginia,Amelia County,11,1094,542,552
Virginia,Amelia County,12,1117,545,572
Virginia,Amelia County,13,867,407,460
Virginia,Amelia County,14,807,406,401
Virginia,Amelia County,15,641,306,335
Virginia,Amelia County,16,392,181,211
Virginia,Amelia County,17,259,103,156
Virginia,Amelia County,18,239,82,157
Virginia,Amherst County,0,32041,15327,16714
Virginia,Amherst County,1,1602,833,769
Virginia,Amherst County,2,1743,883,860
Virginia,Amherst County,3,1835,954,881
Virginia,Amherst County,4,2094,1002,1092
Virginia,Amherst County,5,2242,993,1249
Virginia,Amherst County,6,1803,906,897
Virginia,Amherst County,7,1608,806,802
Virginia,Amherst County,8,1593,762,831
Virginia,Amherst County,9,1973,959,1014
Virginia,Amherst County,10,2214,1076,1138
Virginia,Amherst County,11,2577,1211,1366
Virginia,Amherst County,12,2458,1206,1252
Virginia,Amherst County,13,2244,1061,1183
Virginia,Amherst County,14,1980,956,1024
Virginia,Amherst County,15,1543,710,833
Virginia,Amherst County,16,1089,495,594
Virginia,Amherst County,17,717,298,419
Virginia,Amherst County,18,726,216,510
Virginia,Appomattox County,0,15279,7411,7868
Virginia,Appomattox County,1,939,491,448
Virginia,Appomattox County,2,841,429,412
Virginia,Appomattox County,3,961,487,474
Virginia,Appomattox County,4,911,471,440
Virginia,Appomattox County,5,838,413,425
Virginia,Appomattox County,6,894,446,448
Virginia,Appomattox County,7,928,471,457
Virginia,Appomattox County,8,769,365,404
Virginia,Appomattox County,9,997,495,502
Virginia,Appomattox County,10,959,443,516
Virginia,Appomattox County,11,1145,541,604
Virginia,Appomattox County,12,1170,553,617
Virginia,Appomattox County,13,1011,468,543
Virginia,Appomattox County,14,951,473,478
Virginia,Appomattox County,15,783,377,406
Virginia,Appomattox County,16,512,227,285
Virginia,Appomattox County,17,365,159,206
Virginia,Appomattox County,18,305,102,203
Virginia,Arlington County,0,226908,113714,113194
Virginia,Arlington County,1,14079,7367,6712
Virginia,Arlington County,2,10876,5546,5330
Virginia,Arlington County,3,9078,4608,4470
Virginia,Arlington County,4,8005,4038,3967
Virginia,Arlington County,5,14599,7323,7276
Virginia,Arlington County,6,32794,16103,16691
Virginia,Arlington County,7,28665,14693,13972
Virginia,Arlington County,8,20598,10499,10099
Virginia,Arlington County,9,16924,8656,8268
Virginia,Arlington County,10,14550,7625,6925
Virginia,Arlington County,11,13374,6888,6486
Virginia,Arlington County,12,11949,5933,6016
Virginia,Arlington County,13,10374,5026,5348
Virginia,Arlington County,14,7851,3809,4042
Virginia,Arlington County,15,4968,2288,2680
Virginia,Arlington County,16,3160,1453,1707
Virginia,Arlington County,17,2241,977,1264
Virginia,Arlington County,18,2823,882,1941
Virginia,Augusta County,0,73862,37340,36522
Virginia,Augusta County,1,3197,1669,1528
Virginia,Augusta County,2,4061,2078,1983
Virginia,Augusta County,3,4475,2324,2151
Virginia,Augusta County,4,4399,2251,2148
Virginia,Augusta County,5,4258,2235,2023
Virginia,Augusta County,6,4029,2221,1808
Virginia,Augusta County,7,4101,2166,1935
Virginia,Augusta County,8,4044,2107,1937
Virginia,Augusta County,9,4757,2453,2304
Virginia,Augusta County,10,5264,2645,2619
Virginia,Augusta County,11,6031,3035,2996
Virginia,Augusta County,12,5749,2870,2879
Virginia,Augusta County,13,5199,2573,2626
Virginia,Augusta County,14,4782,2337,2445
Virginia,Augusta County,15,3712,1840,1872
Virginia,Augusta County,16,2526,1155,1371
Virginia,Augusta County,17,1684,797,887
Virginia,Augusta County,18,1594,584,1010
Virginia,Bath County,0,4563,2312,2251
Virginia,Bath County,1,174,80,94
Virginia,Bath County,2,176,82,94
Virginia,Bath County,3,216,127,89
Virginia,Bath County,4,252,128,124
Virginia,Bath County,5,258,128,130
Virginia,Bath County,6,227,122,105
Virginia,Bath County,7,200,104,96
Virginia,Bath County,8,207,95,112
Virginia,Bath County,9,274,141,133
Virginia,Bath County,10,356,186,170
Virginia,Bath County,11,398,209,189
Virginia,Bath County,12,354,176,178
Virginia,Bath County,13,329,162,167
Virginia,Bath County,14,366,182,184
Virginia,Bath County,15,292,151,141
Virginia,Bath County,16,213,113,100
Virginia,Bath County,17,148,69,79
Virginia,Bath County,18,123,57,66
Virginia,Bedford County,0,76583,37785,38798
Virginia,Bedford County,1,3348,1713,1635
Virginia,Bedford County,2,4240,2130,2110
Virginia,Bedford County,3,4876,2453,2423
Virginia,Bedford County,4,4817,2524,2293
Virginia,Bedford County,5,4227,2165,2062
Virginia,Bedford County,6,3690,1888,1802
Virginia,Bedford County,7,3482,1714,1768
Virginia,Bedford County,8,3852,1910,1942
Virginia,Bedford County,9,5011,2396,2615
Virginia,Bedford County,10,5485,2668,2817
Virginia,Bedford County,11,6460,3158,3302
Virginia,Bedford County,12,6530,3245,3285
Virginia,Bedford County,13,5701,2797,2904
Virginia,Bedford County,14,5226,2602,2624
Virginia,Bedford County,15,3905,1884,2021
Virginia,Bedford County,16,2550,1218,1332
Virginia,Bedford County,17,1745,786,959
Virginia,Bedford County,18,1438,534,904
Virginia,Bland County,0,6625,3664,2961
Virginia,Bland County,1,262,145,117
Virginia,Bland County,2,302,153,149
Virginia,Bland County,3,340,182,158
Virginia,Bland County,4,329,193,136
Virginia,Bland County,5,338,174,164
Virginia,Bland County,6,363,234,129
Virginia,Bland County,7,411,272,139
Virginia,Bland County,8,411,260,151
Virginia,Bland County,9,538,324,214
Virginia,Bland County,10,515,310,205
Virginia,Bland County,11,492,263,229
Virginia,Bland County,12,487,241,246
Virginia,Bland County,13,493,249,244
Virginia,Bland County,14,480,255,225
Virginia,Bland County,15,351,179,172
Virginia,Bland County,16,243,117,126
Virginia,Bland County,17,148,70,78
Virginia,Bland County,18,122,43,79
Virginia,Botetourt County,0,33100,16359,16741
Virginia,Botetourt County,1,1267,609,658
Virginia,Botetourt County,2,1745,874,871
Virginia,Botetourt County,3,2172,1120,1052
Virginia,Botetourt County,4,2167,1129,1038
Virginia,Botetourt County,5,1648,855,793
Virginia,Botetourt County,6,1383,715,668
Virginia,Botetourt County,7,1493,771,722
Virginia,Botetourt County,8,1594,774,820
Virginia,Botetourt County,9,2185,1076,1109
Virginia,Botetourt County,10,2454,1209,1245
Virginia,Botetourt County,11,2927,1423,1504
Virginia,Botetourt County,12,2781,1398,1383
Virginia,Botetourt County,13,2687,1332,1355
Virginia,Botetourt County,14,2350,1175,1175
Virginia,Botetourt County,15,1661,798,863
Virginia,Botetourt County,16,1159,533,626
Virginia,Botetourt County,17,755,329,426
Virginia,Botetourt County,18,672,239,433
Virginia,Brunswick County,0,16498,8642,7856
Virginia,Brunswick County,1,691,334,357
Virginia,Brunswick County,2,818,444,374
Virginia,Brunswick County,3,864,446,418
Virginia,Brunswick County,4,901,460,441
Virginia,Brunswick County,5,1133,683,450
Virginia,Brunswick County,6,1143,726,417
Virginia,Brunswick County,7,1077,676,401
Virginia,Brunswick County,8,954,545,409
Virginia,Brunswick County,9,1015,566,449
Virginia,Brunswick County,10,1070,557,513
Virginia,Brunswick County,11,1220,624,596
Virginia,Brunswick County,12,1237,599,638
Virginia,Brunswick County,13,1214,574,640
Virginia,Brunswick County,14,1024,496,528
Virginia,Brunswick County,15,763,359,404
Virginia,Brunswick County,16,585,265,320
Virginia,Brunswick County,17,417,178,239
Virginia,Brunswick County,18,372,110,262
Virginia,Buchanan County,0,23106,11770,11336
Virginia,Buchanan County,1,1020,520,500
Virginia,Buchanan County,2,1108,583,525
Virginia,Buchanan County,3,1190,612,578
Virginia,Buchanan County,4,1186,611,575
Virginia,Buchanan County,5,1282,714,568
Virginia,Buchanan County,6,1424,801,623
Virginia,Buchanan County,7,1346,740,606
Virginia,Buchanan County,8,1351,756,595
Virginia,Buchanan County,9,1541,806,735
Virginia,Buchanan County,10,1692,876,816
Virginia,Buchanan County,11,1854,917,937
Virginia,Buchanan County,12,1950,1010,940
Virginia,Buchanan County,13,1675,813,862
Virginia,Buchanan County,14,1548,714,834
Virginia,Buchanan County,15,1200,582,618
Virginia,Buchanan County,16,886,370,516
Virginia,Buchanan County,17,485,212,273
Virginia,Buchanan County,18,368,133,235
Virginia,Buckingham County,0,16913,9199,7714
Virginia,Buckingham County,1,911,449,462
Virginia,Buckingham County,2,891,441,450
Virginia,Buckingham County,3,827,442,385
Virginia,Buckingham County,4,845,454,391
Virginia,Buckingham County,5,1064,630,434
Virginia,Buckingham County,6,1163,703,460
Virginia,Buckingham County,7,1091,687,404
Virginia,Buckingham County,8,1015,622,393
Virginia,Buckingham County,9,1186,724,462
Virginia,Buckingham County,10,1270,731,539
Virginia,Buckingham County,11,1356,768,588
Virginia,Buckingham County,12,1266,669,597
Virginia,Buckingham County,13,1168,567,601
Virginia,Buckingham County,14,1035,491,544
Virginia,Buckingham County,15,706,349,357
Virginia,Buckingham County,16,536,246,290
Virginia,Buckingham County,17,309,132,177
Virginia,Buckingham County,18,274,94,180
Virginia,Campbell County,0,54885,26703,28182
Virginia,Campbell County,1,2572,1286,1286
Virginia,Campbell County,2,3071,1541,1530
Virginia,Campbell County,3,3251,1671,1580
Virginia,Campbell County,4,3389,1721,1668
Virginia,Campbell County,5,3650,1856,1794
Virginia,Campbell County,6,3682,1880,1802
Virginia,Campbell County,7,3098,1560,1538
Virginia,Campbell County,8,3059,1533,1526
Virginia,Campbell County,9,3587,1743,1844
Virginia,Campbell County,10,3701,1821,1880
Virginia,Campbell County,11,4219,2053,2166
Virginia,Campbell County,12,4131,1995,2136
Virginia,Campbell County,13,3526,1652,1874
Virginia,Campbell County,14,3300,1544,1756
Virginia,Campbell County,15,2446,1118,1328
Virginia,Campbell County,16,1834,811,1023
Virginia,Campbell County,17,1278,558,720
Virginia,Campbell County,18,1091,360,731
Virginia,Caroline County,0,29778,14622,15156
Virginia,Caroline County,1,2008,974,1034
Virginia,Caroline County,2,1996,1029,967
Virginia,Caroline County,3,1916,955,961
Virginia,Caroline County,4,1626,854,772
Virginia,Caroline County,5,1660,802,858
Virginia,Caroline County,6,2022,988,1034
Virginia,Caroline County,7,2052,1083,969
Virginia,Caroline County,8,1916,941,975
Virginia,Caroline County,9,1937,993,944
Virginia,Caroline County,10,2020,1033,987
Virginia,Caroline County,11,2242,1111,1131
Virginia,Caroline County,12,2111,965,1146
Virginia,Caroline County,13,1775,877,898
Virginia,Caroline County,14,1592,778,814
Virginia,Caroline County,15,1210,561,649
Virginia,Caroline County,16,752,308,444
Virginia,Caroline County,17,478,216,262
Virginia,Caroline County,18,465,154,311
Virginia,Carroll County,0,29621,14689,14932
Virginia,Carroll County,1,1312,675,637
Virginia,Carroll County,2,1577,834,743
Virginia,Carroll County,3,1722,852,870
Virginia,Carroll County,4,1687,917,770
Virginia,Carroll County,5,1529,764,765
Virginia,Carroll County,6,1366,720,646
Virginia,Carroll County,7,1438,723,715
Virginia,Carroll County,8,1619,833,786
Virginia,Carroll County,9,2003,986,1017
Virginia,Carroll County,10,2071,1058,1013
Virginia,Carroll County,11,2265,1132,1133
Virginia,Carroll County,12,2258,1112,1146
Virginia,Carroll County,13,2335,1145,1190
Virginia,Carroll County,14,2122,1012,1110
Virginia,Carroll County,15,1707,839,868
Virginia,Carroll County,16,1154,514,640
Virginia,Carroll County,17,796,342,454
Virginia,Carroll County,18,660,231,429
Virginia,Charles City County,0,7023,3448,3575
Virginia,Charles City County,1,228,112,116
Virginia,Charles City County,2,305,146,159
Virginia,Charles City County,3,339,193,146
Virginia,Charles City County,4,352,191,161
Virginia,Charles City County,5,387,200,187
Virginia,Charles City County,6,358,184,174
Virginia,Charles City County,7,354,169,185
Virginia,Charles City County,8,319,166,153
Virginia,Charles City County,9,382,185,197
Virginia,Charles City County,10,542,271,271
Virginia,Charles City County,11,693,342,351
Virginia,Charles City County,12,653,313,340
Virginia,Charles City County,13,613,296,317
Virginia,Charles City County,14,553,275,278
Virginia,Charles City County,15,380,188,192
Virginia,Charles City County,16,261,105,156
Virginia,Charles City County,17,168,57,111
Virginia,Charles City County,18,136,55,81
Virginia,Charlotte County,0,12225,6086,6139
Virginia,Charlotte County,1,678,359,319
Virginia,Charlotte County,2,658,354,304
Virginia,Charlotte County,3,751,378,373
Virginia,Charlotte County,4,830,444,386
Virginia,Charlotte County,5,712,383,329
Virginia,Charlotte County,6,695,402,293
Virginia,Charlotte County,7,566,282,284
Virginia,Charlotte County,8,608,299,309
Virginia,Charlotte County,9,693,333,360
Virginia,Charlotte County,10,783,354,429
Virginia,Charlotte County,11,976,502,474
Virginia,Charlotte County,12,974,475,499
Virginia,Charlotte County,13,837,404,433
Virginia,Charlotte County,14,772,367,405
Virginia,Charlotte County,15,639,318,321
Virginia,Charlotte County,16,445,211,234
Virginia,Charlotte County,17,325,124,201
Virginia,Charlotte County,18,283,97,186
Virginia,Chesterfield County,0,332499,160100,172399
Virginia,Chesterfield County,1,19385,9761,9624
Virginia,Chesterfield County,2,22133,11162,10971
Virginia,Chesterfield County,3,24445,12712,11733
Virginia,Chesterfield County,4,24998,12657,12341
Virginia,Chesterfield County,5,21253,10560,10693
Virginia,Chesterfield County,6,18669,9224,9445
Virginia,Chesterfield County,7,20569,9841,10728
Virginia,Chesterfield County,8,21738,10222,11516
Virginia,Chesterfield County,9,23803,11308,12495
Virginia,Chesterfield County,10,24016,11442,12574
Virginia,Chesterfield County,11,25042,11862,13180
Virginia,Chesterfield County,12,23694,11018,12676
Virginia,Chesterfield County,13,20181,9486,10695
Virginia,Chesterfield County,14,16439,7749,8690
Virginia,Chesterfield County,15,10696,4955,5741
Virginia,Chesterfield County,16,6527,2855,3672
Virginia,Chesterfield County,17,4433,1807,2626
Virginia,Chesterfield County,18,4478,1479,2999
Virginia,Clarke County,0,14423,7211,7212
Virginia,Clarke County,1,768,410,358
Virginia,Clarke County,2,802,411,391
Virginia,Clarke County,3,892,451,441
Virginia,Clarke County,4,949,478,471
Virginia,Clarke County,5,819,447,372
Virginia,Clarke County,6,634,340,294
Virginia,Clarke County,7,673,350,323
Virginia,Clarke County,8,687,346,341
Virginia,Clarke County,9,802,383,419
Virginia,Clarke County,10,1162,573,589
Virginia,Clarke County,11,1326,656,670
Virginia,Clarke County,12,1248,623,625
Virginia,Clarke County,13,1052,530,522
Virginia,Clarke County,14,902,449,453
Virginia,Clarke County,15,605,288,317
Virginia,Clarke County,16,456,223,233
Virginia,Clarke County,17,328,140,188
Virginia,Clarke County,18,318,113,205
Virginia,Craig County,0,5234,2622,2612
Virginia,Craig County,1,233,136,97
Virginia,Craig County,2,278,150,128
Virginia,Craig County,3,316,160,156
Virginia,Craig County,4,303,150,153
Virginia,Craig County,5,277,146,131
Virginia,Craig County,6,240,127,113
Virginia,Craig County,7,233,115,118
Virginia,Craig County,8,269,130,139
Virginia,Craig County,9,342,175,167
Virginia,Craig County,10,370,198,172
Virginia,Craig County,11,443,215,228
Virginia,Craig County,12,423,208,215
Virginia,Craig County,13,405,198,207
Virginia,Craig County,14,375,190,185
Virginia,Craig County,15,294,148,146
Virginia,Craig County,16,192,87,105
Virginia,Craig County,17,135,57,78
Virginia,Craig County,18,106,32,74
Virginia,Culpeper County,0,49166,24719,24447
Virginia,Culpeper County,1,3205,1626,1579
Virginia,Culpeper County,2,3640,1803,1837
Virginia,Culpeper County,3,3647,1910,1737
Virginia,Culpeper County,4,3152,1671,1481
Virginia,Culpeper County,5,2760,1423,1337
Virginia,Culpeper County,6,2842,1408,1434
Virginia,Culpeper County,7,3162,1624,1538
Virginia,Culpeper County,8,3071,1544,1527
Virginia,Culpeper County,9,3361,1737,1624
Virginia,Culpeper County,10,3559,1882,1677
Virginia,Culpeper County,11,3766,1886,1880
Virginia,Culpeper County,12,3364,1644,1720
Virginia,Culpeper County,13,2792,1386,1406
Virginia,Culpeper County,14,2450,1153,1297
Virginia,Culpeper County,15,1771,853,918
Virginia,Culpeper County,16,1117,559,558
Virginia,Culpeper County,17,775,340,435
Virginia,Culpeper County,18,732,270,462
Virginia,Cumberland County,0,9827,4697,5130
Virginia,Cumberland County,1,529,253,276
Virginia,Cumberland County,2,559,278,281
Virginia,Cumberland County,3,591,292,299
Virginia,Cumberland County,4,589,276,313
Virginia,Cumberland County,5,615,304,311
Virginia,Cumberland County,6,598,298,300
Virginia,Cumberland County,7,503,233,270
Virginia,Cumberland County,8,505,243,262
Virginia,Cumberland County,9,579,270,309
Virginia,Cumberland County,10,694,344,350
Virginia,Cumberland County,11,771,375,396
Virginia,Cumberland County,12,693,336,357
Virginia,Cumberland County,13,703,331,372
Virginia,Cumberland County,14,691,335,356
Virginia,Cumberland County,15,482,240,242
Virginia,Cumberland County,16,324,140,184
Virginia,Cumberland County,17,216,89,127
Virginia,Cumberland County,18,185,60,125
Virginia,Dickenson County,0,15308,7771,7537
Virginia,Dickenson County,1,794,411,383
Virginia,Dickenson County,2,879,456,423
Virginia,Dickenson County,3,901,463,438
Virginia,Dickenson County,4,852,424,428
Virginia,Dickenson County,5,866,452,414
Virginia,Dickenson County,6,822,452,370
Virginia,Dickenson County,7,940,501,439
Virginia,Dickenson County,8,936,492,444
Virginia,Dickenson County,9,1006,520,486
Virginia,Dickenson County,10,971,517,454
Virginia,Dickenson County,11,1146,573,573
Virginia,Dickenson County,12,1210,626,584
Virginia,Dickenson County,13,1097,540,557
Virginia,Dickenson County,14,1030,502,528
Virginia,Dickenson County,15,760,394,366
Virginia,Dickenson County,16,516,228,288
Virginia,Dickenson County,17,311,126,185
Virginia,Dickenson County,18,271,94,177
Virginia,Dinwiddie County,0,27859,13625,14234
Virginia,Dinwiddie County,1,1223,663,560
Virginia,Dinwiddie County,2,1590,775,815
Virginia,Dinwiddie County,3,1740,923,817
Virginia,Dinwiddie County,4,1842,906,936
Virginia,Dinwiddie County,5,1754,902,852
Virginia,Dinwiddie County,6,1644,844,800
Virginia,Dinwiddie County,7,1577,773,804
Virginia,Dinwiddie County,8,1574,747,827
Virginia,Dinwiddie County,9,1816,880,936
Virginia,Dinwiddie County,10,2078,1022,1056
Virginia,Dinwiddie County,11,2416,1170,1246
Virginia,Dinwiddie County,12,2266,1104,1162
Virginia,Dinwiddie County,13,1803,844,959
Virginia,Dinwiddie County,14,1527,767,760
Virginia,Dinwiddie County,15,1246,572,674
Virginia,Dinwiddie County,16,856,389,467
Virginia,Dinwiddie County,17,501,211,290
Virginia,Dinwiddie County,18,406,133,273
Virginia,Essex County,0,11103,5225,5878
Virginia,Essex County,1,595,304,291
Virginia,Essex County,2,632,306,326
Virginia,Essex County,3,585,286,299
Virginia,Essex County,4,655,273,382
Virginia,Essex County,5,673,337,336
Virginia,Essex County,6,651,304,347
Virginia,Essex County,7,540,259,281
Virginia,Essex County,8,566,263,303
Virginia,Essex County,9,606,277,329
Virginia,Essex County,10,794,378,416
Virginia,Essex County,11,865,378,487
Virginia,Essex County,12,842,422,420
Virginia,Essex County,13,833,388,445
Virginia,Essex County,14,779,359,420
Virginia,Essex County,15,557,278,279
Virginia,Essex County,16,382,182,200
Virginia,Essex County,17,262,113,149
Virginia,Essex County,18,286,118,168
Virginia,Fairfax County,0,1137538,563225,574313
Virginia,Fairfax County,1,76337,38988,37349
Virginia,Fairfax County,2,75190,38484,36706
Virginia,Fairfax County,3,74742,38137,36605
Virginia,Fairfax County,4,72222,37277,34945
Virginia,Fairfax County,5,67291,34323,32968
Virginia,Fairfax County,6,76662,39400,37262
Virginia,Fairfax County,7,85142,42627,42515
Virginia,Fairfax County,8,82217,40658,41559
Virginia,Fairfax County,9,84165,41232,42933
Virginia,Fairfax County,10,84328,41121,43207
Virginia,Fairfax County,11,87028,42678,44350
Virginia,Fairfax County,12,78620,38334,40286
Virginia,Fairfax County,13,63103,30327,32776
Virginia,Fairfax County,14,48888,23637,25251
Virginia,Fairfax County,15,31729,15081,16648
Virginia,Fairfax County,16,20371,9389,10982
Virginia,Fairfax County,17,13880,6058,7822
Virginia,Fairfax County,18,15623,5474,10149
Virginia,Fauquier County,0,68248,33752,34496
Virginia,Fauquier County,1,3841,1908,1933
Virginia,Fauquier County,2,4367,2294,2073
Virginia,Fauquier County,3,4983,2534,2449
Virginia,Fauquier County,4,4731,2437,2294
Virginia,Fauquier County,5,3937,1987,1950
Virginia,Fauquier County,6,3476,1771,1705
Virginia,Fauquier County,7,3748,1875,1873
Virginia,Fauquier County,8,3662,1817,1845
Virginia,Fauquier County,9,4464,2175,2289
Virginia,Fauquier County,10,5250,2535,2715
Virginia,Fauquier County,11,6057,3008,3049
Virginia,Fauquier County,12,5295,2630,2665
Virginia,Fauquier County,13,4252,2085,2167
Virginia,Fauquier County,14,3592,1758,1834
Virginia,Fauquier County,15,2663,1257,1406
Virginia,Fauquier County,16,1727,824,903
Virginia,Fauquier County,17,1139,492,647
Virginia,Fauquier County,18,1064,365,699
Virginia,Floyd County,0,15578,7857,7721
Virginia,Floyd County,1,773,402,371
Virginia,Floyd County,2,894,471,423
Virginia,Floyd County,3,963,507,456
Virginia,Floyd County,4,857,439,418
Virginia,Floyd County,5,727,354,373
Virginia,Floyd County,6,738,385,353
Virginia,Floyd County,7,806,413,393
Virginia,Floyd County,8,901,458,443
Virginia,Floyd County,9,982,514,468
Virginia,Floyd County,10,1042,551,491
Virginia,Floyd County,11,1277,649,628
Virginia,Floyd County,12,1251,630,621
Virginia,Floyd County,13,1186,593,593
Virginia,Floyd County,14,1094,539,555
Virginia,Floyd County,15,857,442,415
Virginia,Floyd County,16,545,267,278
Virginia,Floyd County,17,332,129,203
Virginia,Floyd County,18,353,114,239
Virginia,Fluvanna County,0,26092,11927,14165
Virginia,Fluvanna County,1,1323,682,641
Virginia,Fluvanna County,2,1595,803,792
Virginia,Fluvanna County,3,1624,788,836
Virginia,Fluvanna County,4,1544,761,783
Virginia,Fluvanna County,5,1330,554,776
Virginia,Fluvanna County,6,1362,557,805
Virginia,Fluvanna County,7,1640,689,951
Virginia,Fluvanna County,8,1676,712,964
Virginia,Fluvanna County,9,1782,763,1019
Virginia,Fluvanna County,10,1905,846,1059
Virginia,Fluvanna County,11,1964,921,1043
Virginia,Fluvanna County,12,1926,873,1053
Virginia,Fluvanna County,13,1646,749,897
Virginia,Fluvanna County,14,1565,737,828
Virginia,Fluvanna County,15,1261,586,675
Virginia,Fluvanna County,16,907,433,474
Virginia,Fluvanna County,17,569,270,299
Virginia,Fluvanna County,18,473,203,270
Virginia,Franklin County,0,56358,27770,28588
Virginia,Franklin County,1,2679,1319,1360
Virginia,Franklin County,2,3147,1618,1529
Virginia,Franklin County,3,3289,1637,1652
Virginia,Franklin County,4,3543,1764,1779
Virginia,Franklin County,5,3413,1760,1653
Virginia,Franklin County,6,2740,1323,1417
Virginia,Franklin County,7,2700,1325,1375
Virginia,Franklin County,8,2761,1355,1406
Virginia,Franklin County,9,3307,1644,1663
Virginia,Franklin County,10,3912,1962,1950
Virginia,Franklin County,11,4388,2155,2233
Virginia,Franklin County,12,4470,2257,2213
Virginia,Franklin County,13,4279,2055,2224
Virginia,Franklin County,14,4266,2137,2129
Virginia,Franklin County,15,3129,1589,1540
Virginia,Franklin County,16,2016,953,1063
Virginia,Franklin County,17,1267,552,715
Virginia,Franklin County,18,1052,365,687
Virginia,Frederick County,0,82377,40993,41384
Virginia,Frederick County,1,4774,2455,2319
Virginia,Frederick County,2,5481,2879,2602
Virginia,Frederick County,3,5753,2903,2850
Virginia,Frederick County,4,5240,2739,2501
Virginia,Frederick County,5,4957,2542,2415
Virginia,Frederick County,6,4832,2449,2383
Virginia,Frederick County,7,5145,2577,2568
Virginia,Frederick County,8,4956,2477,2479
Virginia,Frederick County,9,5553,2716,2837
Virginia,Frederick County,10,6140,3033,3107
Virginia,Frederick County,11,6515,3316,3199
Virginia,Frederick County,12,5784,2871,2913
Virginia,Frederick County,13,4729,2264,2465
Virginia,Frederick County,14,4221,2030,2191
Virginia,Frederick County,15,3183,1501,1682
Virginia,Frederick County,16,2310,1090,1220
Virginia,Frederick County,17,1456,657,799
Virginia,Frederick County,18,1348,494,854
Virginia,Giles County,0,16815,8280,8535
Virginia,Giles County,1,861,413,448
Virginia,Giles County,2,877,444,433
Virginia,Giles County,3,1091,549,542
Virginia,Giles County,4,994,531,463
Virginia,Giles County,5,922,467,455
Virginia,Giles County,6,879,446,433
Virginia,Giles County,7,907,481,426
Virginia,Giles County,8,950,474,476
Virginia,Giles County,9,1130,569,561
Virginia,Giles County,10,1219,582,637
Virginia,Giles County,11,1229,648,581
Virginia,Giles County,12,1178,567,611
Virginia,Giles County,13,1223,586,637
Virginia,Giles County,14,1160,569,591
Virginia,Giles County,15,886,438,448
Virginia,Giles County,16,523,251,272
Virginia,Giles County,17,387,153,234
Virginia,Giles County,18,399,112,287
Virginia,Gloucester County,0,37141,18314,18827
Virginia,Gloucester County,1,1911,937,974
Virginia,Gloucester County,2,1973,998,975
Virginia,Gloucester County,3,2283,1193,1090
Virginia,Gloucester County,4,2237,1198,1039
Virginia,Gloucester County,5,2161,1114,1047
Virginia,Gloucester County,6,2101,1042,1059
Virginia,Gloucester County,7,2157,1099,1058
Virginia,Gloucester County,8,1964,989,975
Virginia,Gloucester County,9,2284,1130,1154
Virginia,Gloucester County,10,2647,1263,1384
Virginia,Gloucester County,11,3262,1623,1639
Virginia,Gloucester County,12,3171,1534,1637
Virginia,Gloucester County,13,2490,1223,1267
Virginia,Gloucester County,14,2249,1105,1144
Virginia,Gloucester County,15,1705,807,898
Virginia,Gloucester County,16,1135,501,634
Virginia,Gloucester County,17,712,301,411
Virginia,Gloucester County,18,699,257,442
Virginia,Goochland County,0,21936,10833,11103
Virginia,Goochland County,1,876,440,436
Virginia,Goochland County,2,1103,577,526
Virginia,Goochland County,3,1350,678,672
Virginia,Goochland County,4,1256,657,599
Virginia,Goochland County,5,1056,577,479
Virginia,Goochland County,6,884,465,419
Virginia,Goochland County,7,1002,504,498
Virginia,Goochland County,8,1177,561,616
Virginia,Goochland County,9,1536,731,805
Virginia,Goochland County,10,1683,804,879
Virginia,Goochland County,11,1985,944,1041
Virginia,Goochland County,12,1981,949,1032
Virginia,Goochland County,13,1790,898,892
Virginia,Goochland County,14,1677,843,834
Virginia,Goochland County,15,1104,524,580
Virginia,Goochland County,16,634,324,310
Virginia,Goochland County,17,434,199,235
Virginia,Goochland County,18,408,158,250
Virginia,Grayson County,0,15093,7346,7747
Virginia,Grayson County,1,705,337,368
Virginia,Grayson County,2,685,335,350
Virginia,Grayson County,3,819,398,421
Virginia,Grayson County,4,795,398,397
Virginia,Grayson County,5,724,349,375
Virginia,Grayson County,6,720,372,348
Virginia,Grayson County,7,664,341,323
Virginia,Grayson County,8,758,390,368
Virginia,Grayson County,9,970,495,475
Virginia,Grayson County,10,1052,517,535
Virginia,Grayson County,11,1173,579,594
Virginia,Grayson County,12,1188,596,592
Virginia,Grayson County,13,1271,628,643
Virginia,Grayson County,14,1129,570,559
Virginia,Grayson County,15,875,418,457
Virginia,Grayson County,16,681,305,376
Virginia,Grayson County,17,500,204,296
Virginia,Grayson County,18,384,114,270
Virginia,Greene County,0,19031,9442,9589
Virginia,Greene County,1,1227,652,575
Virginia,Greene County,2,1339,690,649
Virginia,Greene County,3,1321,705,616
Virginia,Greene County,4,1087,603,484
Virginia,Greene County,5,969,489,480
Virginia,Greene County,6,1076,524,552
Virginia,Greene County,7,1189,579,610
Virginia,Greene County,8,1201,603,598
Virginia,Greene County,9,1281,640,641
Virginia,Greene County,10,1359,670,689
Virginia,Greene County,11,1517,745,772
Virginia,Greene County,12,1325,649,676
Virginia,Greene County,13,1145,523,622
Virginia,Greene County,14,1133,538,595
Virginia,Greene County,15,782,365,417
Virginia,Greene County,16,512,246,266
Virginia,Greene County,17,304,133,171
Virginia,Greene County,18,264,88,176
Virginia,Greensville County,0,11681,7148,4533
Virginia,Greensville County,1,613,356,257
Virginia,Greensville County,2,535,270,265
Virginia,Greensville County,3,553,294,259
Virginia,Greensville County,4,576,304,272
Virginia,Greensville County,5,778,550,228
Virginia,Greensville County,6,881,638,243
Virginia,Greensville County,7,856,659,197
Virginia,Greensville County,8,838,584,254
Virginia,Greensville County,9,900,629,271
Virginia,Greensville County,10,962,669,293
Virginia,Greensville County,11,889,558,331
Virginia,Greensville County,12,831,479,352
Virginia,Greensville County,13,706,383,323
Virginia,Greensville County,14,633,321,312
Virginia,Greensville County,15,445,192,253
Virginia,Greensville County,16,298,119,179
Virginia,Greensville County,17,220,99,121
Virginia,Greensville County,18,167,44,123
Virginia,Halifax County,0,35200,16894,18306
Virginia,Halifax County,1,1737,943,794
Virginia,Halifax County,2,2052,1041,1011
Virginia,Halifax County,3,2151,1067,1084
Virginia,Halifax County,4,2148,1109,1039
Virginia,Halifax County,5,2020,1026,994
Virginia,Halifax County,6,1699,880,819
Virginia,Halifax County,7,1736,839,897
Virginia,Halifax County,8,1716,827,889
Virginia,Halifax County,9,2072,1025,1047
Virginia,Halifax County,10,2200,1099,1101
Virginia,Halifax County,11,2500,1235,1265
Virginia,Halifax County,12,2772,1317,1455
Virginia,Halifax County,13,2637,1266,1371
Virginia,Halifax County,14,2531,1172,1359
Virginia,Halifax County,15,1927,882,1045
Virginia,Halifax County,16,1410,592,818
Virginia,Halifax County,17,938,314,624
Virginia,Halifax County,18,954,260,694
Virginia,Hanover County,0,101918,49916,52002
Virginia,Hanover County,1,4711,2467,2244
Virginia,Hanover County,2,6290,3299,2991
Virginia,Hanover County,3,7465,3790,3675
Virginia,Hanover County,4,7539,3910,3629
Virginia,Hanover County,5,6358,3333,3025
Virginia,Hanover County,6,4681,2422,2259
Virginia,Hanover County,7,5129,2501,2628
Virginia,Hanover County,8,5548,2663,2885
Virginia,Hanover County,9,7099,3389,3710
Virginia,Hanover County,10,7692,3686,4006
Virginia,Hanover County,11,8789,4185,4604
Virginia,Hanover County,12,8011,3919,4092
Virginia,Hanover County,13,6637,3224,3413
Virginia,Hanover County,14,5513,2684,2829
Virginia,Hanover County,15,3998,1848,2150
Virginia,Hanover County,16,2613,1187,1426
Virginia,Hanover County,17,1897,770,1127
Virginia,Hanover County,18,1948,639,1309
Virginia,Henrico County,0,321924,151956,169968
Virginia,Henrico County,1,20229,10289,9940
Virginia,Henrico County,2,21185,10766,10419
Virginia,Henrico County,3,21299,11050,10249
Virginia,Henrico County,4,19626,10157,9469
Virginia,Henrico County,5,19601,9555,10046
Virginia,Henrico County,6,22465,10709,11756
Virginia,Henrico County,7,23508,11153,12355
Virginia,Henrico County,8,21610,10443,11167
Virginia,Henrico County,9,22225,10537,11688
Virginia,Henrico County,10,22101,10414,11687
Virginia,Henrico County,11,23353,10831,12522
Virginia,Henrico County,12,21922,9981,11941
Virginia,Henrico County,13,18459,8368,10091
Virginia,Henrico County,14,14774,6527,8247
Virginia,Henrico County,15,9949,4232,5717
Virginia,Henrico County,16,7035,2805,4230
Virginia,Henrico County,17,5724,2091,3633
Virginia,Henrico County,18,6859,2048,4811
Virginia,Henry County,0,52081,25116,26965
Virginia,Henry County,1,2613,1345,1268
Virginia,Henry County,2,2850,1479,1371
Virginia,Henry County,3,3038,1550,1488
Virginia,Henry County,4,2861,1456,1405
Virginia,Henry County,5,2750,1411,1339
Virginia,Henry County,6,2714,1344,1370
Virginia,Henry County,7,2566,1238,1328
Virginia,Henry County,8,2603,1298,1305
Virginia,Henry County,9,3101,1495,1606
Virginia,Henry County,10,3687,1796,1891
Virginia,Henry County,11,4176,2017,2159
Virginia,Henry County,12,4116,2016,2100
Virginia,Henry County,13,3678,1769,1909
Virginia,Henry County,14,3420,1563,1857
Virginia,Henry County,15,2957,1345,1612
Virginia,Henry County,16,2173,968,1205
Virginia,Henry County,17,1461,590,871
Virginia,Henry County,18,1317,436,881
Virginia,Highland County,0,2248,1117,1131
Virginia,Highland County,1,71,29,42
Virginia,Highland County,2,73,32,41
Virginia,Highland County,3,100,45,55
Virginia,Highland County,4,86,48,38
Virginia,Highland County,5,105,52,53
Virginia,Highland County,6,96,49,47
Virginia,Highland County,7,71,37,34
Virginia,Highland County,8,89,43,46
Virginia,Highland County,9,100,55,45
Virginia,Highland County,10,110,66,44
Virginia,Highland County,11,199,99,100
Virginia,Highland County,12,255,128,127
Virginia,Highland County,13,232,128,104
Virginia,Highland County,14,226,114,112
Virginia,Highland County,15,167,76,91
Virginia,Highland County,16,130,63,67
Virginia,Highland County,17,72,27,45
Virginia,Highland County,18,66,26,40
Virginia,Isle of Wight County,0,36007,17525,18482
Virginia,Isle of Wight County,1,1669,803,866
Virginia,Isle of Wight County,2,2117,1078,1039
Virginia,Isle of Wight County,3,2353,1181,1172
Virginia,Isle of Wight County,4,2250,1173,1077
Virginia,Isle of Wight County,5,1985,1061,924
Virginia,Isle of Wight County,6,1827,930,897
Virginia,Isle of Wight County,7,1871,914,957
Virginia,Isle of Wight County,8,1914,940,974
Virginia,Isle of Wight County,9,2295,1055,1240
Virginia,Isle of Wight County,10,2502,1195,1307
Virginia,Isle of Wight County,11,3404,1690,1714
Virginia,Isle of Wight County,12,3012,1494,1518
Virginia,Isle of Wight County,13,2583,1254,1329
Virginia,Isle of Wight County,14,2174,1013,1161
Virginia,Isle of Wight County,15,1641,786,855
Virginia,Isle of Wight County,16,1065,465,600
Virginia,Isle of Wight County,17,685,294,391
Virginia,Isle of Wight County,18,660,199,461
Virginia,James City County,0,72583,35042,37541
Virginia,James City County,1,3670,1847,1823
Virginia,James City County,2,4119,2072,2047
Virginia,James City County,3,4514,2259,2255
Virginia,James City County,4,4396,2306,2090
Virginia,James City County,5,3982,2040,1942
Virginia,James City County,6,3774,1909,1865
Virginia,James City County,7,3753,1849,1904
Virginia,James City County,8,3755,1849,1906
Virginia,James City County,9,4186,2015,2171
Virginia,James City County,10,4752,2271,2481
Virginia,James City County,11,5166,2442,2724
Virginia,James City County,12,4942,2323,2619
Virginia,James City County,13,5011,2279,2732
Virginia,James City County,14,5133,2363,2770
Virginia,James City County,15,4266,1967,2299
Virginia,James City County,16,2976,1490,1486
Virginia,James City County,17,2113,981,1132
Virginia,James City County,18,2075,780,1295
Virginia,King and Queen County,0,7175,3606,3569
Virginia,King and Queen County,1,283,162,121
Virginia,King and Queen County,2,387,197,190
Virginia,King and Queen County,3,450,237,213
Virginia,King and Queen County,4,368,190,178
Virginia,King and Queen County,5,393,213,180
Virginia,King and Queen County,6,394,220,174
Virginia,King and Queen County,7,347,169,178
Virginia,King and Queen County,8,374,197,177
Virginia,King and Queen County,9,406,212,194
Virginia,King and Queen County,10,481,220,261
Virginia,King and Queen County,11,587,310,277
Virginia,King and Queen County,12,622,319,303
Virginia,King and Queen County,13,603,287,316
Virginia,King and Queen County,14,470,240,230
Virginia,King and Queen County,15,422,207,215
Virginia,King and Queen County,16,208,92,116
Virginia,King and Queen County,17,189,76,113
Virginia,King and Queen County,18,191,58,133
Virginia,King George County,0,25371,12828,12543
Virginia,King George County,1,1735,904,831
Virginia,King George County,2,1949,1002,947
Virginia,King George County,3,1836,917,919
Virginia,King George County,4,1698,881,817
Virginia,King George County,5,1618,887,731
Virginia,King George County,6,1574,826,748
Virginia,King George County,7,1676,825,851
Virginia,King George County,8,1730,867,863
Virginia,King George County,9,1710,856,854
Virginia,King George County,10,1854,942,912
Virginia,King George County,11,2018,1009,1009
Virginia,King George County,12,1698,857,841
Virginia,King George County,13,1313,658,655
Virginia,King George County,14,1057,537,520
Virginia,King George County,15,802,392,410
Virginia,King George County,16,506,227,279
Virginia,King George County,17,305,147,158
Virginia,King George County,18,292,94,198
Virginia,King William County,0,16186,7876,8310
Virginia,King William County,1,983,485,498
Virginia,King William County,2,1083,545,538
Virginia,King William County,3,1108,576,532
Virginia,King William County,4,971,489,482
Virginia,King William County,5,907,471,436
Virginia,King William County,6,975,475,500
Virginia,King William County,7,1065,527,538
Virginia,King William County,8,977,471,506
Virginia,King William County,9,1080,515,565
Virginia,King William County,10,1172,582,590
Virginia,King William County,11,1314,630,684
Virginia,King William County,12,1215,579,636
Virginia,King William County,13,1004,463,541
Virginia,King William County,14,863,418,445
Virginia,King William County,15,592,287,305
Virginia,King William County,16,389,177,212
Virginia,King William County,17,246,120,126
Virginia,King William County,18,242,66,176
Virginia,Lancaster County,0,11044,5163,5881
Virginia,Lancaster County,1,419,191,228
Virginia,Lancaster County,2,436,251,185
Virginia,Lancaster County,3,508,257,251
Virginia,Lancaster County,4,472,252,220
Virginia,Lancaster County,5,476,242,234
Virginia,Lancaster County,6,452,231,221
Virginia,Lancaster County,7,372,186,186
Virginia,Lancaster County,8,397,181,216
Virginia,Lancaster County,9,439,201,238
Virginia,Lancaster County,10,534,264,270
Virginia,Lancaster County,11,763,344,419
Virginia,Lancaster County,12,916,417,499
Virginia,Lancaster County,13,975,458,517
Virginia,Lancaster County,14,1061,475,586
Virginia,Lancaster County,15,943,449,494
Virginia,Lancaster County,16,720,328,392
Virginia,Lancaster County,17,540,242,298
Virginia,Lancaster County,18,621,194,427
Virginia,Lee County,0,24951,13042,11909
Virginia,Lee County,1,1277,663,614
Virginia,Lee County,2,1289,676,613
Virginia,Lee County,3,1372,717,655
Virginia,Lee County,4,1310,693,617
Virginia,Lee County,5,1347,741,606
Virginia,Lee County,6,1605,983,622
Virginia,Lee County,7,1585,978,607
Virginia,Lee County,8,1666,993,673
Virginia,Lee County,9,1703,910,793
Virginia,Lee County,10,1660,848,812
Virginia,Lee County,11,1752,865,887
Virginia,Lee County,12,1900,950,950
Virginia,Lee County,13,1782,887,895
Virginia,Lee County,14,1566,771,795
Virginia,Lee County,15,1284,609,675
Virginia,Lee County,16,917,402,515
Virginia,Lee County,17,513,215,298
Virginia,Lee County,18,423,141,282
Virginia,Loudoun County,0,363050,180222,182828
Virginia,Loudoun County,1,27910,14507,13403
Virginia,Loudoun County,2,31616,16141,15475
Virginia,Loudoun County,3,30870,15536,15334
Virginia,Loudoun County,4,24158,12302,11856
Virginia,Loudoun County,5,17320,8858,8462
Virginia,Loudoun County,6,19312,9556,9756
Virginia,Loudoun County,7,27824,13311,14513
Virginia,Loudoun County,8,31130,15044,16086
Virginia,Loudoun County,9,33133,16722,16411
Virginia,Loudoun County,10,30221,15046,15175
Virginia,Loudoun County,11,26988,13738,13250
Virginia,Loudoun County,12,19883,9973,9910
Virginia,Loudoun County,13,14096,6886,7210
Virginia,Loudoun County,14,10427,4949,5478
Virginia,Loudoun County,15,7138,3194,3944
Virginia,Loudoun County,16,4516,1982,2534
Virginia,Loudoun County,17,3299,1360,1939
Virginia,Loudoun County,18,3209,1117,2092
Virginia,Louisa County,0,34348,16953,17395
Virginia,Louisa County,1,1922,970,952
Virginia,Louisa County,2,2060,1041,1019
Virginia,Louisa County,3,2059,1025,1034
Virginia,Louisa County,4,1827,966,861
Virginia,Louisa County,5,1772,855,917
Virginia,Louisa County,6,1928,950,978
Virginia,Louisa County,7,1908,951,957
Virginia,Louisa County,8,1951,995,956
Virginia,Louisa County,9,2087,1047,1040
Virginia,Louisa County,10,2433,1191,1242
Virginia,Louisa County,11,2979,1434,1545
Virginia,Louisa County,12,2808,1384,1424
Virginia,Louisa County,13,2576,1258,1318
Virginia,Louisa County,14,2280,1141,1139
Virginia,Louisa County,15,1586,762,824
Virginia,Louisa County,16,1045,503,542
Virginia,Louisa County,17,613,296,317
Virginia,Louisa County,18,514,184,330
Virginia,Lunenburg County,0,12466,6571,5895
Virginia,Lunenburg County,1,548,297,251
Virginia,Lunenburg County,2,668,336,332
Virginia,Lunenburg County,3,700,364,336
Virginia,Lunenburg County,4,647,338,309
Virginia,Lunenburg County,5,708,388,320
Virginia,Lunenburg County,6,706,392,314
Virginia,Lunenburg County,7,739,465,274
Virginia,Lunenburg County,8,757,461,296
Virginia,Lunenburg County,9,766,439,327
Virginia,Lunenburg County,10,834,485,349
Virginia,Lunenburg County,11,945,497,448
Virginia,Lunenburg County,12,1027,526,501
Virginia,Lunenburg County,13,969,490,479
Virginia,Lunenburg County,14,801,385,416
Virginia,Lunenburg County,15,625,287,338
Virginia,Lunenburg County,16,455,206,249
Virginia,Lunenburg County,17,315,126,189
Virginia,Lunenburg County,18,256,89,167
Virginia,Madison County,0,13157,6398,6759
Virginia,Madison County,1,663,330,333
Virginia,Madison County,2,753,394,359
Virginia,Madison County,3,859,407,452
Virginia,Madison County,4,775,383,392
Virginia,Madison County,5,728,366,362
Virginia,Madison County,6,643,310,333
Virginia,Madison County,7,669,350,319
Virginia,Madison County,8,675,314,361
Virginia,Madison County,9,735,360,375
Virginia,Madison County,10,836,428,408
Virginia,Madison County,11,1097,528,569
Virginia,Madison County,12,1069,513,556
Virginia,Madison County,13,957,453,504
Virginia,Madison County,14,870,400,470
Virginia,Madison County,15,680,332,348
Virginia,Madison County,16,510,247,263
Virginia,Madison County,17,308,147,161
Virginia,Madison County,18,330,136,194
Virginia,Mathews County,0,8836,4267,4569
Virginia,Mathews County,1,328,163,165
Virginia,Mathews County,2,386,192,194
Virginia,Mathews County,3,457,227,230
Virginia,Mathews County,4,498,260,238
Virginia,Mathews County,5,413,203,210
Virginia,Mathews County,6,352,180,172
Virginia,Mathews County,7,324,152,172
Virginia,Mathews County,8,364,196,168
Virginia,Mathews County,9,451,222,229
Virginia,Mathews County,10,580,272,308
Virginia,Mathews County,11,687,312,375
Virginia,Mathews County,12,764,383,381
Virginia,Mathews County,13,736,339,397
Virginia,Mathews County,14,773,353,420
Virginia,Mathews County,15,663,339,324
Virginia,Mathews County,16,468,221,247
Virginia,Mathews County,17,318,143,175
Virginia,Mathews County,18,274,110,164
Virginia,Mecklenburg County,0,31192,15083,16109
Virginia,Mecklenburg County,1,1485,744,741
Virginia,Mecklenburg County,2,1604,840,764
Virginia,Mecklenburg County,3,1713,844,869
Virginia,Mecklenburg County,4,1755,887,868
Virginia,Mecklenburg County,5,1643,872,771
Virginia,Mecklenburg County,6,1492,792,700
Virginia,Mecklenburg County,7,1528,821,707
Virginia,Mecklenburg County,8,1535,752,783
Virginia,Mecklenburg County,9,1776,835,941
Virginia,Mecklenburg County,10,1896,950,946
Virginia,Mecklenburg County,11,2398,1184,1214
Virginia,Mecklenburg County,12,2494,1199,1295
Virginia,Mecklenburg County,13,2436,1145,1291
Virginia,Mecklenburg County,14,2394,1119,1275
Virginia,Mecklenburg County,15,1890,845,1045
Virginia,Mecklenburg County,16,1368,601,767
Virginia,Mecklenburg County,17,931,366,565
Virginia,Mecklenburg County,18,854,287,567
Virginia,Middlesex County,0,10696,5260,5436
Virginia,Middlesex County,1,438,223,215
Virginia,Middlesex County,2,450,235,215
Virginia,Middlesex County,3,504,250,254
Virginia,Middlesex County,4,437,225,212
Virginia,Middlesex County,5,513,274,239
Virginia,Middlesex County,6,487,267,220
Virginia,Middlesex County,7,455,246,209
Virginia,Middlesex County,8,404,210,194
Virginia,Middlesex County,9,521,264,257
Virginia,Middlesex County,10,640,307,333
Virginia,Middlesex County,11,847,416,431
Virginia,Middlesex County,12,957,452,505
Virginia,Middlesex County,13,938,436,502
Virginia,Middlesex County,14,1023,496,527
Virginia,Middlesex County,15,835,411,424
Virginia,Middlesex County,16,546,258,288
Virginia,Middlesex County,17,355,152,203
Virginia,Middlesex County,18,346,138,208
Virginia,Montgomery County,0,97244,50649,46595
Virginia,Montgomery County,1,4418,2286,2132
Virginia,Montgomery County,2,4311,2228,2083
Virginia,Montgomery County,3,4202,2197,2005
Virginia,Montgomery County,4,10670,5779,4891
Virginia,Montgomery County,5,19661,11258,8403
Virginia,Montgomery County,6,8188,4519,3669
Virginia,Montgomery County,7,5723,3079,2644
Virginia,Montgomery County,8,4894,2550,2344
Virginia,Montgomery County,9,5180,2614,2566
Virginia,Montgomery County,10,4853,2437,2416
Virginia,Montgomery County,11,5050,2436,2614
Virginia,Montgomery County,12,4947,2409,2538
Virginia,Montgomery County,13,4460,2142,2318
Virginia,Montgomery County,14,3570,1656,1914
Virginia,Montgomery County,15,2636,1250,1386
Virginia,Montgomery County,16,1856,831,1025
Virginia,Montgomery County,17,1287,527,760
Virginia,Montgomery County,18,1338,451,887
Virginia,Nelson County,0,14850,7224,7626
Virginia,Nelson County,1,669,346,323
Virginia,Nelson County,2,770,389,381
Virginia,Nelson County,3,850,450,400
Virginia,Nelson County,4,763,416,347
Virginia,Nelson County,5,717,342,375
Virginia,Nelson County,6,697,346,351
Virginia,Nelson County,7,723,366,357
Virginia,Nelson County,8,699,346,353
Virginia,Nelson County,9,769,377,392
Virginia,Nelson County,10,909,436,473
Virginia,Nelson County,11,1125,537,588
Virginia,Nelson County,12,1262,590,672
Virginia,Nelson County,13,1378,639,739
Virginia,Nelson County,14,1300,634,666
Virginia,Nelson County,15,918,452,466
Virginia,Nelson County,16,620,285,335
Virginia,Nelson County,17,357,170,187
Virginia,Nelson County,18,324,103,221
Virginia,New Kent County,0,20021,10203,9818
Virginia,New Kent County,1,969,479,490
Virginia,New Kent County,2,1119,592,527
Virginia,New Kent County,3,1277,664,613
Virginia,New Kent County,4,1236,648,588
Virginia,New Kent County,5,1125,635,490
Virginia,New Kent County,6,1104,613,491
Virginia,New Kent County,7,1108,554,554
Virginia,New Kent County,8,1154,572,582
Virginia,New Kent County,9,1410,706,704
Virginia,New Kent County,10,1510,772,738
Virginia,New Kent County,11,1769,905,864
Virginia,New Kent County,12,1730,827,903
Virginia,New Kent County,13,1492,719,773
Virginia,New Kent County,14,1317,672,645
Virginia,New Kent County,15,799,427,372
Virginia,New Kent County,16,467,234,233
Virginia,New Kent County,17,224,100,124
Virginia,New Kent County,18,211,84,127
Virginia,Northampton County,0,12121,5867,6254
Virginia,Northampton County,1,707,409,298
Virginia,Northampton County,2,681,388,293
Virginia,Northampton County,3,653,330,323
Virginia,Northampton County,4,589,321,268
Virginia,Northampton County,5,639,326,313
Virginia,Northampton County,6,643,313,330
Virginia,Northampton County,7,591,274,317
Virginia,Northampton County,8,569,300,269
Virginia,Northampton County,9,560,273,287
Virginia,Northampton County,10,604,289,315
Virginia,Northampton County,11,888,402,486
Virginia,Northampton County,12,1040,469,571
Virginia,Northampton County,13,999,466,533
Virginia,Northampton County,14,926,438,488
Virginia,Northampton County,15,726,340,386
Virginia,Northampton County,16,486,222,264
Virginia,Northampton County,17,381,154,227
Virginia,Northampton County,18,439,153,286
Virginia,Northumberland County,0,12251,6068,6183
Virginia,Northumberland County,1,475,269,206
Virginia,Northumberland County,2,563,313,250
Virginia,Northumberland County,3,564,305,259
Virginia,Northumberland County,4,536,283,253
Virginia,Northumberland County,5,526,274,252
Virginia,Northumberland County,6,472,241,231
Virginia,Northumberland County,7,458,221,237
Virginia,Northumberland County,8,451,235,216
Virginia,Northumberland County,9,436,209,227
Virginia,Northumberland County,10,626,278,348
Virginia,Northumberland County,11,880,433,447
Virginia,Northumberland County,12,1005,466,539
Virginia,Northumberland County,13,1060,505,555
Virginia,Northumberland County,14,1345,619,726
Virginia,Northumberland County,15,1153,572,581
Virginia,Northumberland County,16,780,407,373
Virginia,Northumberland County,17,505,252,253
Virginia,Northumberland County,18,416,186,230
Virginia,Nottoway County,0,15579,8257,7322
Virginia,Nottoway County,1,954,488,466
Virginia,Nottoway County,2,845,418,427
Virginia,Nottoway County,3,849,428,421
Virginia,Nottoway County,4,829,422,407
Virginia,Nottoway County,5,992,594,398
Virginia,Nottoway County,6,1062,681,381
Virginia,Nottoway County,7,1008,619,389
Virginia,Nottoway County,8,901,522,379
Virginia,Nottoway County,9,925,545,380
Virginia,Nottoway County,10,1073,616,457
Virginia,Nottoway County,11,1183,631,552
Virginia,Nottoway County,12,1136,577,559
Virginia,Nottoway County,13,965,488,477
Virginia,Nottoway County,14,876,429,447
Virginia,Nottoway County,15,690,307,383
Virginia,Nottoway County,16,560,236,324
Virginia,Nottoway County,17,370,142,228
Virginia,Nottoway County,18,361,114,247
Virginia,Orange County,0,35026,17162,17864
Virginia,Orange County,1,2030,1022,1008
Virginia,Orange County,2,2151,1070,1081
Virginia,Orange County,3,2191,1128,1063
Virginia,Orange County,4,2054,1063,991
Virginia,Orange County,5,1897,982,915
Virginia,Orange County,6,1896,963,933
Virginia,Orange County,7,2057,1024,1033
Virginia,Orange County,8,1969,960,1009
Virginia,Orange County,9,2128,1064,1064
Virginia,Orange County,10,2389,1210,1179
Virginia,Orange County,11,2627,1302,1325
Virginia,Orange County,12,2539,1253,1286
Virginia,Orange County,13,2193,1014,1179
Virginia,Orange County,14,2181,962,1219
Virginia,Orange County,15,1795,830,965
Virginia,Orange County,16,1336,632,704
Virginia,Orange County,17,834,385,449
Virginia,Orange County,18,759,298,461
Virginia,Page County,0,23848,11832,12016
Virginia,Page County,1,1182,640,542
Virginia,Page County,2,1321,663,658
Virginia,Page County,3,1482,750,732
Virginia,Page County,4,1328,676,652
Virginia,Page County,5,1278,641,637
Virginia,Page County,6,1339,675,664
Virginia,Page County,7,1289,673,616
Virginia,Page County,8,1360,671,689
Virginia,Page County,9,1524,754,770
Virginia,Page County,10,1666,854,812
Virginia,Page County,11,1944,976,968
Virginia,Page County,12,1750,841,909
Virginia,Page County,13,1671,835,836
Virginia,Page County,14,1495,736,759
Virginia,Page County,15,1233,605,628
Virginia,Page County,16,894,425,469
Virginia,Page County,17,577,238,339
Virginia,Page County,18,515,179,336
Virginia,Patrick County,0,18264,8971,9293
Virginia,Patrick County,1,732,370,362
Virginia,Patrick County,2,931,479,452
Virginia,Patrick County,3,978,497,481
Virginia,Patrick County,4,1017,512,505
Virginia,Patrick County,5,861,444,417
Virginia,Patrick County,6,784,401,383
Virginia,Patrick County,7,816,424,392
Virginia,Patrick County,8,942,465,477
Virginia,Patrick County,9,1191,620,571
Virginia,Patrick County,10,1246,644,602
Virginia,Patrick County,11,1512,742,770
Virginia,Patrick County,12,1450,733,717
Virginia,Patrick County,13,1386,680,706
Virginia,Patrick County,14,1377,642,735
Virginia,Patrick County,15,1218,576,642
Virginia,Patrick County,16,835,382,453
Virginia,Patrick County,17,543,215,328
Virginia,Patrick County,18,445,145,300
Virginia,Pittsylvania County,0,62383,30618,31765
Virginia,Pittsylvania County,1,2667,1305,1362
Virginia,Pittsylvania County,2,3450,1669,1781
Virginia,Pittsylvania County,3,3877,1969,1908
Virginia,Pittsylvania County,4,3623,1900,1723
Virginia,Pittsylvania County,5,3423,1788,1635
Virginia,Pittsylvania County,6,3100,1660,1440
Virginia,Pittsylvania County,7,3124,1553,1571
Virginia,Pittsylvania County,8,3235,1639,1596
Virginia,Pittsylvania County,9,4018,2000,2018
Virginia,Pittsylvania County,10,4347,2188,2159
Virginia,Pittsylvania County,11,5268,2562,2706
Virginia,Pittsylvania County,12,5058,2465,2593
Virginia,Pittsylvania County,13,4709,2318,2391
Virginia,Pittsylvania County,14,4138,1961,2177
Virginia,Pittsylvania County,15,3334,1601,1733
Virginia,Pittsylvania County,16,2240,1039,1201
Virginia,Pittsylvania County,17,1426,590,836
Virginia,Pittsylvania County,18,1346,411,935
Virginia,Powhatan County,0,28449,15267,13182
Virginia,Powhatan County,1,1118,597,521
Virginia,Powhatan County,2,1491,802,689
Virginia,Powhatan County,3,1669,855,814
Virginia,Powhatan County,4,1916,1151,765
Virginia,Powhatan County,5,1689,982,707
Virginia,Powhatan County,6,1396,851,545
Virginia,Powhatan County,7,1508,868,640
Virginia,Powhatan County,8,1719,943,776
Virginia,Powhatan County,9,2174,1183,991
Virginia,Powhatan County,10,2486,1341,1145
Virginia,Powhatan County,11,2592,1370,1222
Virginia,Powhatan County,12,2225,1139,1086
Virginia,Powhatan County,13,1991,996,995
Virginia,Powhatan County,14,1778,918,860
Virginia,Powhatan County,15,1240,602,638
Virginia,Powhatan County,16,679,342,337
Virginia,Powhatan County,17,425,198,227
Virginia,Powhatan County,18,353,129,224
Virginia,Prince Edward County,0,23074,11337,11737
Virginia,Prince Edward County,1,953,466,487
Virginia,Prince Edward County,2,1059,502,557
Virginia,Prince Edward County,3,1124,562,562
Virginia,Prince Edward County,4,2783,1297,1486
Virginia,Prince Edward County,5,3999,2252,1747
Virginia,Prince Edward County,6,1305,656,649
Virginia,Prince Edward County,7,1038,527,511
Virginia,Prince Edward County,8,1007,525,482
Virginia,Prince Edward County,9,996,466,530
Virginia,Prince Edward County,10,1232,626,606
Virginia,Prince Edward County,11,1323,618,705
Virginia,Prince Edward County,12,1414,692,722
Virginia,Prince Edward County,13,1282,617,665
Virginia,Prince Edward County,14,1019,471,548
Virginia,Prince Edward County,15,855,401,454
Virginia,Prince Edward County,16,636,270,366
Virginia,Prince Edward County,17,456,182,274
Virginia,Prince Edward County,18,593,207,386
Virginia,Prince George County,0,37333,20483,16850
Virginia,Prince George County,1,1953,1038,915
Virginia,Prince George County,2,2268,1141,1127
Virginia,Prince George County,3,2319,1162,1157
Virginia,Prince George County,4,2217,1170,1047
Virginia,Prince George County,5,2595,1555,1040
Virginia,Prince George County,6,2739,1648,1091
Virginia,Prince George County,7,3093,1912,1181
Virginia,Prince George County,8,3048,1891,1157
Virginia,Prince George County,9,2700,1611,1089
Virginia,Prince George County,10,2570,1441,1129
Virginia,Prince George County,11,2691,1418,1273
Virginia,Prince George County,12,2465,1294,1171
Virginia,Prince George County,13,2028,1003,1025
Virginia,Prince George County,14,1698,859,839
Virginia,Prince George County,15,1223,605,618
Virginia,Prince George County,16,777,356,421
Virginia,Prince George County,17,508,217,291
Virginia,Prince George County,18,441,162,279
Virginia,Prince William County,0,446094,222040,224054
Virginia,Prince William County,1,35420,18069,17351
Virginia,Prince William County,2,35427,18218,17209
Virginia,Prince William County,3,34647,17618,17029
Virginia,Prince William County,4,30366,15612,14754
Virginia,Prince William County,5,29013,15061,13952
Virginia,Prince William County,6,29652,14965,14687
Virginia,Prince William County,7,34983,17365,17618
Virginia,Prince William County,8,33980,16678,17302
Virginia,Prince William County,9,34560,17092,17468
Virginia,Prince William County,10,33550,16696,16854
Virginia,Prince William County,11,32124,16037,16087
Virginia,Prince William County,12,26302,13047,13255
Virginia,Prince William County,13,19114,9217,9897
Virginia,Prince William County,14,14955,7050,7905
Virginia,Prince William County,15,9532,4329,5203
Virginia,Prince William County,16,5761,2521,3240
Virginia,Prince William County,17,3482,1393,2089
Virginia,Prince William County,18,3226,1072,2154
Virginia,Pulaski County,0,34322,17204,17118
Virginia,Pulaski County,1,1663,881,782
Virginia,Pulaski County,2,1731,885,846
Virginia,Pulaski County,3,1776,929,847
Virginia,Pulaski County,4,1742,919,823
Virginia,Pulaski County,5,1958,1062,896
Virginia,Pulaski County,6,1943,1019,924
Virginia,Pulaski County,7,1791,954,837
Virginia,Pulaski County,8,1892,987,905
Virginia,Pulaski County,9,2450,1261,1189
Virginia,Pulaski County,10,2483,1310,1173
Virginia,Pulaski County,11,2564,1287,1277
Virginia,Pulaski County,12,2660,1294,1366
Virginia,Pulaski County,13,2600,1237,1363
Virginia,Pulaski County,14,2506,1221,1285
Virginia,Pulaski County,15,1840,850,990
Virginia,Pulaski County,16,1226,560,666
Virginia,Pulaski County,17,856,342,514
Virginia,Pulaski County,18,641,206,435
Virginia,Rappahannock County,0,7361,3663,3698
Virginia,Rappahannock County,1,276,138,138
Virginia,Rappahannock County,2,336,172,164
Virginia,Rappahannock County,3,407,209,198
Virginia,Rappahannock County,4,421,222,199
Virginia,Rappahannock County,5,381,208,173
Virginia,Rappahannock County,6,327,153,174
Virginia,Rappahannock County,7,304,147,157
Virginia,Rappahannock County,8,352,173,179
Virginia,Rappahannock County,9,388,197,191
Virginia,Rappahannock County,10,498,226,272
Virginia,Rappahannock County,11,618,310,308
Virginia,Rappahannock County,12,680,325,355
Virginia,Rappahannock County,13,619,314,305
Virginia,Rappahannock County,14,654,317,337
Virginia,Rappahannock County,15,439,227,212
Virginia,Rappahannock County,16,324,164,160
Virginia,Rappahannock County,17,166,91,75
Virginia,Rappahannock County,18,171,70,101
Virginia,Richmond County,0,8902,4939,3963
Virginia,Richmond County,1,360,174,186
Virginia,Richmond County,2,436,213,223
Virginia,Richmond County,3,459,242,217
Virginia,Richmond County,4,423,229,194
Virginia,Richmond County,5,515,306,209
Virginia,Richmond County,6,584,403,181
Virginia,Richmond County,7,661,432,229
Virginia,Richmond County,8,566,380,186
Virginia,Richmond County,9,581,400,181
Virginia,Richmond County,10,674,424,250
Virginia,Richmond County,11,734,423,311
Virginia,Richmond County,12,619,347,272
Virginia,Richmond County,13,550,264,286
Virginia,Richmond County,14,457,204,253
Virginia,Richmond County,15,419,191,228
Virginia,Richmond County,16,329,138,191
Virginia,Richmond County,17,242,100,142
Virginia,Richmond County,18,293,69,224
Virginia,Roanoke County,0,93785,45013,48772
Virginia,Roanoke County,1,4514,2395,2119
Virginia,Roanoke County,2,5268,2663,2605
Virginia,Roanoke County,3,5959,3089,2870
Virginia,Roanoke County,4,5868,2976,2892
Virginia,Roanoke County,5,5495,2669,2826
Virginia,Roanoke County,6,4930,2490,2440
Virginia,Roanoke County,7,4850,2410,2440
Virginia,Roanoke County,8,5248,2544,2704
Virginia,Roanoke County,9,6390,3062,3328
Virginia,Roanoke County,10,6386,3105,3281
Virginia,Roanoke County,11,7077,3472,3605
Virginia,Roanoke County,12,6971,3292,3679
Virginia,Roanoke County,13,6434,3086,3348
Virginia,Roanoke County,14,5912,2723,3189
Virginia,Roanoke County,15,4299,1939,2360
Virginia,Roanoke County,16,3230,1361,1869
Virginia,Roanoke County,17,2524,959,1565
Virginia,Roanoke County,18,2430,778,1652
Virginia,Rockbridge County,0,22327,11031,11296
Virginia,Rockbridge County,1,865,435,430
Virginia,Rockbridge County,2,1093,549,544
Virginia,Rockbridge County,3,1180,571,609
Virginia,Rockbridge County,4,1165,613,552
Virginia,Rockbridge County,5,1119,571,548
Virginia,Rockbridge County,6,1221,637,584
Virginia,Rockbridge County,7,1109,563,546
Virginia,Rockbridge County,8,1064,542,522
Virginia,Rockbridge County,9,1238,595,643
Virginia,Rockbridge County,10,1503,739,764
Virginia,Rockbridge County,11,1767,852,915
Virginia,Rockbridge County,12,1789,881,908
Virginia,Rockbridge County,13,1801,920,881
Virginia,Rockbridge County,14,1656,834,822
Virginia,Rockbridge County,15,1311,625,686
Virginia,Rockbridge County,16,1055,497,558
Virginia,Rockbridge County,17,733,330,403
Virginia,Rockbridge County,18,658,277,381
Virginia,Rockingham County,0,78171,38267,39904
Virginia,Rockingham County,1,4216,2149,2067
Virginia,Rockingham County,2,4860,2496,2364
Virginia,Rockingham County,3,5247,2660,2587
Virginia,Rockingham County,4,5415,2637,2778
Virginia,Rockingham County,5,5053,2476,2577
Virginia,Rockingham County,6,4280,2174,2106
Virginia,Rockingham County,7,4435,2249,2186
Virginia,Rockingham County,8,4353,2169,2184
Virginia,Rockingham County,9,4797,2368,2429
Virginia,Rockingham County,10,5113,2524,2589
Virginia,Rockingham County,11,5711,2845,2866
Virginia,Rockingham County,12,5744,2770,2974
Virginia,Rockingham County,13,4899,2424,2475
Virginia,Rockingham County,14,4228,2048,2180
Virginia,Rockingham County,15,3415,1641,1774
Virginia,Rockingham County,16,2593,1160,1433
Virginia,Rockingham County,17,1887,791,1096
Virginia,Rockingham County,18,1925,686,1239
Virginia,Russell County,0,28023,13679,14344
Virginia,Russell County,1,1462,729,733
Virginia,Russell County,2,1518,765,753
Virginia,Russell County,3,1556,759,797
Virginia,Russell County,4,1490,743,747
Virginia,Russell County,5,1613,854,759
Virginia,Russell County,6,1536,761,775
Virginia,Russell County,7,1577,818,759
Virginia,Russell County,8,1627,819,808
Virginia,Russell County,9,1852,913,939
Virginia,Russell County,10,1916,936,980
Virginia,Russell County,11,2180,1069,1111
Virginia,Russell County,12,2302,1114,1188
Virginia,Russell County,13,2120,1051,1069
Virginia,Russell County,14,1809,891,918
Virginia,Russell County,15,1326,596,730
Virginia,Russell County,16,967,412,555
Virginia,Russell County,17,644,251,393
Virginia,Russell County,18,528,198,330
Virginia,Scott County,0,22384,11207,11177
Virginia,Scott County,1,1079,551,528
Virginia,Scott County,2,1147,575,572
Virginia,Scott County,3,1205,601,604
Virginia,Scott County,4,1202,592,610
Virginia,Scott County,5,1209,672,537
Virginia,Scott County,6,1190,650,540
Virginia,Scott County,7,1243,654,589
Virginia,Scott County,8,1250,665,585
Virginia,Scott County,9,1481,748,733
Virginia,Scott County,10,1560,764,796
Virginia,Scott County,11,1692,881,811
Virginia,Scott County,12,1726,880,846
Virginia,Scott County,13,1596,785,811
Virginia,Scott County,14,1538,711,827
Virginia,Scott County,15,1200,572,628
Virginia,Scott County,16,931,442,489
Virginia,Scott County,17,623,261,362
Virginia,Scott County,18,512,203,309
Virginia,Shenandoah County,0,43021,21014,22007
Virginia,Shenandoah County,1,2390,1153,1237
Virginia,Shenandoah County,2,2534,1295,1239
Virginia,Shenandoah County,3,2672,1374,1298
Virginia,Shenandoah County,4,2506,1261,1245
Virginia,Shenandoah County,5,2366,1210,1156
Virginia,Shenandoah County,6,2390,1204,1186
Virginia,Shenandoah County,7,2406,1183,1223
Virginia,Shenandoah County,8,2221,1147,1074
Virginia,Shenandoah County,9,2606,1286,1320
Virginia,Shenandoah County,10,2981,1463,1518
Virginia,Shenandoah County,11,3219,1589,1630
Virginia,Shenandoah County,12,3110,1499,1611
Virginia,Shenandoah County,13,2919,1464,1455
Virginia,Shenandoah County,14,2759,1323,1436
Virginia,Shenandoah County,15,2190,1017,1173
Virginia,Shenandoah County,16,1594,728,866
Virginia,Shenandoah County,17,1075,472,603
Virginia,Shenandoah County,18,1083,346,737
Virginia,Smyth County,0,31555,15469,16086
Virginia,Smyth County,1,1544,786,758
Virginia,Smyth County,2,1791,950,841
Virginia,Smyth County,3,1839,953,886
Virginia,Smyth County,4,1793,923,870
Virginia,Smyth County,5,1907,919,988
Virginia,Smyth County,6,1686,879,807
Virginia,Smyth County,7,1680,820,860
Virginia,Smyth County,8,1776,904,872
Virginia,Smyth County,9,2179,1061,1118
Virginia,Smyth County,10,2183,1105,1078
Virginia,Smyth County,11,2307,1164,1143
Virginia,Smyth County,12,2361,1157,1204
Virginia,Smyth County,13,2202,1041,1161
Virginia,Smyth County,14,2017,965,1052
Virginia,Smyth County,15,1521,713,808
Virginia,Smyth County,16,1203,554,649
Virginia,Smyth County,17,823,335,488
Virginia,Smyth County,18,743,240,503
Virginia,Southampton County,0,18059,9375,8684
Virginia,Southampton County,1,793,412,381
Virginia,Southampton County,2,970,492,478
Virginia,Southampton County,3,1033,492,541
Virginia,Southampton County,4,1000,524,476
Virginia,Southampton County,5,1011,529,482
Virginia,Southampton County,6,935,506,429
Virginia,Southampton County,7,916,439,477
Virginia,Southampton County,8,944,477,467
Virginia,Southampton County,9,1105,567,538
Virginia,Southampton County,10,1434,797,637
Virginia,Southampton County,11,1778,1024,754
Virginia,Southampton County,12,1609,891,718
Virginia,Southampton County,13,1281,690,591
Virginia,Southampton County,14,1074,564,510
Virginia,Southampton County,15,826,389,437
Virginia,Southampton County,16,612,292,320
Virginia,Southampton County,17,373,163,210
Virginia,Southampton County,18,365,127,238
Virginia,Spotsylvania County,0,129188,63621,65567
Virginia,Spotsylvania County,1,7844,4137,3707
Virginia,Spotsylvania County,2,9208,4701,4507
Virginia,Spotsylvania County,3,9952,5088,4864
Virginia,Spotsylvania County,4,9345,4833,4512
Virginia,Spotsylvania County,5,8315,4207,4108
Virginia,Spotsylvania County,6,7930,3911,4019
Virginia,Spotsylvania County,7,8281,4086,4195
Virginia,Spotsylvania County,8,8219,4065,4154
Virginia,Spotsylvania County,9,8945,4341,4604
Virginia,Spotsylvania County,10,9823,4726,5097
Virginia,Spotsylvania County,11,10113,4957,5156
Virginia,Spotsylvania County,12,8588,4227,4361
Virginia,Spotsylvania County,13,6845,3313,3532
Virginia,Spotsylvania County,14,5899,2757,3142
Virginia,Spotsylvania County,15,3948,1796,2152
Virginia,Spotsylvania County,16,2588,1209,1379
Virginia,Spotsylvania County,17,1660,706,954
Virginia,Spotsylvania County,18,1685,561,1124
Virginia,Stafford County,0,139992,70542,69450
Virginia,Stafford County,1,8947,4518,4429
Virginia,Stafford County,2,10131,5170,4961
Virginia,Stafford County,3,11383,5724,5659
Virginia,Stafford County,4,11212,5751,5461
Virginia,Stafford County,5,10548,5976,4572
Virginia,Stafford County,6,9373,5094,4279
Virginia,Stafford County,7,9148,4693,4455
Virginia,Stafford County,8,8890,4402,4488
Virginia,Stafford County,9,10059,4974,5085
Virginia,Stafford County,10,11256,5372,5884
Virginia,Stafford County,11,11293,5610,5683
Virginia,Stafford County,12,8796,4426,4370
Virginia,Stafford County,13,6207,3079,3128
Virginia,Stafford County,14,4862,2362,2500
Virginia,Stafford County,15,3317,1499,1818
Virginia,Stafford County,16,2053,899,1154
Virginia,Stafford County,17,1338,560,778
Virginia,Stafford County,18,1179,433,746
Virginia,Surry County,0,6790,3346,3444
Virginia,Surry County,1,305,148,157
Virginia,Surry County,2,327,174,153
Virginia,Surry County,3,364,182,182
Virginia,Surry County,4,395,198,197
Virginia,Surry County,5,401,210,191
Virginia,Surry County,6,397,205,192
Virginia,Surry County,7,323,163,160
Virginia,Surry County,8,271,134,137
Virginia,Surry County,9,360,170,190
Virginia,Surry County,10,494,236,258
Virginia,Surry County,11,686,343,343
Virginia,Surry County,12,640,307,333
Virginia,Surry County,13,528,272,256
Virginia,Surry County,14,445,225,220
Virginia,Surry County,15,355,171,184
Virginia,Surry County,16,212,103,109
Virginia,Surry County,17,138,52,86
Virginia,Surry County,18,149,53,96
Virginia,Sussex County,0,11767,6988,4779
Virginia,Sussex County,1,536,284,252
Virginia,Sussex County,2,472,232,240
Virginia,Sussex County,3,544,263,281
Virginia,Sussex County,4,550,307,243
Virginia,Sussex County,5,962,696,266
Virginia,Sussex County,6,1100,845,255
Virginia,Sussex County,7,885,656,229
Virginia,Sussex County,8,703,513,190
Virginia,Sussex County,9,760,501,259
Virginia,Sussex County,10,865,494,371
Virginia,Sussex County,11,917,539,378
Virginia,Sussex County,12,787,421,366
Virginia,Sussex County,13,778,403,375
Virginia,Sussex County,14,632,298,334
Virginia,Sussex County,15,468,221,247
Virginia,Sussex County,16,340,134,206
Virginia,Sussex County,17,224,95,129
Virginia,Sussex County,18,244,86,158
Virginia,Tazewell County,0,43452,21612,21840
Virginia,Tazewell County,1,2167,1104,1063
Virginia,Tazewell County,2,2366,1169,1197
Virginia,Tazewell County,3,2437,1249,1188
Virginia,Tazewell County,4,2488,1275,1213
Virginia,Tazewell County,5,2610,1383,1227
Virginia,Tazewell County,6,2326,1295,1031
Virginia,Tazewell County,7,2557,1376,1181
Virginia,Tazewell County,8,2677,1444,1233
Virginia,Tazewell County,9,2800,1450,1350
Virginia,Tazewell County,10,2796,1392,1404
Virginia,Tazewell County,11,3098,1502,1596
Virginia,Tazewell County,12,3438,1638,1800
Virginia,Tazewell County,13,3330,1629,1701
Virginia,Tazewell County,14,2864,1397,1467
Virginia,Tazewell County,15,1977,911,1066
Virginia,Tazewell County,16,1472,652,820
Virginia,Tazewell County,17,1090,431,659
Virginia,Tazewell County,18,959,315,644
Virginia,Warren County,0,38987,19443,19544
Virginia,Warren County,1,2272,1179,1093
Virginia,Warren County,2,2509,1284,1225
Virginia,Warren County,3,2496,1232,1264
Virginia,Warren County,4,2487,1258,1229
Virginia,Warren County,5,2552,1302,1250
Virginia,Warren County,6,2425,1273,1152
Virginia,Warren County,7,2303,1153,1150
Virginia,Warren County,8,2160,1085,1075
Virginia,Warren County,9,2555,1259,1296
Virginia,Warren County,10,2913,1487,1426
Virginia,Warren County,11,3299,1671,1628
Virginia,Warren County,12,2953,1487,1466
Virginia,Warren County,13,2393,1213,1180
Virginia,Warren County,14,1998,955,1043
Virginia,Warren County,15,1508,729,779
Virginia,Warren County,16,930,440,490
Virginia,Warren County,17,652,266,386
Virginia,Warren County,18,582,170,412
Virginia,Washington County,0,54729,26969,27760
Virginia,Washington County,1,2678,1354,1324
Virginia,Washington County,2,2795,1397,1398
Virginia,Washington County,3,3128,1558,1570
Virginia,Washington County,4,3138,1669,1469
Virginia,Washington County,5,3179,1627,1552
Virginia,Washington County,6,2860,1537,1323
Virginia,Washington County,7,3026,1538,1488
Virginia,Washington County,8,3045,1557,1488
Virginia,Washington County,9,3600,1781,1819
Virginia,Washington County,10,3714,1873,1841
Virginia,Washington County,11,4252,2060,2192
Virginia,Washington County,12,4228,2035,2193
Virginia,Washington County,13,4000,1945,2055
Virginia,Washington County,14,3731,1820,1911
Virginia,Washington County,15,2850,1346,1504
Virginia,Washington County,16,2124,973,1151
Virginia,Washington County,17,1366,573,793
Virginia,Washington County,18,1015,326,689
Virginia,Westmoreland County,0,17477,8494,8983
Virginia,Westmoreland County,1,942,476,466
Virginia,Westmoreland County,2,851,468,383
Virginia,Westmoreland County,3,888,438,450
Virginia,Westmoreland County,4,900,463,437
Virginia,Westmoreland County,5,963,494,469
Virginia,Westmoreland County,6,987,501,486
Virginia,Westmoreland County,7,892,464,428
Virginia,Westmoreland County,8,777,376,401
Virginia,Westmoreland County,9,880,437,443
Virginia,Westmoreland County,10,996,470,526
Virginia,Westmoreland County,11,1357,620,737
Virginia,Westmoreland County,12,1466,714,752
Virginia,Westmoreland County,13,1434,679,755
Virginia,Westmoreland County,14,1332,607,725
Virginia,Westmoreland County,15,1106,536,570
Virginia,Westmoreland County,16,795,353,442
Virginia,Westmoreland County,17,510,254,256
Virginia,Westmoreland County,18,401,144,257
Virginia,Wise County,0,39935,20700,19235
Virginia,Wise County,1,2167,1089,1078
Virginia,Wise County,2,2167,1136,1031
Virginia,Wise County,3,2243,1123,1120
Virginia,Wise County,4,2507,1370,1137
Virginia,Wise County,5,2998,1659,1339
Virginia,Wise County,6,2835,1674,1161
Virginia,Wise County,7,2555,1476,1079
Virginia,Wise County,8,2456,1328,1128
Virginia,Wise County,9,2697,1398,1299
Virginia,Wise County,10,2624,1410,1214
Virginia,Wise County,11,2676,1385,1291
Virginia,Wise County,12,2938,1448,1490
Virginia,Wise County,13,2719,1325,1394
Virginia,Wise County,14,2273,1103,1170
Virginia,Wise County,15,1562,751,811
Virginia,Wise County,16,1143,512,631
Virginia,Wise County,17,724,297,427
Virginia,Wise County,18,651,216,435
Virginia,Wythe County,0,29121,14245,14876
Virginia,Wythe County,1,1466,760,706
Virginia,Wythe County,2,1659,846,813
Virginia,Wythe County,3,1740,911,829
Virginia,Wythe County,4,1536,816,720
Virginia,Wythe County,5,1570,773,797
Virginia,Wythe County,6,1607,822,785
Virginia,Wythe County,7,1583,781,802
Virginia,Wythe County,8,1666,806,860
Virginia,Wythe County,9,2036,1053,983
Virginia,Wythe County,10,2062,1006,1056
Virginia,Wythe County,11,2138,1017,1121
Virginia,Wythe County,12,2186,1070,1116
Virginia,Wythe County,13,2147,1031,1116
Virginia,Wythe County,14,1830,870,960
Virginia,Wythe County,15,1476,693,783
Virginia,Wythe County,16,1086,488,598
Virginia,Wythe County,17,702,308,394
Virginia,Wythe County,18,631,194,437
Virginia,York County,0,66342,32713,33629
Virginia,York County,1,3523,1764,1759
Virginia,York County,2,4293,2177,2116
Virginia,York County,3,5062,2599,2463
Virginia,York County,4,4892,2561,2331
Virginia,York County,5,4503,2500,2003
Virginia,York County,6,3773,1964,1809
Virginia,York County,7,3815,1879,1936
Virginia,York County,8,3960,1941,2019
Virginia,York County,9,4191,2017,2174
Virginia,York County,10,4692,2194,2498
Virginia,York County,11,5545,2660,2885
Virginia,York County,12,4810,2370,2440
Virginia,York County,13,3619,1732,1887
Virginia,York County,14,3278,1589,1689
Virginia,York County,15,2493,1173,1320
Virginia,York County,16,1705,746,959
Virginia,York County,17,1164,494,670
Virginia,York County,18,1024,353,671
Virginia,Alexandria city,0,150575,72867,77708
Virginia,Alexandria city,1,11334,5801,5533
Virginia,Alexandria city,2,7147,3610,3537
Virginia,Alexandria city,3,5226,2587,2639
Virginia,Alexandria city,4,4815,2471,2344
Virginia,Alexandria city,5,7033,3232,3801
Virginia,Alexandria city,6,16324,7702,8622
Virginia,Alexandria city,7,19165,9318,9847
Virginia,Alexandria city,8,15115,7686,7429
Virginia,Alexandria city,9,12389,6216,6173
Virginia,Alexandria city,10,10490,5147,5343
Virginia,Alexandria city,11,9860,5007,4853
Virginia,Alexandria city,12,8738,4072,4666
Virginia,Alexandria city,13,7707,3467,4240
Virginia,Alexandria city,14,5919,2709,3210
Virginia,Alexandria city,15,3546,1651,1895
Virginia,Alexandria city,16,2187,939,1248
Virginia,Alexandria city,17,1505,613,892
Virginia,Alexandria city,18,2075,639,1436
Virginia,Bristol city,0,17184,8157,9027
Virginia,Bristol city,1,775,405,370
Virginia,Bristol city,2,1004,528,476
Virginia,Bristol city,3,1036,556,480
Virginia,Bristol city,4,913,482,431
Virginia,Bristol city,5,1085,536,549
Virginia,Bristol city,6,1141,577,564
Virginia,Bristol city,7,1057,504,553
Virginia,Bristol city,8,1064,517,547
Virginia,Bristol city,9,1080,543,537
Virginia,Bristol city,10,1086,536,550
Virginia,Bristol city,11,1222,602,620
Virginia,Bristol city,12,1170,543,627
Virginia,Bristol city,13,1139,506,633
Virginia,Bristol city,14,1017,440,577
Virginia,Bristol city,15,828,324,504
Virginia,Bristol city,16,642,276,366
Virginia,Bristol city,17,464,171,293
Virginia,Bristol city,18,461,111,350
Virginia,Buena Vista city,0,6603,3093,3510
Virginia,Buena Vista city,1,414,194,220
Virginia,Buena Vista city,2,379,201,178
Virginia,Buena Vista city,3,379,202,177
Virginia,Buena Vista city,4,563,251,312
Virginia,Buena Vista city,5,621,284,337
Virginia,Buena Vista city,6,442,215,227
Virginia,Buena Vista city,7,380,192,188
Virginia,Buena Vista city,8,334,169,165
Virginia,Buena Vista city,9,333,152,181
Virginia,Buena Vista city,10,414,217,197
Virginia,Buena Vista city,11,389,185,204
Virginia,Buena Vista city,12,404,177,227
Virginia,Buena Vista city,13,389,160,229
Virginia,Buena Vista city,14,390,174,216
Virginia,Buena Vista city,15,303,148,155
Virginia,Buena Vista city,16,200,92,108
Virginia,Buena Vista city,17,135,46,89
Virginia,Buena Vista city,18,134,34,100
Virginia,Charlottesville city,0,45593,22022,23571
Virginia,Charlottesville city,1,2605,1357,1248
Virginia,Charlottesville city,2,1931,992,939
Virginia,Charlottesville city,3,1584,868,716
Virginia,Charlottesville city,4,2513,1207,1306
Virginia,Charlottesville city,5,8868,4239,4629
Virginia,Charlottesville city,6,5441,2653,2788
Virginia,Charlottesville city,7,3930,1959,1971
Virginia,Charlottesville city,8,2796,1414,1382
Virginia,Charlottesville city,9,2365,1154,1211
Virginia,Charlottesville city,10,2375,1150,1225
Virginia,Charlottesville city,11,2257,1044,1213
Virginia,Charlottesville city,12,2353,1106,1247
Virginia,Charlottesville city,13,2263,1064,1199
Virginia,Charlottesville city,14,1529,700,829
Virginia,Charlottesville city,15,986,418,568
Virginia,Charlottesville city,16,690,287,403
Virginia,Charlottesville city,17,542,226,316
Virginia,Charlottesville city,18,565,184,381
Virginia,Chesapeake city,0,233371,114239,119132
Virginia,Chesapeake city,1,14648,7504,7144
Virginia,Chesapeake city,2,15504,7876,7628
Virginia,Chesapeake city,3,16548,8466,8082
Virginia,Chesapeake city,4,16166,8389,7777
Virginia,Chesapeake city,5,16140,8333,7807
Virginia,Chesapeake city,6,16661,8536,8125
Virginia,Chesapeake city,7,16420,8262,8158
Virginia,Chesapeake city,8,15100,7309,7791
Virginia,Chesapeake city,9,15480,7550,7930
Virginia,Chesapeake city,10,15924,7706,8218
Virginia,Chesapeake city,11,18307,8794,9513
Virginia,Chesapeake city,12,16307,7801,8506
Virginia,Chesapeake city,13,12525,5888,6637
Virginia,Chesapeake city,14,9870,4493,5377
Virginia,Chesapeake city,15,6848,3060,3788
Virginia,Chesapeake city,16,4608,2003,2605
Virginia,Chesapeake city,17,3244,1245,1999
Virginia,Chesapeake city,18,3071,1024,2047
Virginia,Colonial Heights city,0,17731,8192,9539
Virginia,Colonial Heights city,1,1267,638,629
Virginia,Colonial Heights city,2,1006,502,504
Virginia,Colonial Heights city,3,1112,542,570
Virginia,Colonial Heights city,4,1111,566,545
Virginia,Colonial Heights city,5,1113,530,583
Virginia,Colonial Heights city,6,1112,550,562
Virginia,Colonial Heights city,7,1021,476,545
Virginia,Colonial Heights city,8,936,428,508
Virginia,Colonial Heights city,9,1033,498,535
Virginia,Colonial Heights city,10,1055,477,578
Virginia,Colonial Heights city,11,1271,625,646
Virginia,Colonial Heights city,12,1155,558,597
Virginia,Colonial Heights city,13,976,428,548
Virginia,Colonial Heights city,14,1003,427,576
Virginia,Colonial Heights city,15,756,318,438
Virginia,Colonial Heights city,16,693,271,422
Virginia,Colonial Heights city,17,491,186,305
Virginia,Colonial Heights city,18,620,172,448
Virginia,Covington city,0,5802,2864,2938
Virginia,Covington city,1,410,204,206
Virginia,Covington city,2,340,173,167
Virginia,Covington city,3,366,179,187
Virginia,Covington city,4,315,168,147
Virginia,Covington city,5,354,180,174
Virginia,Covington city,6,349,187,162
Virginia,Covington city,7,315,156,159
Virginia,Covington city,8,309,166,143
Virginia,Covington city,9,351,173,178
Virginia,Covington city,10,380,185,195
Virginia,Covington city,11,456,240,216
Virginia,Covington city,12,429,217,212
Virginia,Covington city,13,329,164,165
Virginia,Covington city,14,370,170,200
Virginia,Covington city,15,265,121,144
Virginia,Covington city,16,183,76,107
Virginia,Covington city,17,126,47,79
Virginia,Covington city,18,155,58,97
Virginia,Danville city,0,42444,19601,22843
Virginia,Danville city,1,2922,1511,1411
Virginia,Danville city,2,2613,1276,1337
Virginia,Danville city,3,2470,1280,1190
Virginia,Danville city,4,2435,1248,1187
Virginia,Danville city,5,2934,1427,1507
Virginia,Danville city,6,2801,1358,1443
Virginia,Danville city,7,2255,1071,1184
Virginia,Danville city,8,2027,944,1083
Virginia,Danville city,9,2194,1035,1159
Virginia,Danville city,10,2523,1144,1379
Virginia,Danville city,11,2782,1284,1498
Virginia,Danville city,12,3219,1441,1778
Virginia,Danville city,13,2890,1357,1533
Virginia,Danville city,14,2553,1114,1439
Virginia,Danville city,15,1809,759,1050
Virginia,Danville city,16,1459,552,907
Virginia,Danville city,17,1172,410,762
Virginia,Danville city,18,1386,390,996
Virginia,Emporia city,0,5462,2524,2938
Virginia,Emporia city,1,227,118,109
Virginia,Emporia city,2,417,231,186
Virginia,Emporia city,3,444,238,206
Virginia,Emporia city,4,330,154,176
Virginia,Emporia city,5,381,186,195
Virginia,Emporia city,6,318,140,178
Virginia,Emporia city,7,351,145,206
Virginia,Emporia city,8,307,142,165
Virginia,Emporia city,9,319,136,183
Virginia,Emporia city,10,353,176,177
Virginia,Emporia city,11,366,153,213
Virginia,Emporia city,12,383,185,198
Virginia,Emporia city,13,312,162,150
Virginia,Emporia city,14,259,100,159
Virginia,Emporia city,15,216,100,116
Virginia,Emporia city,16,156,63,93
Virginia,Emporia city,17,137,48,89
Virginia,Emporia city,18,186,47,139
Virginia,Fairfax city,0,24483,12058,12425
Virginia,Fairfax city,1,2194,1086,1108
Virginia,Fairfax city,2,1321,683,638
Virginia,Fairfax city,3,1367,687,680
Virginia,Fairfax city,4,1338,644,694
Virginia,Fairfax city,5,1574,817,757
Virginia,Fairfax city,6,1785,979,806
Virginia,Fairfax city,7,1684,906,778
Virginia,Fairfax city,8,1513,742,771
Virginia,Fairfax city,9,1575,818,757
Virginia,Fairfax city,10,1569,771,798
Virginia,Fairfax city,11,1774,866,908
Virginia,Fairfax city,12,1680,856,824
Virginia,Fairfax city,13,1328,612,716
Virginia,Fairfax city,14,1195,556,639
Virginia,Fairfax city,15,856,381,475
Virginia,Fairfax city,16,628,256,372
Virginia,Fairfax city,17,469,190,279
Virginia,Fairfax city,18,633,208,425
Virginia,Falls Church city,0,13601,6665,6936
Virginia,Falls Church city,1,991,563,428
Virginia,Falls Church city,2,1005,511,494
Virginia,Falls Church city,3,1017,529,488
Virginia,Falls Church city,4,930,446,484
Virginia,Falls Church city,5,591,310,281
Virginia,Falls Church city,6,729,340,389
Virginia,Falls Church city,7,894,446,448
Virginia,Falls Church city,8,931,452,479
Virginia,Falls Church city,9,1071,516,555
Virginia,Falls Church city,10,1059,511,548
Virginia,Falls Church city,11,1049,521,528
Virginia,Falls Church city,12,941,433,508
Virginia,Falls Church city,13,841,408,433
Virginia,Falls Church city,14,598,278,320
Virginia,Falls Church city,15,339,145,194
Virginia,Falls Church city,16,261,111,150
Virginia,Falls Church city,17,166,78,88
Virginia,Falls Church city,18,188,67,121
Virginia,Franklin city,0,8526,3841,4685
Virginia,Franklin city,1,751,363,388
Virginia,Franklin city,2,591,328,263
Virginia,Franklin city,3,601,303,298
Virginia,Franklin city,4,458,220,238
Virginia,Franklin city,5,540,247,293
Virginia,Franklin city,6,518,230,288
Virginia,Franklin city,7,464,204,260
Virginia,Franklin city,8,403,198,205
Virginia,Franklin city,9,460,194,266
Virginia,Franklin city,10,478,207,271
Virginia,Franklin city,11,577,231,346
Virginia,Franklin city,12,650,261,389
Virginia,Franklin city,13,547,244,303
Virginia,Franklin city,14,485,236,249
Virginia,Franklin city,15,329,150,179
Virginia,Franklin city,16,242,91,151
Virginia,Franklin city,17,168,67,101
Virginia,Franklin city,18,264,67,197
Virginia,Fredericksburg city,0,28350,12897,15453
Virginia,Fredericksburg city,1,2050,986,1064
Virginia,Fredericksburg city,2,1614,801,813
Virginia,Fredericksburg city,3,1337,684,653
Virginia,Fredericksburg city,4,2521,1007,1514
Virginia,Fredericksburg city,5,4046,1575,2471
Virginia,Fredericksburg city,6,2591,1247,1344
Virginia,Fredericksburg city,7,2135,1025,1110
Virginia,Fredericksburg city,8,1733,841,892
Virginia,Fredericksburg city,9,1656,833,823
Virginia,Fredericksburg city,10,1592,742,850
Virginia,Fredericksburg city,11,1615,789,826
Virginia,Fredericksburg city,12,1426,695,731
Virginia,Fredericksburg city,13,1174,526,648
Virginia,Fredericksburg city,14,960,428,532
Virginia,Fredericksburg city,15,644,276,368
Virginia,Fredericksburg city,16,478,194,284
Virginia,Fredericksburg city,17,389,138,251
Virginia,Fredericksburg city,18,389,110,279
Virginia,Galax city,0,7014,3295,3719
Virginia,Galax city,1,520,263,257
Virginia,Galax city,2,426,212,214
Virginia,Galax city,3,429,213,216
Virginia,Galax city,4,466,242,224
Virginia,Galax city,5,401,200,201
Virginia,Galax city,6,382,177,205
Virginia,Galax city,7,364,179,185
Virginia,Galax city,8,355,173,182
Virginia,Galax city,9,413,221,192
Virginia,Galax city,10,500,237,263
Virginia,Galax city,11,405,202,203
Virginia,Galax city,12,509,248,261
Virginia,Galax city,13,441,212,229
Virginia,Galax city,14,389,157,232
Virginia,Galax city,15,306,113,193
Virginia,Galax city,16,224,102,122
Virginia,Galax city,17,206,68,138
Virginia,Galax city,18,278,76,202
Virginia,Hampton city,0,136879,65862,71017
Virginia,Hampton city,1,8556,4361,4195
Virginia,Hampton city,2,8215,4230,3985
Virginia,Hampton city,3,8123,4169,3954
Virginia,Hampton city,4,9111,4562,4549
Virginia,Hampton city,5,12289,6414,5875
Virginia,Hampton city,6,11664,5924,5740
Virginia,Hampton city,7,9758,4766,4992
Virginia,Hampton city,8,7725,3678,4047
Virginia,Hampton city,9,7303,3378,3925
Virginia,Hampton city,10,7929,3623,4306
Virginia,Hampton city,11,10074,4759,5315
Virginia,Hampton city,12,9674,4589,5085
Virginia,Hampton city,13,7715,3570,4145
Virginia,Hampton city,14,6217,2802,3415
Virginia,Hampton city,15,4585,2015,2570
Virginia,Hampton city,16,3428,1422,2006
Virginia,Hampton city,17,2406,935,1471
Virginia,Hampton city,18,2107,665,1442
Virginia,Harrisonburg city,0,52478,25118,27360
Virginia,Harrisonburg city,1,2781,1420,1361
Virginia,Harrisonburg city,2,2371,1212,1159
Virginia,Harrisonburg city,3,2127,1066,1061
Virginia,Harrisonburg city,4,7163,2803,4360
Virginia,Harrisonburg city,5,12065,5808,6257
Virginia,Harrisonburg city,6,4747,2445,2302
Virginia,Harrisonburg city,7,3433,1814,1619
Virginia,Harrisonburg city,8,2781,1432,1349
Virginia,Harrisonburg city,9,2330,1194,1136
Virginia,Harrisonburg city,10,2228,1136,1092
Virginia,Harrisonburg city,11,2251,1103,1148
Virginia,Harrisonburg city,12,2098,1040,1058
Virginia,Harrisonburg city,13,1847,893,954
Virginia,Harrisonburg city,14,1261,570,691
Virginia,Harrisonburg city,15,898,399,499
Virginia,Harrisonburg city,16,708,301,407
Virginia,Harrisonburg city,17,588,232,356
Virginia,Harrisonburg city,18,801,250,551
Virginia,Hopewell city,0,22196,10358,11838
Virginia,Hopewell city,1,1672,896,776
Virginia,Hopewell city,2,1630,817,813
Virginia,Hopewell city,3,1500,757,743
Virginia,Hopewell city,4,1262,673,589
Virginia,Hopewell city,5,1503,713,790
Virginia,Hopewell city,6,1567,727,840
Virginia,Hopewell city,7,1560,707,853
Virginia,Hopewell city,8,1241,601,640
Virginia,Hopewell city,9,1307,614,693
Virginia,Hopewell city,10,1411,645,766
Virginia,Hopewell city,11,1499,659,840
Virginia,Hopewell city,12,1353,623,730
Virginia,Hopewell city,13,1202,538,664
Virginia,Hopewell city,14,1100,507,593
Virginia,Hopewell city,15,836,357,479
Virginia,Hopewell city,16,624,247,377
Virginia,Hopewell city,17,437,159,278
Virginia,Hopewell city,18,492,118,374
Virginia,Lexington city,0,7311,4064,3247
Virginia,Lexington city,1,272,142,130
Virginia,Lexington city,2,231,105,126
Virginia,Lexington city,3,240,129,111
Virginia,Lexington city,4,1433,905,528
Virginia,Lexington city,5,2030,1400,630
Virginia,Lexington city,6,350,178,172
Virginia,Lexington city,7,266,129,137
Virginia,Lexington city,8,235,107,128
Virginia,Lexington city,9,205,100,105
Virginia,Lexington city,10,211,109,102
Virginia,Lexington city,11,236,106,130
Virginia,Lexington city,12,266,122,144
Virginia,Lexington city,13,303,135,168
Virginia,Lexington city,14,268,122,146
Virginia,Lexington city,15,221,98,123
Virginia,Lexington city,16,168,64,104
Virginia,Lexington city,17,164,52,112
Virginia,Lexington city,18,212,61,151
Virginia,Lynchburg city,0,79047,36968,42079
Virginia,Lynchburg city,1,5115,2562,2553
Virginia,Lynchburg city,2,4301,2236,2065
Virginia,Lynchburg city,3,3962,1940,2022
Virginia,Lynchburg city,4,8066,3661,4405
Virginia,Lynchburg city,5,13431,6363,7068
Virginia,Lynchburg city,6,5981,3005,2976
Virginia,Lynchburg city,7,4390,2144,2246
Virginia,Lynchburg city,8,3577,1706,1871
Virginia,Lynchburg city,9,3484,1685,1799
Virginia,Lynchburg city,10,3655,1694,1961
Virginia,Lynchburg city,11,4097,1923,2174
Virginia,Lynchburg city,12,4133,1912,2221
Virginia,Lynchburg city,13,3755,1709,2046
Virginia,Lynchburg city,14,3209,1409,1800
Virginia,Lynchburg city,15,2388,1062,1326
Virginia,Lynchburg city,16,1899,755,1144
Virginia,Lynchburg city,17,1554,592,962
Virginia,Lynchburg city,18,2050,610,1440
Virginia,Manassas city,0,42081,21186,20895
Virginia,Manassas city,1,3630,1857,1773
Virginia,Manassas city,2,3205,1685,1520
Virginia,Manassas city,3,2803,1410,1393
Virginia,Manassas city,4,2777,1454,1323
Virginia,Manassas city,5,2989,1551,1438
Virginia,Manassas city,6,3342,1720,1622
Virginia,Manassas city,7,3510,1843,1667
Virginia,Manassas city,8,3221,1669,1552
Virginia,Manassas city,9,2893,1483,1410
Virginia,Manassas city,10,2755,1343,1412
Virginia,Manassas city,11,2957,1421,1536
Virginia,Manassas city,12,2613,1275,1338
Virginia,Manassas city,13,1951,978,973
Virginia,Manassas city,14,1311,619,692
Virginia,Manassas city,15,836,401,435
Virginia,Manassas city,16,568,248,320
Virginia,Manassas city,17,345,136,209
Virginia,Manassas city,18,375,93,282
Virginia,Manassas Park city,0,15174,7726,7448
Virginia,Manassas Park city,1,771,423,348
Virginia,Manassas Park city,2,1261,648,613
Virginia,Manassas Park city,3,1160,595,565
Virginia,Manassas Park city,4,883,426,457
Virginia,Manassas Park city,5,927,478,449
Virginia,Manassas Park city,6,1375,694,681
Virginia,Manassas Park city,7,1463,753,710
Virginia,Manassas Park city,8,1356,686,670
Virginia,Manassas Park city,9,1243,658,585
Virginia,Manassas Park city,10,1156,639,517
Virginia,Manassas Park city,11,1030,536,494
Virginia,Manassas Park city,12,849,442,407
Virginia,Manassas Park city,13,565,277,288
Virginia,Manassas Park city,14,446,202,244
Virginia,Manassas Park city,15,262,109,153
Virginia,Manassas Park city,16,201,72,129
Virginia,Manassas Park city,17,126,58,68
Virginia,Manassas Park city,18,100,30,70
Virginia,Martinsville city,0,13711,6306,7405
Virginia,Martinsville city,1,1022,553,469
Virginia,Martinsville city,2,891,425,466
Virginia,Martinsville city,3,798,417,381
Virginia,Martinsville city,4,752,381,371
Virginia,Martinsville city,5,752,340,412
Virginia,Martinsville city,6,789,388,401
Virginia,Martinsville city,7,719,332,387
Virginia,Martinsville city,8,665,319,346
Virginia,Martinsville city,9,807,375,432
Virginia,Martinsville city,10,893,410,483
Virginia,Martinsville city,11,999,472,527
Virginia,Martinsville city,12,978,427,551
Virginia,Martinsville city,13,843,369,474
Virginia,Martinsville city,14,792,363,429
Virginia,Martinsville city,15,656,272,384
Virginia,Martinsville city,16,514,212,302
Virginia,Martinsville city,17,402,136,266
Virginia,Martinsville city,18,439,115,324
Virginia,Newport News city,0,182965,88626,94339
Virginia,Newport News city,1,13412,6805,6607
Virginia,Newport News city,2,12224,6236,5988
Virginia,Newport News city,3,10982,5577,5405
Virginia,Newport News city,4,12569,6429,6140
Virginia,Newport News city,5,17304,8904,8400
Virginia,Newport News city,6,16831,8365,8466
Virginia,Newport News city,7,14319,7190,7129
Virginia,Newport News city,8,10965,5422,5543
Virginia,Newport News city,9,10209,4861,5348
Virginia,Newport News city,10,10440,4938,5502
Virginia,Newport News city,11,12271,5826,6445
Virginia,Newport News city,12,11452,5432,6020
Virginia,Newport News city,13,8715,3971,4744
Virginia,Newport News city,14,6944,3119,3825
Virginia,Newport News city,15,5045,2202,2843
Virginia,Newport News city,16,3723,1494,2229
Virginia,Newport News city,17,2803,1043,1760
Virginia,Newport News city,18,2757,812,1945
Virginia,Norfolk city,0,245428,128003,117425
Virginia,Norfolk city,1,17040,8822,8218
Virginia,Norfolk city,2,14173,7324,6849
Virginia,Norfolk city,3,12126,6164,5962
Virginia,Norfolk city,4,15627,8210,7417
Virginia,Norfolk city,5,36648,22701,13947
Virginia,Norfolk city,6,26746,14917,11829
Virginia,Norfolk city,7,19766,10700,9066
Virginia,Norfolk city,8,14599,7975,6624
Virginia,Norfolk city,9,12368,6343,6025
Virginia,Norfolk city,10,12417,6109,6308
Virginia,Norfolk city,11,14287,6816,7471
Virginia,Norfolk city,12,14032,6547,7485
Virginia,Norfolk city,13,11198,5264,5934
Virginia,Norfolk city,14,8286,3757,4529
Virginia,Norfolk city,15,5411,2309,3102
Virginia,Norfolk city,16,3968,1621,2347
Virginia,Norfolk city,17,3081,1158,1923
Virginia,Norfolk city,18,3655,1266,2389
Virginia,Norton city,0,4031,1908,2123
Virginia,Norton city,1,227,112,115
Virginia,Norton city,2,261,118,143
Virginia,Norton city,3,291,153,138
Virginia,Norton city,4,232,121,111
Virginia,Norton city,5,296,130,166
Virginia,Norton city,6,310,172,138
Virginia,Norton city,7,261,129,132
Virginia,Norton city,8,243,116,127
Virginia,Norton city,9,232,112,120
Virginia,Norton city,10,244,117,127
Virginia,Norton city,11,266,127,139
Virginia,Norton city,12,282,131,151
Virginia,Norton city,13,291,125,166
Virginia,Norton city,14,183,79,104
Virginia,Norton city,15,138,62,76
Virginia,Norton city,16,115,43,72
Virginia,Norton city,17,79,36,43
Virginia,Norton city,18,80,25,55
Virginia,Petersburg city,0,32701,15112,17589
Virginia,Petersburg city,1,2731,1350,1381
Virginia,Petersburg city,2,1882,970,912
Virginia,Petersburg city,3,1630,835,795
Virginia,Petersburg city,4,1612,819,793
Virginia,Petersburg city,5,2874,1310,1564
Virginia,Petersburg city,6,2778,1272,1506
Virginia,Petersburg city,7,1907,936,971
Virginia,Petersburg city,8,1556,753,803
Virginia,Petersburg city,9,1682,805,877
Virginia,Petersburg city,10,2177,1009,1168
Virginia,Petersburg city,11,2416,1146,1270
Virginia,Petersburg city,12,2413,1065,1348
Virginia,Petersburg city,13,2055,913,1142
Virginia,Petersburg city,14,1618,704,914
Virginia,Petersburg city,15,1173,496,677
Virginia,Petersburg city,16,834,334,500
Virginia,Petersburg city,17,632,210,422
Virginia,Petersburg city,18,731,185,546
Virginia,Poquoson city,0,12048,5964,6084
Virginia,Poquoson city,1,436,211,225
Virginia,Poquoson city,2,701,346,355
Virginia,Poquoson city,3,875,464,411
Virginia,Poquoson city,4,908,493,415
Virginia,Poquoson city,5,741,383,358
Virginia,Poquoson city,6,502,293,209
Virginia,Poquoson city,7,618,293,325
Virginia,Poquoson city,8,629,299,330
Virginia,Poquoson city,9,808,387,421
Virginia,Poquoson city,10,900,443,457
Virginia,Poquoson city,11,1066,525,541
Virginia,Poquoson city,12,882,426,456
Virginia,Poquoson city,13,782,388,394
Virginia,Poquoson city,14,736,357,379
Virginia,Poquoson city,15,566,270,296
Virginia,Poquoson city,16,429,196,233
Virginia,Poquoson city,17,258,119,139
Virginia,Poquoson city,18,211,71,140
Virginia,Portsmouth city,0,96004,46079,49925
Virginia,Portsmouth city,1,7269,3659,3610
Virginia,Portsmouth city,2,6336,3169,3167
Virginia,Portsmouth city,3,5676,2861,2815
Virginia,Portsmouth city,4,5238,2732,2506
Virginia,Portsmouth city,5,7826,4068,3758
Virginia,Portsmouth city,6,8349,4242,4107
Virginia,Portsmouth city,7,7415,3699,3716
Virginia,Portsmouth city,8,5810,2875,2935
Virginia,Portsmouth city,9,5173,2511,2662
Virginia,Portsmouth city,10,5470,2556,2914
Virginia,Portsmouth city,11,6420,3020,3400
Virginia,Portsmouth city,12,6209,2834,3375
Virginia,Portsmouth city,13,5490,2482,3008
Virginia,Portsmouth city,14,4265,1891,2374
Virginia,Portsmouth city,15,3054,1277,1777
Virginia,Portsmouth city,16,2329,918,1411
Virginia,Portsmouth city,17,1694,665,1029
Virginia,Portsmouth city,18,1981,620,1361
Virginia,Radford city,0,17646,8377,9269
Virginia,Radford city,1,676,317,359
Virginia,Radford city,2,640,319,321
Virginia,Radford city,3,648,325,323
Virginia,Radford city,4,2816,1208,1608
Virginia,Radford city,5,4950,2336,2614
Virginia,Radford city,6,1385,756,629
Virginia,Radford city,7,794,408,386
Virginia,Radford city,8,764,365,399
Virginia,Radford city,9,742,388,354
Virginia,Radford city,10,701,350,351
Virginia,Radford city,11,724,352,372
Virginia,Radford city,12,722,347,375
Virginia,Radford city,13,691,317,374
Virginia,Radford city,14,408,198,210
Virginia,Radford city,15,341,144,197
Virginia,Radford city,16,253,112,141
Virginia,Radford city,17,174,73,101
Virginia,Radford city,18,217,62,155
Virginia,Richmond city,0,217853,103882,113971
Virginia,Richmond city,1,13734,7029,6705
Virginia,Richmond city,2,11370,5694,5676
Virginia,Richmond city,3,9644,4811,4833
Virginia,Richmond city,4,13853,6523,7330
Virginia,Richmond city,5,21860,10259,11601
Virginia,Richmond city,6,25985,12703,13282
Virginia,Richmond city,7,19273,9683,9590
Virginia,Richmond city,8,12969,6557,6412
Virginia,Richmond city,9,11863,5860,6003
Virginia,Richmond city,10,12336,5959,6377
Virginia,Richmond city,11,13808,6488,7320
Virginia,Richmond city,12,13824,6445,7379
Virginia,Richmond city,13,12459,5753,6706
Virginia,Richmond city,14,8616,3913,4703
Virginia,Richmond city,15,5384,2293,3091
Virginia,Richmond city,16,3864,1527,2337
Virginia,Richmond city,17,3001,1104,1897
Virginia,Richmond city,18,4010,1281,2729
Virginia,Roanoke city,0,99428,47470,51958
Virginia,Roanoke city,1,7155,3647,3508
Virginia,Roanoke city,2,6340,3242,3098
Virginia,Roanoke city,3,5399,2742,2657
Virginia,Roanoke city,4,4830,2449,2381
Virginia,Roanoke city,5,6648,3196,3452
Virginia,Roanoke city,6,7995,3807,4188
Virginia,Roanoke city,7,7335,3670,3665
Virginia,Roanoke city,8,6215,3098,3117
Virginia,Roanoke city,9,6236,3075,3161
Virginia,Roanoke city,10,6385,3197,3188
Virginia,Roanoke city,11,6879,3318,3561
Virginia,Roanoke city,12,6885,3292,3593
Virginia,Roanoke city,13,6356,2884,3472
Virginia,Roanoke city,14,4903,2176,2727
Virginia,Roanoke city,15,3202,1384,1818
Virginia,Roanoke city,16,2303,893,1410
Virginia,Roanoke city,17,1837,657,1180
Virginia,Roanoke city,18,2525,743,1782
Virginia,Salem city,0,25483,12180,13303
Virginia,Salem city,1,1361,718,643
Virginia,Salem city,2,1285,646,639
Virginia,Salem city,3,1474,740,734
Virginia,Salem city,4,2172,1082,1090
Virginia,Salem city,5,2250,1050,1200
Virginia,Salem city,6,1604,842,762
Virginia,Salem city,7,1360,686,674
Virginia,Salem city,8,1246,599,647
Virginia,Salem city,9,1516,724,792
Virginia,Salem city,10,1605,762,843
Virginia,Salem city,11,1743,832,911
Virginia,Salem city,12,1879,917,962
Virginia,Salem city,13,1639,756,883
Virginia,Salem city,14,1369,634,735
Virginia,Salem city,15,992,438,554
Virginia,Salem city,16,757,321,436
Virginia,Salem city,17,649,265,384
Virginia,Salem city,18,582,168,414
Virginia,Staunton city,0,24538,11048,13490
Virginia,Staunton city,1,1415,783,632
Virginia,Staunton city,2,1293,652,641
Virginia,Staunton city,3,1185,619,566
Virginia,Staunton city,4,1473,509,964
Virginia,Staunton city,5,1802,601,1201
Virginia,Staunton city,6,1589,707,882
Virginia,Staunton city,7,1628,815,813
Virginia,Staunton city,8,1410,689,721
Virginia,Staunton city,9,1354,661,693
Virginia,Staunton city,10,1413,672,741
Virginia,Staunton city,11,1624,798,826
Virginia,Staunton city,12,1656,738,918
Virginia,Staunton city,13,1638,753,885
Virginia,Staunton city,14,1519,701,818
Virginia,Staunton city,15,1180,498,682
Virginia,Staunton city,16,908,371,537
Virginia,Staunton city,17,680,249,431
Virginia,Staunton city,18,771,232,539
Virginia,Suffolk city,0,86806,41948,44858
Virginia,Suffolk city,1,5582,2870,2712
Virginia,Suffolk city,2,6198,3134,3064
Virginia,Suffolk city,3,6261,3161,3100
Virginia,Suffolk city,4,5517,2841,2676
Virginia,Suffolk city,5,5310,2652,2658
Virginia,Suffolk city,6,5584,2809,2775
Virginia,Suffolk city,7,5872,2770,3102
Virginia,Suffolk city,8,5505,2582,2923
Virginia,Suffolk city,9,5993,2868,3125
Virginia,Suffolk city,10,6160,2863,3297
Virginia,Suffolk city,11,6820,3279,3541
Virginia,Suffolk city,12,5986,2899,3087
Virginia,Suffolk city,13,4762,2322,2440
Virginia,Suffolk city,14,3955,1839,2116
Virginia,Suffolk city,15,2832,1272,1560
Virginia,Suffolk city,16,1873,829,1044
Virginia,Suffolk city,17,1240,505,735
Virginia,Suffolk city,18,1356,453,903
Virginia,Virginia Beach city,0,450980,221835,229145
Virginia,Virginia Beach city,1,30057,15559,14498
Virginia,Virginia Beach city,2,28181,14376,13805
Virginia,Virginia Beach city,3,27914,14278,13636
Virginia,Virginia Beach city,4,27537,14181,13356
Virginia,Virginia Beach city,5,35670,18813,16857
Virginia,Virginia Beach city,6,39901,20867,19034
Virginia,Virginia Beach city,7,35623,18045,17578
Virginia,Virginia Beach city,8,29322,14926,14396
Virginia,Virginia Beach city,9,28484,13904,14580
Virginia,Virginia Beach city,10,29162,13868,15294
Virginia,Virginia Beach city,11,31850,15222,16628
Virginia,Virginia Beach city,12,28511,13485,15026
Virginia,Virginia Beach city,13,23275,10631,12644
Virginia,Virginia Beach city,14,19205,8727,10478
Virginia,Virginia Beach city,15,13368,5955,7413
Virginia,Virginia Beach city,16,9205,3946,5259
Virginia,Virginia Beach city,17,6884,2748,4136
Virginia,Virginia Beach city,18,6831,2304,4527
Virginia,Waynesboro city,0,21366,10125,11241
Virginia,Waynesboro city,1,1598,793,805
Virginia,Waynesboro city,2,1431,754,677
Virginia,Waynesboro city,3,1294,678,616
Virginia,Waynesboro city,4,1134,553,581
Virginia,Waynesboro city,5,1311,654,657
Virginia,Waynesboro city,6,1496,730,766
Virginia,Waynesboro city,7,1527,746,781
Virginia,Waynesboro city,8,1280,620,660
Virginia,Waynesboro city,9,1240,603,637
Virginia,Waynesboro city,10,1225,579,646
Virginia,Waynesboro city,11,1452,659,793
Virginia,Waynesboro city,12,1452,680,772
Virginia,Waynesboro city,13,1214,522,692
Virginia,Waynesboro city,14,1131,514,617
Virginia,Waynesboro city,15,907,393,514
Virginia,Waynesboro city,16,649,258,391
Virginia,Waynesboro city,17,499,203,296
Virginia,Waynesboro city,18,526,186,340
Virginia,Williamsburg city,0,14691,6832,7859
Virginia,Williamsburg city,1,475,232,243
Virginia,Williamsburg city,2,419,219,200
Virginia,Williamsburg city,3,392,206,186
Virginia,Williamsburg city,4,2441,1066,1375
Virginia,Williamsburg city,5,3348,1519,1829
Virginia,Williamsburg city,6,1139,611,528
Virginia,Williamsburg city,7,701,349,352
Virginia,Williamsburg city,8,523,233,290
Virginia,Williamsburg city,9,496,243,253
Virginia,Williamsburg city,10,527,232,295
Virginia,Williamsburg city,11,611,278,333
Virginia,Williamsburg city,12,651,307,344
Virginia,Williamsburg city,13,650,302,348
Virginia,Williamsburg city,14,695,311,384
Virginia,Williamsburg city,15,588,286,302
Virginia,Williamsburg city,16,476,213,263
Virginia,Williamsburg city,17,303,149,154
Virginia,Williamsburg city,18,256,76,180
Virginia,Winchester city,0,27543,13650,13893
Virginia,Winchester city,1,1855,911,944
Virginia,Winchester city,2,1735,911,824
Virginia,Winchester city,3,1685,859,826
Virginia,Winchester city,4,1900,950,950
Virginia,Winchester city,5,2102,1035,1067
Virginia,Winchester city,6,2197,1143,1054
Virginia,Winchester city,7,1802,963,839
Virginia,Winchester city,8,1671,875,796
Virginia,Winchester city,9,1634,829,805
Virginia,Winchester city,10,1707,840,867
Virginia,Winchester city,11,1909,960,949
Virginia,Winchester city,12,1714,830,884
Virginia,Winchester city,13,1604,772,832
Virginia,Winchester city,14,1255,620,635
Virginia,Winchester city,15,924,408,516
Virginia,Winchester city,16,708,307,401
Virginia,Winchester city,17,563,223,340
Virginia,Winchester city,18,578,214,364
Washington,Adams County,0,19179,9757,9422
Washington,Adams County,1,2031,1037,994
Washington,Adams County,2,2000,1070,930
Washington,Adams County,3,1718,856,862
Washington,Adams County,4,1579,805,774
Washington,Adams County,5,1434,758,676
Washington,Adams County,6,1152,598,554
Washington,Adams County,7,1140,558,582
Washington,Adams County,8,1198,609,589
Washington,Adams County,9,1070,557,513
Washington,Adams County,10,1010,524,486
Washington,Adams County,11,1015,517,498
Washington,Adams County,12,993,488,505
Washington,Adams County,13,877,444,433
Washington,Adams County,14,647,322,325
Washington,Adams County,15,462,242,220
Washington,Adams County,16,342,160,182
Washington,Adams County,17,229,98,131
Washington,Adams County,18,282,114,168
Washington,Asotin County,0,22189,10688,11501
Washington,Asotin County,1,1207,568,639
Washington,Asotin County,2,1306,637,669
Washington,Asotin County,3,1328,623,705
Washington,Asotin County,4,1228,620,608
Washington,Asotin County,5,1272,640,632
Washington,Asotin County,6,1271,627,644
Washington,Asotin County,7,1300,635,665
Washington,Asotin County,8,1185,583,602
Washington,Asotin County,9,1198,592,606
Washington,Asotin County,10,1269,618,651
Washington,Asotin County,11,1580,749,831
Washington,Asotin County,12,1762,805,957
Washington,Asotin County,13,1650,824,826
Washington,Asotin County,14,1414,659,755
Washington,Asotin County,15,1168,565,603
Washington,Asotin County,16,876,438,438
Washington,Asotin County,17,564,256,308
Washington,Asotin County,18,611,249,362
Washington,Benton County,0,186486,93562,92924
Washington,Benton County,1,13499,6862,6637
Washington,Benton County,2,13979,7129,6850
Washington,Benton County,3,13880,7142,6738
Washington,Benton County,4,12865,6793,6072
Washington,Benton County,5,12239,6307,5932
Washington,Benton County,6,12400,6309,6091
Washington,Benton County,7,12809,6562,6247
Washington,Benton County,8,11319,5757,5562
Washington,Benton County,9,10984,5482,5502
Washington,Benton County,10,11255,5551,5704
Washington,Benton County,11,12605,6203,6402
Washington,Benton County,12,12489,6225,6264
Washington,Benton County,13,11181,5626,5555
Washington,Benton County,14,8783,4355,4428
Washington,Benton County,15,6106,2969,3137
Washington,Benton County,16,4166,1949,2217
Washington,Benton County,17,2846,1237,1609
Washington,Benton County,18,3081,1104,1977
Washington,Chelan County,0,74588,37183,37405
Washington,Chelan County,1,5086,2544,2542
Washington,Chelan County,2,5013,2598,2415
Washington,Chelan County,3,4980,2563,2417
Washington,Chelan County,4,4754,2431,2323
Washington,Chelan County,5,4635,2405,2230
Washington,Chelan County,6,4415,2264,2151
Washington,Chelan County,7,4544,2326,2218
Washington,Chelan County,8,4204,2076,2128
Washington,Chelan County,9,4056,2018,2038
Washington,Chelan County,10,4302,2177,2125
Washington,Chelan County,11,5120,2526,2594
Washington,Chelan County,12,5387,2611,2776
Washington,Chelan County,13,5068,2554,2514
Washington,Chelan County,14,4229,2102,2127
Washington,Chelan County,15,3097,1491,1606
Washington,Chelan County,16,2208,1072,1136
Washington,Chelan County,17,1574,708,866
Washington,Chelan County,18,1916,717,1199
Washington,Clallam County,0,72715,36108,36607
Washington,Clallam County,1,3398,1726,1672
Washington,Clallam County,2,3444,1784,1660
Washington,Clallam County,3,3600,1815,1785
Washington,Clallam County,4,3657,1931,1726
Washington,Clallam County,5,3823,2164,1659
Washington,Clallam County,6,3962,2136,1826
Washington,Clallam County,7,3721,1990,1731
Washington,Clallam County,8,3473,1805,1668
Washington,Clallam County,9,3409,1722,1687
Washington,Clallam County,10,3584,1783,1801
Washington,Clallam County,11,4816,2303,2513
Washington,Clallam County,12,5759,2772,2987
Washington,Clallam County,13,6530,3014,3516
Washington,Clallam County,14,6164,2936,3228
Washington,Clallam County,15,4910,2373,2537
Washington,Clallam County,16,3401,1681,1720
Washington,Clallam County,17,2366,1089,1277
Washington,Clallam County,18,2698,1084,1614
Washington,Clark County,0,451008,223474,227534
Washington,Clark County,1,28482,14599,13883
Washington,Clark County,2,31918,16202,15716
Washington,Clark County,3,33214,17053,16161
Washington,Clark County,4,30557,15836,14721
Washington,Clark County,5,27261,14096,13165
Washington,Clark County,6,28070,14150,13920
Washington,Clark County,7,29418,14491,14927
Washington,Clark County,8,30111,14916,15195
Washington,Clark County,9,30833,15391,15442
Washington,Clark County,10,29977,14951,15026
Washington,Clark County,11,31716,15583,16133
Washington,Clark County,12,30146,14856,15290
Washington,Clark County,13,27255,13010,14245
Washington,Clark County,14,23036,10944,12092
Washington,Clark County,15,15467,7452,8015
Washington,Clark County,16,9746,4600,5146
Washington,Clark County,17,6499,2799,3700
Washington,Clark County,18,7302,2545,4757
Washington,Columbia County,0,3985,1991,1994
Washington,Columbia County,1,147,83,64
Washington,Columbia County,2,206,106,100
Washington,Columbia County,3,227,112,115
Washington,Columbia County,4,250,117,133
Washington,Columbia County,5,178,96,82
Washington,Columbia County,6,152,79,73
Washington,Columbia County,7,200,93,107
Washington,Columbia County,8,185,102,83
Washington,Columbia County,9,194,98,96
Washington,Columbia County,10,234,119,115
Washington,Columbia County,11,300,147,153
Washington,Columbia County,12,285,145,140
Washington,Columbia County,13,365,176,189
Washington,Columbia County,14,325,158,167
Washington,Columbia County,15,288,144,144
Washington,Columbia County,16,189,103,86
Washington,Columbia County,17,112,52,60
Washington,Columbia County,18,148,61,87
Washington,Cowlitz County,0,102133,50642,51491
Washington,Cowlitz County,1,5900,2988,2912
Washington,Cowlitz County,2,6560,3290,3270
Washington,Cowlitz County,3,6735,3370,3365
Washington,Cowlitz County,4,6475,3368,3107
Washington,Cowlitz County,5,6087,3021,3066
Washington,Cowlitz County,6,5791,2938,2853
Washington,Cowlitz County,7,5748,2920,2828
Washington,Cowlitz County,8,5783,2893,2890
Washington,Cowlitz County,9,6106,3055,3051
Washington,Cowlitz County,10,6327,3172,3155
Washington,Cowlitz County,11,7343,3719,3624
Washington,Cowlitz County,12,7661,3825,3836
Washington,Cowlitz County,13,7099,3466,3633
Washington,Cowlitz County,14,6410,3145,3265
Washington,Cowlitz County,15,4639,2275,2364
Washington,Cowlitz County,16,3063,1426,1637
Washington,Cowlitz County,17,2052,887,1165
Washington,Cowlitz County,18,2354,884,1470
Washington,Douglas County,0,39804,20081,19723
Washington,Douglas County,1,2734,1474,1260
Washington,Douglas County,2,2944,1537,1407
Washington,Douglas County,3,2900,1456,1444
Washington,Douglas County,4,2812,1485,1327
Washington,Douglas County,5,2436,1236,1200
Washington,Douglas County,6,2289,1203,1086
Washington,Douglas County,7,2530,1316,1214
Washington,Douglas County,8,2276,1103,1173
Washington,Douglas County,9,2403,1190,1213
Washington,Douglas County,10,2366,1186,1180
Washington,Douglas County,11,2680,1373,1307
Washington,Douglas County,12,2657,1329,1328
Washington,Douglas County,13,2451,1190,1261
Washington,Douglas County,14,2114,1041,1073
Washington,Douglas County,15,1622,825,797
Washington,Douglas County,16,1113,533,580
Washington,Douglas County,17,752,350,402
Washington,Douglas County,18,725,254,471
Washington,Ferry County,0,7667,3966,3701
Washington,Ferry County,1,349,190,159
Washington,Ferry County,2,399,213,186
Washington,Ferry County,3,375,208,167
Washington,Ferry County,4,524,306,218
Washington,Ferry County,5,424,245,179
Washington,Ferry County,6,340,179,161
Washington,Ferry County,7,367,186,181
Washington,Ferry County,8,359,187,172
Washington,Ferry County,9,387,190,197
Washington,Ferry County,10,438,205,233
Washington,Ferry County,11,557,264,293
Washington,Ferry County,12,664,321,343
Washington,Ferry County,13,777,386,391
Washington,Ferry County,14,640,352,288
Washington,Ferry County,15,487,256,231
Washington,Ferry County,16,282,155,127
Washington,Ferry County,17,165,86,79
Washington,Ferry County,18,133,37,96
Washington,Franklin County,0,87809,45599,42210
Washington,Franklin County,1,8744,4416,4328
Washington,Franklin County,2,8649,4347,4302
Washington,Franklin County,3,7780,4002,3778
Washington,Franklin County,4,6588,3370,3218
Washington,Franklin County,5,6199,3328,2871
Washington,Franklin County,6,6833,3679,3154
Washington,Franklin County,7,7262,3948,3314
Washington,Franklin County,8,6316,3345,2971
Washington,Franklin County,9,5444,2909,2535
Washington,Franklin County,10,4745,2585,2160
Washington,Franklin County,11,4386,2268,2118
Washington,Franklin County,12,4173,2190,1983
Washington,Franklin County,13,3735,1929,1806
Washington,Franklin County,14,2569,1265,1304
Washington,Franklin County,15,1728,855,873
Washington,Franklin County,16,1157,552,605
Washington,Franklin County,17,771,334,437
Washington,Franklin County,18,730,277,453
Washington,Garfield County,0,2215,1087,1128
Washington,Garfield County,1,94,45,49
Washington,Garfield County,2,122,62,60
Washington,Garfield County,3,130,60,70
Washington,Garfield County,4,147,81,66
Washington,Garfield County,5,84,46,38
Washington,Garfield County,6,95,51,44
Washington,Garfield County,7,107,50,57
Washington,Garfield County,8,114,56,58
Washington,Garfield County,9,113,59,54
Washington,Garfield County,10,105,46,59
Washington,Garfield County,11,162,82,80
Washington,Garfield County,12,190,91,99
Washington,Garfield County,13,208,106,102
Washington,Garfield County,14,175,89,86
Washington,Garfield County,15,105,60,45
Washington,Garfield County,16,93,37,56
Washington,Garfield County,17,75,27,48
Washington,Garfield County,18,96,39,57
Washington,Grant County,0,93147,47063,46084
Washington,Grant County,1,8022,3928,4094
Washington,Grant County,2,8130,4120,4010
Washington,Grant County,3,7468,3770,3698
Washington,Grant County,4,7132,3640,3492
Washington,Grant County,5,6720,3477,3243
Washington,Grant County,6,6192,3325,2867
Washington,Grant County,7,5957,3103,2854
Washington,Grant County,8,5548,2810,2738
Washington,Grant County,9,5479,2726,2753
Washington,Grant County,10,5118,2629,2489
Washington,Grant County,11,5532,2831,2701
Washington,Grant County,12,5333,2750,2583
Washington,Grant County,13,4754,2365,2389
Washington,Grant County,14,4045,2004,2041
Washington,Grant County,15,2957,1470,1487
Washington,Grant County,16,1906,924,982
Washington,Grant County,17,1439,661,778
Washington,Grant County,18,1415,530,885
Washington,Grays Harbor County,0,70818,36346,34472
Washington,Grays Harbor County,1,3995,2026,1969
Washington,Grays Harbor County,2,4183,2113,2070
Washington,Grays Harbor County,3,4054,2016,2038
Washington,Grays Harbor County,4,4153,2215,1938
Washington,Grays Harbor County,5,4094,2271,1823
Washington,Grays Harbor County,6,4265,2354,1911
Washington,Grays Harbor County,7,4068,2186,1882
Washington,Grays Harbor County,8,4067,2261,1806
Washington,Grays Harbor County,9,4085,2172,1913
Washington,Grays Harbor County,10,4351,2310,2041
Washington,Grays Harbor County,11,5069,2617,2452
Washington,Grays Harbor County,12,5563,2740,2823
Washington,Grays Harbor County,13,5466,2734,2732
Washington,Grays Harbor County,14,4768,2321,2447
Washington,Grays Harbor County,15,3386,1685,1701
Washington,Grays Harbor County,16,2324,1098,1226
Washington,Grays Harbor County,17,1450,668,782
Washington,Grays Harbor County,18,1477,559,918
Washington,Island County,0,79275,39533,39742
Washington,Island County,1,4381,2328,2053
Washington,Island County,2,4065,2077,1988
Washington,Island County,3,3987,2047,1940
Washington,Island County,4,4055,2117,1938
Washington,Island County,5,5782,3293,2489
Washington,Island County,6,5438,2957,2481
Washington,Island County,7,4576,2451,2125
Washington,Island County,8,3881,1962,1919
Washington,Island County,9,3866,1910,1956
Washington,Island County,10,4160,1993,2167
Washington,Island County,11,5189,2495,2694
Washington,Island County,12,5737,2596,3141
Washington,Island County,13,6345,2936,3409
Washington,Island County,14,6212,2971,3241
Washington,Island County,15,4686,2219,2467
Washington,Island County,16,2956,1508,1448
Washington,Island County,17,1961,917,1044
Washington,Island County,18,1998,756,1242
Washington,Jefferson County,0,30228,14904,15324
Washington,Jefferson County,1,1006,505,501
Washington,Jefferson County,2,1121,591,530
Washington,Jefferson County,3,1163,578,585
Washington,Jefferson County,4,1211,618,593
Washington,Jefferson County,5,1202,669,533
Washington,Jefferson County,6,1209,622,587
Washington,Jefferson County,7,1296,707,589
Washington,Jefferson County,8,1248,616,632
Washington,Jefferson County,9,1357,689,668
Washington,Jefferson County,10,1512,762,750
Washington,Jefferson County,11,2056,954,1102
Washington,Jefferson County,12,2808,1261,1547
Washington,Jefferson County,13,3421,1619,1802
Washington,Jefferson County,14,3497,1683,1814
Washington,Jefferson County,15,2594,1290,1304
Washington,Jefferson County,16,1538,791,747
Washington,Jefferson County,17,1009,530,479
Washington,Jefferson County,18,980,419,561
Washington,King County,0,2079967,1039325,1040642
Washington,King County,1,128308,65214,63094
Washington,King County,2,122737,62878,59859
Washington,King County,3,115228,58891,56337
Washington,King County,4,116220,59322,56898
Washington,King County,5,134370,68850,65520
Washington,King County,6,176115,90236,85879
Washington,King County,7,177435,90984,86451
Washington,King County,8,156210,80143,76067
Washington,King County,9,153133,78266,74867
Washington,King County,10,144979,73944,71035
Washington,King County,11,146899,73971,72928
Washington,King County,12,138571,68829,69742
Washington,King County,13,116531,56275,60256
Washington,King County,14,89450,42346,47104
Washington,King County,15,58236,27025,31211
Washington,King County,16,39282,17454,21828
Washington,King County,17,29141,12038,17103
Washington,King County,18,37122,12659,24463
Washington,Kitsap County,0,254183,129374,124809
Washington,Kitsap County,1,14400,7317,7083
Washington,Kitsap County,2,14417,7365,7052
Washington,Kitsap County,3,14890,7516,7374
Washington,Kitsap County,4,15285,8234,7051
Washington,Kitsap County,5,20702,12414,8288
Washington,Kitsap County,6,17955,10049,7906
Washington,Kitsap County,7,16249,8654,7595
Washington,Kitsap County,8,14060,7166,6894
Washington,Kitsap County,9,14453,7284,7169
Washington,Kitsap County,10,15724,7738,7986
Washington,Kitsap County,11,18640,9165,9475
Washington,Kitsap County,12,18941,9172,9769
Washington,Kitsap County,13,17644,8565,9079
Washington,Kitsap County,14,15001,7162,7839
Washington,Kitsap County,15,10327,5037,5290
Washington,Kitsap County,16,6374,3024,3350
Washington,Kitsap County,17,4181,1813,2368
Washington,Kitsap County,18,4940,1699,3241
Washington,Kittitas County,0,42522,21381,21141
Washington,Kittitas County,1,2129,1121,1008
Washington,Kittitas County,2,2161,1051,1110
Washington,Kittitas County,3,2106,1041,1065
Washington,Kittitas County,4,3585,1735,1850
Washington,Kittitas County,5,7287,3668,3619
Washington,Kittitas County,6,2803,1577,1226
Washington,Kittitas County,7,2231,1189,1042
Washington,Kittitas County,8,2072,1076,996
Washington,Kittitas County,9,2088,1029,1059
Washington,Kittitas County,10,2159,1086,1073
Washington,Kittitas County,11,2489,1230,1259
Washington,Kittitas County,12,2646,1318,1328
Washington,Kittitas County,13,2569,1281,1288
Washington,Kittitas County,14,2183,1082,1101
Washington,Kittitas County,15,1636,811,825
Washington,Kittitas County,16,1056,539,517
Washington,Kittitas County,17,595,281,314
Washington,Kittitas County,18,727,266,461
Washington,Klickitat County,0,20861,10548,10313
Washington,Klickitat County,1,1070,519,551
Washington,Klickitat County,2,1170,600,570
Washington,Klickitat County,3,1224,651,573
Washington,Klickitat County,4,1250,663,587
Washington,Klickitat County,5,975,505,470
Washington,Klickitat County,6,936,475,461
Washington,Klickitat County,7,1037,537,500
Washington,Klickitat County,8,1151,565,586
Washington,Klickitat County,9,1262,651,611
Washington,Klickitat County,10,1262,669,593
Washington,Klickitat County,11,1515,759,756
Washington,Klickitat County,12,1704,813,891
Washington,Klickitat County,13,1898,942,956
Washington,Klickitat County,14,1631,841,790
Washington,Klickitat County,15,1178,625,553
Washington,Klickitat County,16,720,367,353
Washington,Klickitat County,17,441,209,232
Washington,Klickitat County,18,437,157,280
Washington,Lewis County,0,75128,37578,37550
Washington,Lewis County,1,4342,2213,2129
Washington,Lewis County,2,4455,2292,2163
Washington,Lewis County,3,4588,2333,2255
Washington,Lewis County,4,4768,2544,2224
Washington,Lewis County,5,4370,2282,2088
Washington,Lewis County,6,4286,2236,2050
Washington,Lewis County,7,4147,2134,2013
Washington,Lewis County,8,4097,2050,2047
Washington,Lewis County,9,4326,2132,2194
Washington,Lewis County,10,4387,2240,2147
Washington,Lewis County,11,5426,2613,2813
Washington,Lewis County,12,5566,2764,2802
Washington,Lewis County,13,5494,2680,2814
Washington,Lewis County,14,4891,2482,2409
Washington,Lewis County,15,3806,1844,1962
Washington,Lewis County,16,2673,1307,1366
Washington,Lewis County,17,1730,779,951
Washington,Lewis County,18,1776,653,1123
Washington,Lincoln County,0,10250,5151,5099
Washington,Lincoln County,1,479,240,239
Washington,Lincoln County,2,605,319,286
Washington,Lincoln County,3,686,331,355
Washington,Lincoln County,4,657,349,308
Washington,Lincoln County,5,437,241,196
Washington,Lincoln County,6,398,196,202
Washington,Lincoln County,7,448,229,219
Washington,Lincoln County,8,496,237,259
Washington,Lincoln County,9,515,249,266
Washington,Lincoln County,10,567,304,263
Washington,Lincoln County,11,729,364,365
Washington,Lincoln County,12,918,460,458
Washington,Lincoln County,13,866,447,419
Washington,Lincoln County,14,812,411,401
Washington,Lincoln County,15,587,295,292
Washington,Lincoln County,16,460,232,228
Washington,Lincoln County,17,286,127,159
Washington,Lincoln County,18,304,120,184
Washington,Mason County,0,60711,31340,29371
Washington,Mason County,1,3259,1678,1581
Washington,Mason County,2,3117,1599,1518
Washington,Mason County,3,3205,1669,1536
Washington,Mason County,4,3334,1742,1592
Washington,Mason County,5,3418,2003,1415
Washington,Mason County,6,3428,1983,1445
Washington,Mason County,7,3499,1896,1603
Washington,Mason County,8,3219,1781,1438
Washington,Mason County,9,3432,1803,1629
Washington,Mason County,10,3479,1811,1668
Washington,Mason County,11,4429,2224,2205
Washington,Mason County,12,4986,2501,2485
Washington,Mason County,13,4970,2413,2557
Washington,Mason County,14,4517,2213,2304
Washington,Mason County,15,3386,1662,1724
Washington,Mason County,16,2276,1136,1140
Washington,Mason County,17,1511,738,773
Washington,Mason County,18,1246,488,758
Washington,Okanogan County,0,41290,20852,20438
Washington,Okanogan County,1,2643,1430,1213
Washington,Okanogan County,2,2815,1428,1387
Washington,Okanogan County,3,2604,1334,1270
Washington,Okanogan County,4,2446,1309,1137
Washington,Okanogan County,5,2198,1141,1057
Washington,Okanogan County,6,2022,1030,992
Washington,Okanogan County,7,2313,1191,1122
Washington,Okanogan County,8,2216,1124,1092
Washington,Okanogan County,9,2288,1136,1152
Washington,Okanogan County,10,2195,1087,1108
Washington,Okanogan County,11,2851,1399,1452
Washington,Okanogan County,12,3295,1587,1708
Washington,Okanogan County,13,3216,1586,1630
Washington,Okanogan County,14,2961,1522,1439
Washington,Okanogan County,15,2063,1098,965
Washington,Okanogan County,16,1396,719,677
Washington,Okanogan County,17,896,406,490
Washington,Okanogan County,18,872,325,547
Washington,Pacific County,0,20561,10326,10235
Washington,Pacific County,1,950,498,452
Washington,Pacific County,2,969,484,485
Washington,Pacific County,3,921,493,428
Washington,Pacific County,4,1023,574,449
Washington,Pacific County,5,914,492,422
Washington,Pacific County,6,896,434,462
Washington,Pacific County,7,972,524,448
Washington,Pacific County,8,911,465,446
Washington,Pacific County,9,1000,482,518
Washington,Pacific County,10,1105,574,531
Washington,Pacific County,11,1394,701,693
Washington,Pacific County,12,1733,831,902
Washington,Pacific County,13,2044,990,1054
Washington,Pacific County,14,1989,977,1012
Washington,Pacific County,15,1477,744,733
Washington,Pacific County,16,1018,513,505
Washington,Pacific County,17,625,298,327
Washington,Pacific County,18,620,252,368
Washington,Pend Oreille County,0,12985,6629,6356
Washington,Pend Oreille County,1,593,319,274
Washington,Pend Oreille County,2,689,357,332
Washington,Pend Oreille County,3,766,406,360
Washington,Pend Oreille County,4,836,452,384
Washington,Pend Oreille County,5,601,308,293
Washington,Pend Oreille County,6,535,261,274
Washington,Pend Oreille County,7,497,247,250
Washington,Pend Oreille County,8,542,268,274
Washington,Pend Oreille County,9,702,352,350
Washington,Pend Oreille County,10,781,418,363
Washington,Pend Oreille County,11,1003,484,519
Washington,Pend Oreille County,12,1158,573,585
Washington,Pend Oreille County,13,1276,673,603
Washington,Pend Oreille County,14,1172,622,550
Washington,Pend Oreille County,15,796,394,402
Washington,Pend Oreille County,16,488,265,223
Washington,Pend Oreille County,17,276,133,143
Washington,Pend Oreille County,18,274,97,177
Washington,Pierce County,0,831928,413761,418167
Washington,Pierce County,1,57289,29364,27925
Washington,Pierce County,2,55747,28509,27238
Washington,Pierce County,3,53924,27398,26526
Washington,Pierce County,4,52307,26859,25448
Washington,Pierce County,5,62587,33435,29152
Washington,Pierce County,6,64205,33071,31134
Washington,Pierce County,7,60175,30111,30064
Washington,Pierce County,8,53176,26502,26674
Washington,Pierce County,9,53190,26578,26612
Washington,Pierce County,10,53728,26564,27164
Washington,Pierce County,11,58477,29062,29415
Washington,Pierce County,12,55544,27239,28305
Washington,Pierce County,13,46206,22165,24041
Washington,Pierce County,14,37102,17725,19377
Washington,Pierce County,15,25558,11915,13643
Washington,Pierce County,16,17234,7547,9687
Washington,Pierce County,17,12581,5331,7250
Washington,Pierce County,18,12898,4386,8512
Washington,San Juan County,0,16015,7697,8318
Washington,San Juan County,1,477,220,257
Washington,San Juan County,2,624,310,314
Washington,San Juan County,3,679,337,342
Washington,San Juan County,4,743,375,368
Washington,San Juan County,5,606,299,307
Washington,San Juan County,6,595,274,321
Washington,San Juan County,7,660,321,339
Washington,San Juan County,8,695,336,359
Washington,San Juan County,9,767,375,392
Washington,San Juan County,10,882,428,454
Washington,San Juan County,11,1232,592,640
Washington,San Juan County,12,1532,706,826
Washington,San Juan County,13,1814,831,983
Washington,San Juan County,14,1808,878,930
Washington,San Juan County,15,1236,650,586
Washington,San Juan County,16,730,363,367
Washington,San Juan County,17,434,220,214
Washington,San Juan County,18,501,182,319
Washington,Skagit County,0,120365,59699,60666
Washington,Skagit County,1,7384,3736,3648
Washington,Skagit County,2,7695,3891,3804
Washington,Skagit County,3,7336,3737,3599
Washington,Skagit County,4,7397,3817,3580
Washington,Skagit County,5,7318,3748,3570
Washington,Skagit County,6,7103,3708,3395
Washington,Skagit County,7,7533,3863,3670
Washington,Skagit County,8,6738,3434,3304
Washington,Skagit County,9,6940,3478,3462
Washington,Skagit County,10,6861,3467,3394
Washington,Skagit County,11,8252,4076,4176
Washington,Skagit County,12,8587,4084,4503
Washington,Skagit County,13,8675,4205,4470
Washington,Skagit County,14,7505,3577,3928
Washington,Skagit County,15,5642,2705,2937
Washington,Skagit County,16,3800,1837,1963
Washington,Skagit County,17,2615,1176,1439
Washington,Skagit County,18,2984,1160,1824
Washington,Skamania County,0,11340,5752,5588
Washington,Skamania County,1,514,251,263
Washington,Skamania County,2,676,353,323
Washington,Skamania County,3,724,372,352
Washington,Skamania County,4,683,356,327
Washington,Skamania County,5,521,286,235
Washington,Skamania County,6,532,272,260
Washington,Skamania County,7,605,301,304
Washington,Skamania County,8,641,320,321
Washington,Skamania County,9,694,338,356
Washington,Skamania County,10,740,369,371
Washington,Skamania County,11,1009,515,494
Washington,Skamania County,12,1069,513,556
Washington,Skamania County,13,961,511,450
Washington,Skamania County,14,755,402,353
Washington,Skamania County,15,529,272,257
Washington,Skamania County,16,285,145,140
Washington,Skamania County,17,215,105,110
Washington,Skamania County,18,187,71,116
Washington,Snohomish County,0,759583,381692,377891
Washington,Snohomish County,1,47285,24219,23066
Washington,Snohomish County,2,49886,25479,24407
Washington,Snohomish County,3,48752,24864,23888
Washington,Snohomish County,4,46581,24131,22450
Washington,Snohomish County,5,49382,26101,23281
Washington,Snohomish County,6,53269,27752,25517
Washington,Snohomish County,7,55750,28650,27100
Washington,Snohomish County,8,51471,26496,24975
Washington,Snohomish County,9,53508,27064,26444
Washington,Snohomish County,10,53907,27500,26407
Washington,Snohomish County,11,58870,29637,29233
Washington,Snohomish County,12,54922,27508,27414
Washington,Snohomish County,13,44285,21558,22727
Washington,Snohomish County,14,33612,15917,17695
Washington,Snohomish County,15,21753,10246,11507
Washington,Snohomish County,16,14464,6383,8081
Washington,Snohomish County,17,10406,4285,6121
Washington,Snohomish County,18,11480,3902,7578
Washington,Spokane County,0,484318,240565,243753
Washington,Spokane County,1,29781,15302,14479
Washington,Spokane County,2,30489,15646,14843
Washington,Spokane County,3,30222,15676,14546
Washington,Spokane County,4,31620,16130,15490
Washington,Spokane County,5,37106,19046,18060
Washington,Spokane County,6,37178,19069,18109
Washington,Spokane County,7,32537,16731,15806
Washington,Spokane County,8,28300,14231,14069
Washington,Spokane County,9,29189,14776,14413
Washington,Spokane County,10,29090,14449,14641
Washington,Spokane County,11,33624,16512,17112
Washington,Spokane County,12,33182,16193,16989
Washington,Spokane County,13,30468,14709,15759
Washington,Spokane County,14,24540,11768,12772
Washington,Spokane County,15,17021,8070,8951
Washington,Spokane County,16,11677,5296,6381
Washington,Spokane County,17,8596,3624,4972
Washington,Spokane County,18,9698,3337,6361
Washington,Stevens County,0,43650,21836,21814
Washington,Stevens County,1,2232,1162,1070
Washington,Stevens County,2,2552,1294,1258
Washington,Stevens County,3,2918,1488,1430
Washington,Stevens County,4,3011,1545,1466
Washington,Stevens County,5,2084,1104,980
Washington,Stevens County,6,1736,906,830
Washington,Stevens County,7,1914,938,976
Washington,Stevens County,8,2186,1026,1160
Washington,Stevens County,9,2396,1213,1183
Washington,Stevens County,10,2595,1265,1330
Washington,Stevens County,11,3236,1555,1681
Washington,Stevens County,12,3968,1922,2046
Washington,Stevens County,13,3788,1879,1909
Washington,Stevens County,14,3304,1726,1578
Washington,Stevens County,15,2463,1282,1181
Washington,Stevens County,16,1575,804,771
Washington,Stevens County,17,890,419,471
Washington,Stevens County,18,802,308,494
Washington,Thurston County,0,265851,130639,135212
Washington,Thurston County,1,16088,8527,7561
Washington,Thurston County,2,16302,8412,7890
Washington,Thurston County,3,16315,8469,7846
Washington,Thurston County,4,16117,8372,7745
Washington,Thurston County,5,17605,9005,8600
Washington,Thurston County,6,18852,9604,9248
Washington,Thurston County,7,19078,9509,9569
Washington,Thurston County,8,17387,8691,8696
Washington,Thurston County,9,16805,8324,8481
Washington,Thurston County,10,16610,8179,8431
Washington,Thurston County,11,18034,8614,9420
Washington,Thurston County,12,18397,8653,9744
Washington,Thurston County,13,17845,8192,9653
Washington,Thurston County,14,14522,6886,7636
Washington,Thurston County,15,9867,4610,5257
Washington,Thurston County,16,6401,2952,3449
Washington,Thurston County,17,4617,1998,2619
Washington,Thurston County,18,5009,1642,3367
Washington,Wahkiakum County,0,4067,2015,2052
Washington,Wahkiakum County,1,146,77,69
Washington,Wahkiakum County,2,186,93,93
Washington,Wahkiakum County,3,229,115,114
Washington,Wahkiakum County,4,213,104,109
Washington,Wahkiakum County,5,167,91,76
Washington,Wahkiakum County,6,151,74,77
Washington,Wahkiakum County,7,140,67,73
Washington,Wahkiakum County,8,162,88,74
Washington,Wahkiakum County,9,189,88,101
Washington,Wahkiakum County,10,234,110,124
Washington,Wahkiakum County,11,285,143,142
Washington,Wahkiakum County,12,311,150,161
Washington,Wahkiakum County,13,405,214,191
Washington,Wahkiakum County,14,443,206,237
Washington,Wahkiakum County,15,368,192,176
Washington,Wahkiakum County,16,203,102,101
Washington,Wahkiakum County,17,119,57,62
Washington,Wahkiakum County,18,116,44,72
Washington,Walla Walla County,0,59844,30448,29396
Washington,Walla Walla County,1,3497,1811,1686
Washington,Walla Walla County,2,3620,1898,1722
Washington,Walla Walla County,3,3631,1825,1806
Washington,Walla Walla County,4,4747,2301,2446
Washington,Walla Walla County,5,5752,3066,2686
Washington,Walla Walla County,6,3807,2240,1567
Washington,Walla Walla County,7,3557,1969,1588
Washington,Walla Walla County,8,3338,1799,1539
Washington,Walla Walla County,9,3340,1764,1576
Washington,Walla Walla County,10,3395,1768,1627
Washington,Walla Walla County,11,3731,1904,1827
Washington,Walla Walla County,12,3935,1915,2020
Washington,Walla Walla County,13,3592,1783,1809
Washington,Walla Walla County,14,3056,1501,1555
Washington,Walla Walla County,15,2172,1065,1107
Washington,Walla Walla County,16,1607,702,905
Washington,Walla Walla County,17,1374,563,811
Washington,Walla Walla County,18,1693,574,1119
Washington,Whatcom County,0,208351,103378,104973
Washington,Whatcom County,1,11540,5858,5682
Washington,Whatcom County,2,11610,5972,5638
Washington,Whatcom County,3,11510,5917,5593
Washington,Whatcom County,4,15110,7443,7667
Washington,Whatcom County,5,23801,11965,11836
Washington,Whatcom County,6,13092,6906,6186
Washington,Whatcom County,7,13240,6798,6442
Washington,Whatcom County,8,12008,6064,5944
Washington,Whatcom County,9,11927,6050,5877
Washington,Whatcom County,10,12280,6059,6221
Washington,Whatcom County,11,13225,6568,6657
Washington,Whatcom County,12,13438,6517,6921
Washington,Whatcom County,13,13412,6353,7059
Washington,Whatcom County,14,11544,5627,5917
Washington,Whatcom County,15,7799,3785,4014
Washington,Whatcom County,16,5098,2404,2694
Washington,Whatcom County,17,3702,1631,2071
Washington,Whatcom County,18,4015,1461,2554
Washington,Whitman County,0,46827,23931,22896
Washington,Whitman County,1,2224,1117,1107
Washington,Whitman County,2,1933,1014,919
Washington,Whitman County,3,1863,931,932
Washington,Whitman County,4,5874,2818,3056
Washington,Whitman County,5,12404,6642,5762
Washington,Whitman County,6,3720,2050,1670
Washington,Whitman County,7,2593,1361,1232
Washington,Whitman County,8,2054,1066,988
Washington,Whitman County,9,1644,850,794
Washington,Whitman County,10,1793,864,929
Washington,Whitman County,11,2062,1034,1028
Washington,Whitman County,12,2129,1048,1081
Washington,Whitman County,13,1845,971,874
Washington,Whitman County,14,1513,749,764
Washington,Whitman County,15,1146,544,602
Washington,Whitman County,16,759,353,406
Washington,Whitman County,17,556,249,307
Washington,Whitman County,18,715,270,445
Washington,Yakima County,0,247687,124034,123653
Washington,Yakima County,1,20865,10759,10106
Washington,Yakima County,2,21166,10830,10336
Washington,Yakima County,3,20224,10298,9926
Washington,Yakima County,4,18471,9514,8957
Washington,Yakima County,5,18237,9557,8680
Washington,Yakima County,6,16355,8419,7936
Washington,Yakima County,7,15813,7893,7920
Washington,Yakima County,8,14872,7458,7414
Washington,Yakima County,9,14518,7237,7281
Washington,Yakima County,10,13942,7059,6883
Washington,Yakima County,11,14779,7420,7359
Washington,Yakima County,12,14158,7039,7119
Washington,Yakima County,13,12568,6051,6517
Washington,Yakima County,14,10448,5157,5291
Washington,Yakima County,15,7784,3663,4121
Washington,Yakima County,16,5305,2445,2860
Washington,Yakima County,17,3856,1624,2232
Washington,Yakima County,18,4326,1611,2715
West Virginia,Barbour County,0,16766,8206,8560
West Virginia,Barbour County,1,893,457,436
West Virginia,Barbour County,2,992,518,474
West Virginia,Barbour County,3,987,505,482
West Virginia,Barbour County,4,1208,581,627
West Virginia,Barbour County,5,1272,615,657
West Virginia,Barbour County,6,865,401,464
West Virginia,Barbour County,7,881,449,432
West Virginia,Barbour County,8,904,411,493
West Virginia,Barbour County,9,1065,547,518
West Virginia,Barbour County,10,1053,514,539
West Virginia,Barbour County,11,1215,614,601
West Virginia,Barbour County,12,1215,579,636
West Virginia,Barbour County,13,1151,599,552
West Virginia,Barbour County,14,1008,490,518
West Virginia,Barbour County,15,791,384,407
West Virginia,Barbour County,16,534,245,289
West Virginia,Barbour County,17,363,178,185
West Virginia,Barbour County,18,369,119,250
West Virginia,Berkeley County,0,110497,54496,56001
West Virginia,Berkeley County,1,6896,3530,3366
West Virginia,Berkeley County,2,7651,3843,3808
West Virginia,Berkeley County,3,7716,3907,3809
West Virginia,Berkeley County,4,6695,3401,3294
West Virginia,Berkeley County,5,6328,3133,3195
West Virginia,Berkeley County,6,7379,3542,3837
West Virginia,Berkeley County,7,7664,3783,3881
West Virginia,Berkeley County,8,7359,3576,3783
West Virginia,Berkeley County,9,7806,3865,3941
West Virginia,Berkeley County,10,7955,3958,3997
West Virginia,Berkeley County,11,8176,4076,4100
West Virginia,Berkeley County,12,7591,3762,3829
West Virginia,Berkeley County,13,6596,3262,3334
West Virginia,Berkeley County,14,5719,2811,2908
West Virginia,Berkeley County,15,3729,1749,1980
West Virginia,Berkeley County,16,2435,1159,1276
West Virginia,Berkeley County,17,1519,647,872
West Virginia,Berkeley County,18,1283,492,791
West Virginia,Boone County,0,23714,11783,11931
West Virginia,Boone County,1,1359,721,638
West Virginia,Boone County,2,1452,754,698
West Virginia,Boone County,3,1563,814,749
West Virginia,Boone County,4,1406,744,662
West Virginia,Boone County,5,1263,661,602
West Virginia,Boone County,6,1185,600,585
West Virginia,Boone County,7,1271,593,678
West Virginia,Boone County,8,1602,800,802
West Virginia,Boone County,9,1718,862,856
West Virginia,Boone County,10,1583,786,797
West Virginia,Boone County,11,1600,809,791
West Virginia,Boone County,12,1934,948,986
West Virginia,Boone County,13,1801,853,948
West Virginia,Boone County,14,1489,734,755
West Virginia,Boone County,15,934,472,462
West Virginia,Boone County,16,731,335,396
West Virginia,Boone County,17,435,161,274
West Virginia,Boone County,18,388,136,252
West Virginia,Braxton County,0,14463,7271,7192
West Virginia,Braxton County,1,832,414,418
West Virginia,Braxton County,2,788,413,375
West Virginia,Braxton County,3,826,414,412
West Virginia,Braxton County,4,781,394,387
West Virginia,Braxton County,5,815,421,394
West Virginia,Braxton County,6,784,420,364
West Virginia,Braxton County,7,765,406,359
West Virginia,Braxton County,8,788,406,382
West Virginia,Braxton County,9,900,433,467
West Virginia,Braxton County,10,934,479,455
West Virginia,Braxton County,11,1092,556,536
West Virginia,Braxton County,12,1115,569,546
West Virginia,Braxton County,13,1155,578,577
West Virginia,Braxton County,14,993,495,498
West Virginia,Braxton County,15,727,360,367
West Virginia,Braxton County,16,524,255,269
West Virginia,Braxton County,17,334,155,179
West Virginia,Braxton County,18,310,103,207
West Virginia,Brooke County,0,23530,11530,12000
West Virginia,Brooke County,1,898,478,420
West Virginia,Brooke County,2,1211,644,567
West Virginia,Brooke County,3,1267,650,617
West Virginia,Brooke County,4,1512,778,734
West Virginia,Brooke County,5,1675,845,830
West Virginia,Brooke County,6,1082,580,502
West Virginia,Brooke County,7,1102,549,553
West Virginia,Brooke County,8,1274,645,629
West Virginia,Brooke County,9,1422,705,717
West Virginia,Brooke County,10,1493,749,744
West Virginia,Brooke County,11,1718,860,858
West Virginia,Brooke County,12,1873,904,969
West Virginia,Brooke County,13,1940,951,989
West Virginia,Brooke County,14,1578,760,818
West Virginia,Brooke County,15,1104,507,597
West Virginia,Brooke County,16,930,413,517
West Virginia,Brooke County,17,793,310,483
West Virginia,Brooke County,18,658,202,456
West Virginia,Cabell County,0,97109,47296,49813
West Virginia,Cabell County,1,5941,2996,2945
West Virginia,Cabell County,2,5273,2782,2491
West Virginia,Cabell County,3,5183,2686,2497
West Virginia,Cabell County,4,6236,3124,3112
West Virginia,Cabell County,5,9761,4722,5039
West Virginia,Cabell County,6,6083,3155,2928
West Virginia,Cabell County,7,6396,3279,3117
West Virginia,Cabell County,8,5791,2937,2854
West Virginia,Cabell County,9,5708,2873,2835
West Virginia,Cabell County,10,5641,2819,2822
West Virginia,Cabell County,11,6020,2937,3083
West Virginia,Cabell County,12,6377,3084,3293
West Virginia,Cabell County,13,6211,2933,3278
West Virginia,Cabell County,14,5217,2415,2802
West Virginia,Cabell County,15,3905,1813,2092
West Virginia,Cabell County,16,2930,1235,1695
West Virginia,Cabell County,17,2178,791,1387
West Virginia,Cabell County,18,2258,715,1543
West Virginia,Calhoun County,0,7513,3773,3740
West Virginia,Calhoun County,1,370,190,180
West Virginia,Calhoun County,2,407,203,204
West Virginia,Calhoun County,3,407,195,212
West Virginia,Calhoun County,4,396,206,190
West Virginia,Calhoun County,5,347,181,166
West Virginia,Calhoun County,6,383,202,181
West Virginia,Calhoun County,7,418,211,207
West Virginia,Calhoun County,8,456,229,227
West Virginia,Calhoun County,9,428,215,213
West Virginia,Calhoun County,10,517,250,267
West Virginia,Calhoun County,11,595,303,292
West Virginia,Calhoun County,12,631,312,319
West Virginia,Calhoun County,13,600,301,299
West Virginia,Calhoun County,14,555,304,251
West Virginia,Calhoun County,15,352,192,160
West Virginia,Calhoun County,16,273,120,153
West Virginia,Calhoun County,17,194,90,104
West Virginia,Calhoun County,18,184,69,115
West Virginia,Clay County,0,8941,4479,4462
West Virginia,Clay County,1,579,281,298
West Virginia,Clay County,2,553,293,260
West Virginia,Clay County,3,577,300,277
West Virginia,Clay County,4,518,262,256
West Virginia,Clay County,5,458,237,221
West Virginia,Clay County,6,385,192,193
West Virginia,Clay County,7,482,253,229
West Virginia,Clay County,8,533,235,298
West Virginia,Clay County,9,568,275,293
West Virginia,Clay County,10,603,310,293
West Virginia,Clay County,11,651,303,348
West Virginia,Clay County,12,692,370,322
West Virginia,Clay County,13,637,319,318
West Virginia,Clay County,14,579,303,276
West Virginia,Clay County,15,444,237,207
West Virginia,Clay County,16,310,157,153
West Virginia,Clay County,17,205,100,105
West Virginia,Clay County,18,167,52,115
West Virginia,Doddridge County,0,8391,4595,3796
West Virginia,Doddridge County,1,336,183,153
West Virginia,Doddridge County,2,392,201,191
West Virginia,Doddridge County,3,439,239,200
West Virginia,Doddridge County,4,562,351,211
West Virginia,Doddridge County,5,586,373,213
West Virginia,Doddridge County,6,439,266,173
West Virginia,Doddridge County,7,509,290,219
West Virginia,Doddridge County,8,524,300,224
West Virginia,Doddridge County,9,571,321,250
West Virginia,Doddridge County,10,612,348,264
West Virginia,Doddridge County,11,697,363,334
West Virginia,Doddridge County,12,655,322,333
West Virginia,Doddridge County,13,653,322,331
West Virginia,Doddridge County,14,533,277,256
West Virginia,Doddridge County,15,348,168,180
West Virginia,Doddridge County,16,270,143,127
West Virginia,Doddridge County,17,148,75,73
West Virginia,Doddridge County,18,117,53,64
West Virginia,Fayette County,0,45132,22725,22407
West Virginia,Fayette County,1,2650,1384,1266
West Virginia,Fayette County,2,2543,1316,1227
West Virginia,Fayette County,3,2597,1320,1277
West Virginia,Fayette County,4,2484,1347,1137
West Virginia,Fayette County,5,2460,1309,1151
West Virginia,Fayette County,6,2477,1342,1135
West Virginia,Fayette County,7,2588,1379,1209
West Virginia,Fayette County,8,2791,1439,1352
West Virginia,Fayette County,9,2929,1538,1391
West Virginia,Fayette County,10,2930,1541,1389
West Virginia,Fayette County,11,3146,1542,1604
West Virginia,Fayette County,12,3626,1814,1812
West Virginia,Fayette County,13,3458,1754,1704
West Virginia,Fayette County,14,2842,1408,1434
West Virginia,Fayette County,15,1986,911,1075
West Virginia,Fayette County,16,1489,665,824
West Virginia,Fayette County,17,1052,379,673
West Virginia,Fayette County,18,1084,337,747
West Virginia,Gilmer County,0,8618,5179,3439
West Virginia,Gilmer County,1,349,168,181
West Virginia,Gilmer County,2,319,159,160
West Virginia,Gilmer County,3,296,158,138
West Virginia,Gilmer County,4,571,278,293
West Virginia,Gilmer County,5,958,602,356
West Virginia,Gilmer County,6,602,434,168
West Virginia,Gilmer County,7,748,580,168
West Virginia,Gilmer County,8,699,514,185
West Virginia,Gilmer County,9,578,389,189
West Virginia,Gilmer County,10,605,403,202
West Virginia,Gilmer County,11,578,346,232
West Virginia,Gilmer County,12,550,290,260
West Virginia,Gilmer County,13,482,271,211
West Virginia,Gilmer County,14,388,204,184
West Virginia,Gilmer County,15,284,124,160
West Virginia,Gilmer County,16,257,120,137
West Virginia,Gilmer County,17,182,74,108
West Virginia,Gilmer County,18,172,65,107
West Virginia,Grant County,0,11687,5807,5880
West Virginia,Grant County,1,605,295,310
West Virginia,Grant County,2,605,306,299
West Virginia,Grant County,3,679,363,316
West Virginia,Grant County,4,649,341,308
West Virginia,Grant County,5,609,309,300
West Virginia,Grant County,6,568,290,278
West Virginia,Grant County,7,576,296,280
West Virginia,Grant County,8,641,313,328
West Virginia,Grant County,9,727,365,362
West Virginia,Grant County,10,820,411,409
West Virginia,Grant County,11,870,427,443
West Virginia,Grant County,12,867,441,426
West Virginia,Grant County,13,879,439,440
West Virginia,Grant County,14,864,418,446
West Virginia,Grant County,15,684,350,334
West Virginia,Grant County,16,448,205,243
West Virginia,Grant County,17,306,147,159
West Virginia,Grant County,18,290,91,199
West Virginia,Greenbrier County,0,35450,17331,18119
West Virginia,Greenbrier County,1,1920,968,952
West Virginia,Greenbrier County,2,1840,912,928
West Virginia,Greenbrier County,3,2011,1007,1004
West Virginia,Greenbrier County,4,1782,958,824
West Virginia,Greenbrier County,5,1947,1045,902
West Virginia,Greenbrier County,6,1909,943,966
West Virginia,Greenbrier County,7,2008,1021,987
West Virginia,Greenbrier County,8,1938,935,1003
West Virginia,Greenbrier County,9,2034,952,1082
West Virginia,Greenbrier County,10,2288,1141,1147
West Virginia,Greenbrier County,11,2669,1325,1344
West Virginia,Greenbrier County,12,2809,1375,1434
West Virginia,Greenbrier County,13,2729,1337,1392
West Virginia,Greenbrier County,14,2489,1221,1268
West Virginia,Greenbrier County,15,1869,893,976
West Virginia,Greenbrier County,16,1387,625,762
West Virginia,Greenbrier County,17,922,358,564
West Virginia,Greenbrier County,18,899,315,584
West Virginia,Hampshire County,0,23483,11906,11577
West Virginia,Hampshire County,1,1082,553,529
West Virginia,Hampshire County,2,1254,645,609
West Virginia,Hampshire County,3,1439,725,714
West Virginia,Hampshire County,4,1451,750,701
West Virginia,Hampshire County,5,1232,648,584
West Virginia,Hampshire County,6,1133,586,547
West Virginia,Hampshire County,7,1210,605,605
West Virginia,Hampshire County,8,1277,652,625
West Virginia,Hampshire County,9,1575,795,780
West Virginia,Hampshire County,10,1683,882,801
West Virginia,Hampshire County,11,1874,965,909
West Virginia,Hampshire County,12,1806,911,895
West Virginia,Hampshire County,13,1813,928,885
West Virginia,Hampshire County,14,1711,881,830
West Virginia,Hampshire County,15,1251,620,631
West Virginia,Hampshire County,16,792,377,415
West Virginia,Hampshire County,17,483,245,238
West Virginia,Hampshire County,18,417,138,279
West Virginia,Hancock County,0,30112,14567,15545
West Virginia,Hancock County,1,1472,716,756
West Virginia,Hancock County,2,1629,831,798
West Virginia,Hancock County,3,1801,925,876
West Virginia,Hancock County,4,1643,857,786
West Virginia,Hancock County,5,1507,768,739
West Virginia,Hancock County,6,1462,724,738
West Virginia,Hancock County,7,1622,814,808
West Virginia,Hancock County,8,1670,798,872
West Virginia,Hancock County,9,2018,1024,994
West Virginia,Hancock County,10,1948,976,972
West Virginia,Hancock County,11,2367,1151,1216
West Virginia,Hancock County,12,2446,1178,1268
West Virginia,Hancock County,13,2458,1181,1277
West Virginia,Hancock County,14,1908,957,951
West Virginia,Hancock County,15,1338,598,740
West Virginia,Hancock County,16,1150,485,665
West Virginia,Hancock County,17,817,319,498
West Virginia,Hancock County,18,856,265,591
West Virginia,Hardy County,0,13923,7000,6923
West Virginia,Hardy County,1,717,388,329
West Virginia,Hardy County,2,779,408,371
West Virginia,Hardy County,3,823,440,383
West Virginia,Hardy County,4,779,381,398
West Virginia,Hardy County,5,735,373,362
West Virginia,Hardy County,6,724,369,355
West Virginia,Hardy County,7,713,355,358
West Virginia,Hardy County,8,830,418,412
West Virginia,Hardy County,9,900,452,448
West Virginia,Hardy County,10,1020,545,475
West Virginia,Hardy County,11,1068,533,535
West Virginia,Hardy County,12,1076,542,534
West Virginia,Hardy County,13,1006,487,519
West Virginia,Hardy County,14,980,493,487
West Virginia,Hardy County,15,694,338,356
West Virginia,Hardy County,16,510,251,259
West Virginia,Hardy County,17,285,123,162
West Virginia,Hardy County,18,284,104,180
West Virginia,Harrison County,0,68761,33633,35128
West Virginia,Harrison County,1,4009,2049,1960
West Virginia,Harrison County,2,4148,2147,2001
West Virginia,Harrison County,3,4077,2127,1950
West Virginia,Harrison County,4,3902,1960,1942
West Virginia,Harrison County,5,3862,1955,1907
West Virginia,Harrison County,6,3957,1932,2025
West Virginia,Harrison County,7,4403,2211,2192
West Virginia,Harrison County,8,4061,2080,1981
West Virginia,Harrison County,9,4468,2226,2242
West Virginia,Harrison County,10,4497,2218,2279
West Virginia,Harrison County,11,5207,2542,2665
West Virginia,Harrison County,12,5251,2620,2631
West Virginia,Harrison County,13,4590,2248,2342
West Virginia,Harrison County,14,4044,1914,2130
West Virginia,Harrison County,15,2888,1314,1574
West Virginia,Harrison County,16,2170,941,1229
West Virginia,Harrison County,17,1536,587,949
West Virginia,Harrison County,18,1691,562,1129
West Virginia,Jackson County,0,29126,14371,14755
West Virginia,Jackson County,1,1581,806,775
West Virginia,Jackson County,2,1769,912,857
West Virginia,Jackson County,3,1829,973,856
West Virginia,Jackson County,4,1742,901,841
West Virginia,Jackson County,5,1621,868,753
West Virginia,Jackson County,6,1523,767,756
West Virginia,Jackson County,7,1624,809,815
West Virginia,Jackson County,8,1703,852,851
West Virginia,Jackson County,9,1893,916,977
West Virginia,Jackson County,10,1892,926,966
West Virginia,Jackson County,11,2178,1027,1151
West Virginia,Jackson County,12,2273,1144,1129
West Virginia,Jackson County,13,1957,966,991
West Virginia,Jackson County,14,1643,785,858
West Virginia,Jackson County,15,1344,624,720
West Virginia,Jackson County,16,1167,527,640
West Virginia,Jackson County,17,785,344,441
West Virginia,Jackson County,18,602,224,378
West Virginia,Jefferson County,0,55713,27406,28307
West Virginia,Jefferson County,1,3035,1505,1530
West Virginia,Jefferson County,2,3725,1889,1836
West Virginia,Jefferson County,3,3825,1962,1863
West Virginia,Jefferson County,4,3805,1886,1919
West Virginia,Jefferson County,5,3459,1649,1810
West Virginia,Jefferson County,6,3095,1523,1572
West Virginia,Jefferson County,7,3362,1656,1706
West Virginia,Jefferson County,8,3456,1695,1761
West Virginia,Jefferson County,9,3940,1933,2007
West Virginia,Jefferson County,10,4240,2079,2161
West Virginia,Jefferson County,11,4461,2264,2197
West Virginia,Jefferson County,12,3980,1977,2003
West Virginia,Jefferson County,13,3473,1680,1793
West Virginia,Jefferson County,14,3009,1497,1512
West Virginia,Jefferson County,15,2035,977,1058
West Virginia,Jefferson County,16,1247,594,653
West Virginia,Jefferson County,17,793,357,436
West Virginia,Jefferson County,18,773,283,490
West Virginia,Kanawha County,0,190223,91688,98535
West Virginia,Kanawha County,1,10692,5380,5312
West Virginia,Kanawha County,2,10677,5504,5173
West Virginia,Kanawha County,3,10886,5458,5428
West Virginia,Kanawha County,4,10654,5496,5158
West Virginia,Kanawha County,5,11052,5568,5484
West Virginia,Kanawha County,6,11382,5618,5764
West Virginia,Kanawha County,7,11852,5938,5914
West Virginia,Kanawha County,8,11764,5855,5909
West Virginia,Kanawha County,9,11746,5778,5968
West Virginia,Kanawha County,10,11764,5828,5936
West Virginia,Kanawha County,11,13853,6626,7227
West Virginia,Kanawha County,12,15226,7269,7957
West Virginia,Kanawha County,13,14173,6699,7474
West Virginia,Kanawha County,14,11315,5264,6051
West Virginia,Kanawha County,15,8016,3635,4381
West Virginia,Kanawha County,16,6219,2592,3627
West Virginia,Kanawha County,17,4478,1653,2825
West Virginia,Kanawha County,18,4474,1527,2947
West Virginia,Lewis County,0,16414,8110,8304
West Virginia,Lewis County,1,941,463,478
West Virginia,Lewis County,2,964,483,481
West Virginia,Lewis County,3,912,458,454
West Virginia,Lewis County,4,834,447,387
West Virginia,Lewis County,5,918,462,456
West Virginia,Lewis County,6,889,442,447
West Virginia,Lewis County,7,931,435,496
West Virginia,Lewis County,8,994,553,441
West Virginia,Lewis County,9,1096,551,545
West Virginia,Lewis County,10,1128,559,569
West Virginia,Lewis County,11,1234,615,619
West Virginia,Lewis County,12,1218,589,629
West Virginia,Lewis County,13,1156,577,579
West Virginia,Lewis County,14,1082,527,555
West Virginia,Lewis County,15,786,366,420
West Virginia,Lewis County,16,591,268,323
West Virginia,Lewis County,17,390,179,211
West Virginia,Lewis County,18,350,136,214
West Virginia,Lincoln County,0,21561,10707,10854
West Virginia,Lincoln County,1,1269,632,637
West Virginia,Lincoln County,2,1384,726,658
West Virginia,Lincoln County,3,1381,715,666
West Virginia,Lincoln County,4,1237,640,597
West Virginia,Lincoln County,5,1145,552,593
West Virginia,Lincoln County,6,1109,571,538
West Virginia,Lincoln County,7,1247,589,658
West Virginia,Lincoln County,8,1375,677,698
West Virginia,Lincoln County,9,1449,734,715
West Virginia,Lincoln County,10,1482,759,723
West Virginia,Lincoln County,11,1598,793,805
West Virginia,Lincoln County,12,1651,809,842
West Virginia,Lincoln County,13,1519,736,783
West Virginia,Lincoln County,14,1291,652,639
West Virginia,Lincoln County,15,930,462,468
West Virginia,Lincoln County,16,762,355,407
West Virginia,Lincoln County,17,453,214,239
West Virginia,Lincoln County,18,279,91,188
West Virginia,Logan County,0,35348,17524,17824
West Virginia,Logan County,1,2097,1111,986
West Virginia,Logan County,2,1862,955,907
West Virginia,Logan County,3,2060,1041,1019
West Virginia,Logan County,4,2013,1043,970
West Virginia,Logan County,5,1994,998,996
West Virginia,Logan County,6,1887,1018,869
West Virginia,Logan County,7,2049,1035,1014
West Virginia,Logan County,8,2426,1253,1173
West Virginia,Logan County,9,2486,1280,1206
West Virginia,Logan County,10,2248,1123,1125
West Virginia,Logan County,11,2318,1102,1216
West Virginia,Logan County,12,2956,1426,1530
West Virginia,Logan County,13,2886,1448,1438
West Virginia,Logan County,14,2200,1058,1142
West Virginia,Logan County,15,1444,666,778
West Virginia,Logan County,16,1104,451,653
West Virginia,Logan County,17,759,285,474
West Virginia,Logan County,18,559,231,328
West Virginia,McDowell County,0,20448,10099,10349
West Virginia,McDowell County,1,1281,671,610
West Virginia,McDowell County,2,1115,559,556
West Virginia,McDowell County,3,1124,582,542
West Virginia,McDowell County,4,1071,546,525
West Virginia,McDowell County,5,1110,584,526
West Virginia,McDowell County,6,1163,571,592
West Virginia,McDowell County,7,1062,545,517
West Virginia,McDowell County,8,1282,672,610
West Virginia,McDowell County,9,1288,659,629
West Virginia,McDowell County,10,1308,653,655
West Virginia,McDowell County,11,1484,671,813
West Virginia,McDowell County,12,1813,900,913
West Virginia,McDowell County,13,1640,805,835
West Virginia,McDowell County,14,1310,665,645
West Virginia,McDowell County,15,856,428,428
West Virginia,McDowell County,16,661,281,380
West Virginia,McDowell County,17,424,157,267
West Virginia,McDowell County,18,456,150,306
West Virginia,Marion County,0,56803,27929,28874
West Virginia,Marion County,1,3269,1596,1673
West Virginia,Marion County,2,3087,1586,1501
West Virginia,Marion County,3,3083,1588,1495
West Virginia,Marion County,4,3558,1852,1706
West Virginia,Marion County,5,4769,2374,2395
West Virginia,Marion County,6,3059,1564,1495
West Virginia,Marion County,7,3402,1716,1686
West Virginia,Marion County,8,3384,1739,1645
West Virginia,Marion County,9,3592,1771,1821
West Virginia,Marion County,10,3634,1884,1750
West Virginia,Marion County,11,3575,1713,1862
West Virginia,Marion County,12,4188,2123,2065
West Virginia,Marion County,13,3908,1968,1940
West Virginia,Marion County,14,3357,1565,1792
West Virginia,Marion County,15,2444,1122,1322
West Virginia,Marion County,16,1791,771,1020
West Virginia,Marion County,17,1237,500,737
West Virginia,Marion County,18,1466,497,969
West Virginia,Marshall County,0,32416,15990,16426
West Virginia,Marshall County,1,1705,920,785
West Virginia,Marshall County,2,1774,903,871
West Virginia,Marshall County,3,1883,944,939
West Virginia,Marshall County,4,1771,900,871
West Virginia,Marshall County,5,1844,931,913
West Virginia,Marshall County,6,1768,944,824
West Virginia,Marshall County,7,1730,865,865
West Virginia,Marshall County,8,1795,909,886
West Virginia,Marshall County,9,2085,1066,1019
West Virginia,Marshall County,10,2094,1064,1030
West Virginia,Marshall County,11,2413,1182,1231
West Virginia,Marshall County,12,2628,1300,1328
West Virginia,Marshall County,13,2581,1252,1329
West Virginia,Marshall County,14,2229,1075,1154
West Virginia,Marshall County,15,1427,669,758
West Virginia,Marshall County,16,1130,469,661
West Virginia,Marshall County,17,734,290,444
West Virginia,Marshall County,18,825,307,518
West Virginia,Mason County,0,27016,13006,14010
West Virginia,Mason County,1,1434,734,700
West Virginia,Mason County,2,1643,819,824
West Virginia,Mason County,3,1656,859,797
West Virginia,Mason County,4,1521,802,719
West Virginia,Mason County,5,1469,718,751
West Virginia,Mason County,6,1426,662,764
West Virginia,Mason County,7,1600,710,890
West Virginia,Mason County,8,1672,774,898
West Virginia,Mason County,9,1673,827,846
West Virginia,Mason County,10,1670,804,866
West Virginia,Mason County,11,2055,1008,1047
West Virginia,Mason County,12,2192,1046,1146
West Virginia,Mason County,13,1934,937,997
West Virginia,Mason County,14,1648,824,824
West Virginia,Mason County,15,1292,603,689
West Virginia,Mason County,16,944,430,514
West Virginia,Mason County,17,658,261,397
West Virginia,Mason County,18,529,188,341
West Virginia,Mercer County,0,61785,29594,32191
West Virginia,Mercer County,1,3944,2031,1913
West Virginia,Mercer County,2,3402,1758,1644
West Virginia,Mercer County,3,3407,1692,1715
West Virginia,Mercer County,4,3674,1901,1773
West Virginia,Mercer County,5,4012,1979,2033
West Virginia,Mercer County,6,3593,1812,1781
West Virginia,Mercer County,7,3389,1584,1805
West Virginia,Mercer County,8,3591,1746,1845
West Virginia,Mercer County,9,3805,1867,1938
West Virginia,Mercer County,10,3738,1877,1861
West Virginia,Mercer County,11,4000,1906,2094
West Virginia,Mercer County,12,4616,2125,2491
West Virginia,Mercer County,13,4686,2158,2528
West Virginia,Mercer County,14,3975,1886,2089
West Virginia,Mercer County,15,2778,1316,1462
West Virginia,Mercer County,16,2135,920,1215
West Virginia,Mercer County,17,1512,583,929
West Virginia,Mercer County,18,1528,453,1075
West Virginia,Mineral County,0,27578,13689,13889
West Virginia,Mineral County,1,1449,719,730
West Virginia,Mineral County,2,1482,803,679
West Virginia,Mineral County,3,1618,865,753
West Virginia,Mineral County,4,1867,990,877
West Virginia,Mineral County,5,1731,902,829
West Virginia,Mineral County,6,1440,746,694
West Virginia,Mineral County,7,1467,738,729
West Virginia,Mineral County,8,1447,706,741
West Virginia,Mineral County,9,1783,921,862
West Virginia,Mineral County,10,1900,955,945
West Virginia,Mineral County,11,1984,957,1027
West Virginia,Mineral County,12,1975,921,1054
West Virginia,Mineral County,13,1953,941,1012
West Virginia,Mineral County,14,1901,912,989
West Virginia,Mineral County,15,1422,706,716
West Virginia,Mineral County,16,992,450,542
West Virginia,Mineral County,17,600,238,362
West Virginia,Mineral County,18,567,219,348
West Virginia,Mingo County,0,25716,12675,13041
West Virginia,Mingo County,1,1653,869,784
West Virginia,Mingo County,2,1540,798,742
West Virginia,Mingo County,3,1617,833,784
West Virginia,Mingo County,4,1353,702,651
West Virginia,Mingo County,5,1429,718,711
West Virginia,Mingo County,6,1481,708,773
West Virginia,Mingo County,7,1591,750,841
West Virginia,Mingo County,8,1685,861,824
West Virginia,Mingo County,9,1701,848,853
West Virginia,Mingo County,10,1753,846,907
West Virginia,Mingo County,11,1879,939,940
West Virginia,Mingo County,12,2082,1014,1068
West Virginia,Mingo County,13,1954,913,1041
West Virginia,Mingo County,14,1546,771,775
West Virginia,Mingo County,15,982,510,472
West Virginia,Mingo County,16,663,286,377
West Virginia,Mingo County,17,433,163,270
West Virginia,Mingo County,18,374,146,228
West Virginia,Monongalia County,0,103463,53229,50234
West Virginia,Monongalia County,1,5178,2616,2562
West Virginia,Monongalia County,2,4539,2360,2179
West Virginia,Monongalia County,3,4248,2175,2073
West Virginia,Monongalia County,4,8916,4677,4239
West Virginia,Monongalia County,5,17818,9288,8530
West Virginia,Monongalia County,6,10066,5543,4523
West Virginia,Monongalia County,7,7786,4262,3524
West Virginia,Monongalia County,8,6052,3293,2759
West Virginia,Monongalia County,9,5600,2978,2622
West Virginia,Monongalia County,10,5344,2717,2627
West Virginia,Monongalia County,11,5651,2837,2814
West Virginia,Monongalia County,12,5678,2829,2849
West Virginia,Monongalia County,13,5440,2692,2748
West Virginia,Monongalia County,14,3860,1899,1961
West Virginia,Monongalia County,15,2626,1235,1391
West Virginia,Monongalia County,16,1807,797,1010
West Virginia,Monongalia County,17,1377,570,807
West Virginia,Monongalia County,18,1477,461,1016
West Virginia,Monroe County,0,13582,6710,6872
West Virginia,Monroe County,1,738,360,378
West Virginia,Monroe County,2,804,425,379
West Virginia,Monroe County,3,841,421,420
West Virginia,Monroe County,4,706,376,330
West Virginia,Monroe County,5,658,323,335
West Virginia,Monroe County,6,654,341,313
West Virginia,Monroe County,7,668,322,346
West Virginia,Monroe County,8,735,379,356
West Virginia,Monroe County,9,832,414,418
West Virginia,Monroe County,10,881,438,443
West Virginia,Monroe County,11,990,470,520
West Virginia,Monroe County,12,1048,543,505
West Virginia,Monroe County,13,983,471,512
West Virginia,Monroe County,14,1040,501,539
West Virginia,Monroe County,15,788,398,390
West Virginia,Monroe County,16,537,249,288
West Virginia,Monroe County,17,348,159,189
West Virginia,Monroe County,18,331,120,211
West Virginia,Morgan County,0,17453,8648,8805
West Virginia,Morgan County,1,707,342,365
West Virginia,Morgan County,2,870,455,415
West Virginia,Morgan County,3,1037,540,497
West Virginia,Morgan County,4,1081,536,545
West Virginia,Morgan County,5,834,424,410
West Virginia,Morgan County,6,827,397,430
West Virginia,Morgan County,7,810,421,389
West Virginia,Morgan County,8,900,419,481
West Virginia,Morgan County,9,1157,604,553
West Virginia,Morgan County,10,1284,657,627
West Virginia,Morgan County,11,1430,740,690
West Virginia,Morgan County,12,1430,683,747
West Virginia,Morgan County,13,1435,700,735
West Virginia,Morgan County,14,1222,606,616
West Virginia,Morgan County,15,919,438,481
West Virginia,Morgan County,16,679,335,344
West Virginia,Morgan County,17,468,199,269
West Virginia,Morgan County,18,363,152,211
West Virginia,Nicholas County,0,25827,12723,13104
West Virginia,Nicholas County,1,1501,763,738
West Virginia,Nicholas County,2,1548,800,748
West Virginia,Nicholas County,3,1455,749,706
West Virginia,Nicholas County,4,1357,725,632
West Virginia,Nicholas County,5,1521,729,792
West Virginia,Nicholas County,6,1328,677,651
West Virginia,Nicholas County,7,1390,683,707
West Virginia,Nicholas County,8,1495,706,789
West Virginia,Nicholas County,9,1666,825,841
West Virginia,Nicholas County,10,1668,828,840
West Virginia,Nicholas County,11,1898,939,959
West Virginia,Nicholas County,12,2032,972,1060
West Virginia,Nicholas County,13,2015,989,1026
West Virginia,Nicholas County,14,1688,871,817
West Virginia,Nicholas County,15,1289,627,662
West Virginia,Nicholas County,16,908,428,480
West Virginia,Nicholas County,17,554,234,320
West Virginia,Nicholas County,18,514,178,336
West Virginia,Ohio County,0,43328,20746,22582
West Virginia,Ohio County,1,2389,1170,1219
West Virginia,Ohio County,2,2252,1182,1070
West Virginia,Ohio County,3,2238,1119,1119
West Virginia,Ohio County,4,2943,1443,1500
West Virginia,Ohio County,5,3200,1576,1624
West Virginia,Ohio County,6,2394,1181,1213
West Virginia,Ohio County,7,2397,1244,1153
West Virginia,Ohio County,8,2300,1192,1108
West Virginia,Ohio County,9,2441,1183,1258
West Virginia,Ohio County,10,2556,1253,1303
West Virginia,Ohio County,11,3033,1449,1584
West Virginia,Ohio County,12,3468,1702,1766
West Virginia,Ohio County,13,3266,1557,1709
West Virginia,Ohio County,14,2565,1233,1332
West Virginia,Ohio County,15,1787,815,972
West Virginia,Ohio County,16,1449,603,846
West Virginia,Ohio County,17,1239,428,811
West Virginia,Ohio County,18,1411,416,995
West Virginia,Pendleton County,0,7371,3779,3592
West Virginia,Pendleton County,1,336,172,164
West Virginia,Pendleton County,2,346,184,162
West Virginia,Pendleton County,3,382,189,193
West Virginia,Pendleton County,4,378,200,178
West Virginia,Pendleton County,5,448,275,173
West Virginia,Pendleton County,6,347,176,171
West Virginia,Pendleton County,7,355,189,166
West Virginia,Pendleton County,8,353,196,157
West Virginia,Pendleton County,9,378,199,179
West Virginia,Pendleton County,10,468,229,239
West Virginia,Pendleton County,11,553,287,266
West Virginia,Pendleton County,12,611,303,308
West Virginia,Pendleton County,13,602,293,309
West Virginia,Pendleton County,14,533,282,251
West Virginia,Pendleton County,15,411,182,229
West Virginia,Pendleton County,16,339,166,173
West Virginia,Pendleton County,17,244,128,116
West Virginia,Pendleton County,18,287,129,158
West Virginia,Pleasants County,0,7634,4093,3541
West Virginia,Pleasants County,1,351,189,162
West Virginia,Pleasants County,2,382,208,174
West Virginia,Pleasants County,3,452,228,224
West Virginia,Pleasants County,4,466,262,204
West Virginia,Pleasants County,5,471,276,195
West Virginia,Pleasants County,6,403,255,148
West Virginia,Pleasants County,7,458,258,200
West Virginia,Pleasants County,8,469,280,189
West Virginia,Pleasants County,9,536,281,255
West Virginia,Pleasants County,10,562,312,250
West Virginia,Pleasants County,11,604,328,276
West Virginia,Pleasants County,12,576,292,284
West Virginia,Pleasants County,13,504,257,247
West Virginia,Pleasants County,14,479,239,240
West Virginia,Pleasants County,15,354,190,164
West Virginia,Pleasants County,16,258,133,125
West Virginia,Pleasants County,17,153,50,103
West Virginia,Pleasants County,18,156,55,101
West Virginia,Pocahontas County,0,8662,4473,4189
West Virginia,Pocahontas County,1,424,221,203
West Virginia,Pocahontas County,2,389,188,201
West Virginia,Pocahontas County,3,403,208,195
West Virginia,Pocahontas County,4,432,228,204
West Virginia,Pocahontas County,5,418,218,200
West Virginia,Pocahontas County,6,448,249,199
West Virginia,Pocahontas County,7,463,263,200
West Virginia,Pocahontas County,8,499,266,233
West Virginia,Pocahontas County,9,473,259,214
West Virginia,Pocahontas County,10,566,279,287
West Virginia,Pocahontas County,11,707,374,333
West Virginia,Pocahontas County,12,783,416,367
West Virginia,Pocahontas County,13,714,354,360
West Virginia,Pocahontas County,14,681,354,327
West Virginia,Pocahontas County,15,487,244,243
West Virginia,Pocahontas County,16,359,189,170
West Virginia,Pocahontas County,17,240,110,130
West Virginia,Pocahontas County,18,176,53,123
West Virginia,Preston County,0,33788,17405,16383
West Virginia,Preston County,1,1672,875,797
West Virginia,Preston County,2,1865,941,924
West Virginia,Preston County,3,1818,905,913
West Virginia,Preston County,4,1782,933,849
West Virginia,Preston County,5,1868,950,918
West Virginia,Preston County,6,2256,1338,918
West Virginia,Preston County,7,2266,1182,1084
West Virginia,Preston County,8,2145,1169,976
West Virginia,Preston County,9,2326,1285,1041
West Virginia,Preston County,10,2325,1193,1132
West Virginia,Preston County,11,2581,1404,1177
West Virginia,Preston County,12,2465,1225,1240
West Virginia,Preston County,13,2550,1263,1287
West Virginia,Preston County,14,1975,995,980
West Virginia,Preston County,15,1486,728,758
West Virginia,Preston County,16,1048,498,550
West Virginia,Preston County,17,685,288,397
West Virginia,Preston County,18,675,233,442
West Virginia,Putnam County,0,56770,27952,28818
West Virginia,Putnam County,1,3067,1624,1443
West Virginia,Putnam County,2,3643,1879,1764
West Virginia,Putnam County,3,3991,1982,2009
West Virginia,Putnam County,4,3442,1792,1650
West Virginia,Putnam County,5,2773,1428,1345
West Virginia,Putnam County,6,2898,1463,1435
West Virginia,Putnam County,7,3470,1715,1755
West Virginia,Putnam County,8,3741,1775,1966
West Virginia,Putnam County,9,4054,2008,2046
West Virginia,Putnam County,10,3953,2002,1951
West Virginia,Putnam County,11,4204,2030,2174
West Virginia,Putnam County,12,4248,2089,2159
West Virginia,Putnam County,13,3869,1892,1977
West Virginia,Putnam County,14,3227,1556,1671
West Virginia,Putnam County,15,2419,1142,1277
West Virginia,Putnam County,16,1727,798,929
West Virginia,Putnam County,17,1112,431,681
West Virginia,Putnam County,18,932,346,586
West Virginia,Raleigh County,0,78241,39169,39072
West Virginia,Raleigh County,1,4879,2449,2430
West Virginia,Raleigh County,2,4642,2364,2278
West Virginia,Raleigh County,3,4486,2307,2179
West Virginia,Raleigh County,4,4077,2112,1965
West Virginia,Raleigh County,5,4551,2404,2147
West Virginia,Raleigh County,6,4753,2563,2190
West Virginia,Raleigh County,7,4944,2588,2356
West Virginia,Raleigh County,8,5151,2706,2445
West Virginia,Raleigh County,9,5284,2770,2514
West Virginia,Raleigh County,10,4634,2421,2213
West Virginia,Raleigh County,11,5004,2474,2530
West Virginia,Raleigh County,12,5843,2814,3029
West Virginia,Raleigh County,13,5773,2871,2902
West Virginia,Raleigh County,14,4972,2400,2572
West Virginia,Raleigh County,15,3218,1565,1653
West Virginia,Raleigh County,16,2487,1058,1429
West Virginia,Raleigh County,17,1868,768,1100
West Virginia,Raleigh County,18,1675,535,1140
West Virginia,Randolph County,0,29429,15226,14203
West Virginia,Randolph County,1,1572,807,765
West Virginia,Randolph County,2,1510,783,727
West Virginia,Randolph County,3,1598,834,764
West Virginia,Randolph County,4,1639,854,785
West Virginia,Randolph County,5,1887,1046,841
West Virginia,Randolph County,6,1732,991,741
West Virginia,Randolph County,7,1749,1025,724
West Virginia,Randolph County,8,1635,857,778
West Virginia,Randolph County,9,1841,983,858
West Virginia,Randolph County,10,1978,1066,912
West Virginia,Randolph County,11,2179,1117,1062
West Virginia,Randolph County,12,2190,1123,1067
West Virginia,Randolph County,13,2046,987,1059
West Virginia,Randolph County,14,1997,1014,983
West Virginia,Randolph County,15,1506,713,793
West Virginia,Randolph County,16,1035,524,511
West Virginia,Randolph County,17,599,244,355
West Virginia,Randolph County,18,736,258,478
West Virginia,Ritchie County,0,10011,4974,5037
West Virginia,Ritchie County,1,475,227,248
West Virginia,Ritchie County,2,577,284,293
West Virginia,Ritchie County,3,620,336,284
West Virginia,Ritchie County,4,561,283,278
West Virginia,Ritchie County,5,541,281,260
West Virginia,Ritchie County,6,413,212,201
West Virginia,Ritchie County,7,557,277,280
West Virginia,Ritchie County,8,552,265,287
West Virginia,Ritchie County,9,632,311,321
West Virginia,Ritchie County,10,691,338,353
West Virginia,Ritchie County,11,790,430,360
West Virginia,Ritchie County,12,838,408,430
West Virginia,Ritchie County,13,747,388,359
West Virginia,Ritchie County,14,729,359,370
West Virginia,Ritchie County,15,450,216,234
West Virginia,Ritchie County,16,402,194,208
West Virginia,Ritchie County,17,228,103,125
West Virginia,Ritchie County,18,208,62,146
West Virginia,Roane County,0,14664,7272,7392
West Virginia,Roane County,1,829,428,401
West Virginia,Roane County,2,867,431,436
West Virginia,Roane County,3,953,489,464
West Virginia,Roane County,4,833,450,383
West Virginia,Roane County,5,769,398,371
West Virginia,Roane County,6,671,335,336
West Virginia,Roane County,7,767,377,390
West Virginia,Roane County,8,872,414,458
West Virginia,Roane County,9,942,469,473
West Virginia,Roane County,10,915,467,448
West Virginia,Roane County,11,1102,550,552
West Virginia,Roane County,12,1187,590,597
West Virginia,Roane County,13,1128,554,574
West Virginia,Roane County,14,962,508,454
West Virginia,Roane County,15,708,338,370
West Virginia,Roane County,16,551,274,277
West Virginia,Roane County,17,307,108,199
West Virginia,Roane County,18,301,92,209
West Virginia,Summers County,0,13417,6007,7410
West Virginia,Summers County,1,550,258,292
West Virginia,Summers County,2,685,358,327
West Virginia,Summers County,3,656,333,323
West Virginia,Summers County,4,620,293,327
West Virginia,Summers County,5,647,289,358
West Virginia,Summers County,6,728,253,475
West Virginia,Summers County,7,783,311,472
West Virginia,Summers County,8,898,369,529
West Virginia,Summers County,9,844,349,495
West Virginia,Summers County,10,883,366,517
West Virginia,Summers County,11,1037,441,596
West Virginia,Summers County,12,1107,510,597
West Virginia,Summers County,13,1142,590,552
West Virginia,Summers County,14,938,462,476
West Virginia,Summers County,15,661,313,348
West Virginia,Summers County,16,499,212,287
West Virginia,Summers County,17,376,151,225
West Virginia,Summers County,18,363,149,214
West Virginia,Taylor County,0,17069,8654,8415
West Virginia,Taylor County,1,917,469,448
West Virginia,Taylor County,2,981,526,455
West Virginia,Taylor County,3,1017,534,483
West Virginia,Taylor County,4,885,427,458
West Virginia,Taylor County,5,930,502,428
West Virginia,Taylor County,6,1023,572,451
West Virginia,Taylor County,7,1069,557,512
West Virginia,Taylor County,8,1046,525,521
West Virginia,Taylor County,9,1155,604,551
West Virginia,Taylor County,10,1216,627,589
West Virginia,Taylor County,11,1279,677,602
West Virginia,Taylor County,12,1277,648,629
West Virginia,Taylor County,13,1244,596,648
West Virginia,Taylor County,14,1011,525,486
West Virginia,Taylor County,15,750,359,391
West Virginia,Taylor County,16,525,232,293
West Virginia,Taylor County,17,361,142,219
West Virginia,Taylor County,18,383,132,251
West Virginia,Tucker County,0,6927,3505,3422
West Virginia,Tucker County,1,286,155,131
West Virginia,Tucker County,2,286,148,138
West Virginia,Tucker County,3,358,192,166
West Virginia,Tucker County,4,384,218,166
West Virginia,Tucker County,5,388,193,195
West Virginia,Tucker County,6,321,162,159
West Virginia,Tucker County,7,365,182,183
West Virginia,Tucker County,8,351,166,185
West Virginia,Tucker County,9,437,231,206
West Virginia,Tucker County,10,517,254,263
West Virginia,Tucker County,11,561,294,267
West Virginia,Tucker County,12,543,255,288
West Virginia,Tucker County,13,558,292,266
West Virginia,Tucker County,14,524,265,259
West Virginia,Tucker County,15,393,189,204
West Virginia,Tucker County,16,319,168,151
West Virginia,Tucker County,17,179,82,97
West Virginia,Tucker County,18,157,59,98
West Virginia,Tyler County,0,9098,4501,4597
West Virginia,Tyler County,1,418,213,205
West Virginia,Tyler County,2,529,262,267
West Virginia,Tyler County,3,541,277,264
West Virginia,Tyler County,4,503,236,267
West Virginia,Tyler County,5,513,258,255
West Virginia,Tyler County,6,414,216,198
West Virginia,Tyler County,7,411,206,205
West Virginia,Tyler County,8,482,247,235
West Virginia,Tyler County,9,602,299,303
West Virginia,Tyler County,10,664,352,312
West Virginia,Tyler County,11,670,323,347
West Virginia,Tyler County,12,758,365,393
West Virginia,Tyler County,13,753,387,366
West Virginia,Tyler County,14,614,313,301
West Virginia,Tyler County,15,435,218,217
West Virginia,Tyler County,16,349,153,196
West Virginia,Tyler County,17,229,84,145
West Virginia,Tyler County,18,213,92,121
West Virginia,Upshur County,0,24731,12255,12476
West Virginia,Upshur County,1,1378,721,657
West Virginia,Upshur County,2,1484,757,727
West Virginia,Upshur County,3,1406,705,701
West Virginia,Upshur County,4,1704,827,877
West Virginia,Upshur County,5,1948,955,993
West Virginia,Upshur County,6,1374,693,681
West Virginia,Upshur County,7,1387,668,719
West Virginia,Upshur County,8,1320,701,619
West Virginia,Upshur County,9,1509,764,745
West Virginia,Upshur County,10,1547,766,781
West Virginia,Upshur County,11,1697,844,853
West Virginia,Upshur County,12,1765,867,898
West Virginia,Upshur County,13,1705,865,840
West Virginia,Upshur County,14,1484,755,729
West Virginia,Upshur County,15,1197,564,633
West Virginia,Upshur County,16,843,404,439
West Virginia,Upshur County,17,525,235,290
West Virginia,Upshur County,18,458,164,294
West Virginia,Wayne County,0,41122,20062,21060
West Virginia,Wayne County,1,2004,1009,995
West Virginia,Wayne County,2,2434,1256,1178
West Virginia,Wayne County,3,2601,1324,1277
West Virginia,Wayne County,4,2520,1291,1229
West Virginia,Wayne County,5,2389,1198,1191
West Virginia,Wayne County,6,2155,1084,1071
West Virginia,Wayne County,7,2400,1154,1246
West Virginia,Wayne County,8,2536,1213,1323
West Virginia,Wayne County,9,2790,1381,1409
West Virginia,Wayne County,10,2793,1381,1412
West Virginia,Wayne County,11,2987,1422,1565
West Virginia,Wayne County,12,3079,1501,1578
West Virginia,Wayne County,13,2847,1375,1472
West Virginia,Wayne County,14,2574,1223,1351
West Virginia,Wayne County,15,1821,872,949
West Virginia,Wayne County,16,1395,666,729
West Virginia,Wayne County,17,960,431,529
West Virginia,Wayne County,18,837,281,556
West Virginia,Webster County,0,8834,4367,4467
West Virginia,Webster County,1,496,257,239
West Virginia,Webster County,2,475,249,226
West Virginia,Webster County,3,509,256,253
West Virginia,Webster County,4,438,235,203
West Virginia,Webster County,5,464,228,236
West Virginia,Webster County,6,403,197,206
West Virginia,Webster County,7,434,213,221
West Virginia,Webster County,8,469,233,236
West Virginia,Webster County,9,583,290,293
West Virginia,Webster County,10,589,289,300
West Virginia,Webster County,11,633,318,315
West Virginia,Webster County,12,723,357,366
West Virginia,Webster County,13,723,353,370
West Virginia,Webster County,14,693,352,341
West Virginia,Webster County,15,458,240,218
West Virginia,Webster County,16,310,145,165
West Virginia,Webster County,17,218,78,140
West Virginia,Webster County,18,216,77,139
West Virginia,Wetzel County,0,15988,7893,8095
West Virginia,Wetzel County,1,846,429,417
West Virginia,Wetzel County,2,810,431,379
West Virginia,Wetzel County,3,903,461,442
West Virginia,Wetzel County,4,990,520,470
West Virginia,Wetzel County,5,897,463,434
West Virginia,Wetzel County,6,790,408,382
West Virginia,Wetzel County,7,807,418,389
West Virginia,Wetzel County,8,817,399,418
West Virginia,Wetzel County,9,1012,489,523
West Virginia,Wetzel County,10,1057,525,532
West Virginia,Wetzel County,11,1268,634,634
West Virginia,Wetzel County,12,1227,609,618
West Virginia,Wetzel County,13,1150,573,577
West Virginia,Wetzel County,14,1042,521,521
West Virginia,Wetzel County,15,889,378,511
West Virginia,Wetzel County,16,677,324,353
West Virginia,Wetzel County,17,436,192,244
West Virginia,Wetzel County,18,370,119,251
West Virginia,Wirt County,0,5845,2952,2893
West Virginia,Wirt County,1,313,155,158
West Virginia,Wirt County,2,348,197,151
West Virginia,Wirt County,3,355,189,166
West Virginia,Wirt County,4,335,172,163
West Virginia,Wirt County,5,303,144,159
West Virginia,Wirt County,6,264,129,135
West Virginia,Wirt County,7,304,146,158
West Virginia,Wirt County,8,336,168,168
West Virginia,Wirt County,9,351,162,189
West Virginia,Wirt County,10,423,215,208
West Virginia,Wirt County,11,516,248,268
West Virginia,Wirt County,12,510,267,243
West Virginia,Wirt County,13,413,208,205
West Virginia,Wirt County,14,398,216,182
West Virginia,Wirt County,15,288,145,143
West Virginia,Wirt County,16,206,118,88
West Virginia,Wirt County,17,114,49,65
West Virginia,Wirt County,18,68,24,44
West Virginia,Wood County,0,86237,41777,44460
West Virginia,Wood County,1,4693,2424,2269
West Virginia,Wood County,2,5008,2517,2491
West Virginia,Wood County,3,5117,2654,2463
West Virginia,Wood County,4,5146,2608,2538
West Virginia,Wood County,5,4962,2398,2564
West Virginia,Wood County,6,4769,2307,2462
West Virginia,Wood County,7,5193,2594,2599
West Virginia,Wood County,8,4993,2455,2538
West Virginia,Wood County,9,5512,2752,2760
West Virginia,Wood County,10,5829,2921,2908
West Virginia,Wood County,11,6585,3166,3419
West Virginia,Wood County,12,6530,3182,3348
West Virginia,Wood County,13,5881,2782,3099
West Virginia,Wood County,14,5212,2453,2759
West Virginia,Wood County,15,4063,1896,2167
West Virginia,Wood County,16,2971,1320,1651
West Virginia,Wood County,17,1924,777,1147
West Virginia,Wood County,18,1849,571,1278
West Virginia,Wyoming County,0,22598,11178,11420
West Virginia,Wyoming County,1,1208,622,586
West Virginia,Wyoming County,2,1337,678,659
West Virginia,Wyoming County,3,1409,690,719
West Virginia,Wyoming County,4,1343,717,626
West Virginia,Wyoming County,5,1215,597,618
West Virginia,Wyoming County,6,1163,587,576
West Virginia,Wyoming County,7,1148,562,586
West Virginia,Wyoming County,8,1511,732,779
West Virginia,Wyoming County,9,1506,778,728
West Virginia,Wyoming County,10,1416,703,713
West Virginia,Wyoming County,11,1586,763,823
West Virginia,Wyoming County,12,1871,927,944
West Virginia,Wyoming County,13,1926,964,962
West Virginia,Wyoming County,14,1505,766,739
West Virginia,Wyoming County,15,949,466,483
West Virginia,Wyoming County,16,670,304,366
West Virginia,Wyoming County,17,465,183,282
West Virginia,Wyoming County,18,370,139,231
Wisconsin,Adams County,0,20215,10830,9385
Wisconsin,Adams County,1,744,353,391
Wisconsin,Adams County,2,820,433,387
Wisconsin,Adams County,3,862,433,429
Wisconsin,Adams County,4,912,462,450
Wisconsin,Adams County,5,821,481,340
Wisconsin,Adams County,6,935,591,344
Wisconsin,Adams County,7,1063,681,382
Wisconsin,Adams County,8,941,583,358
Wisconsin,Adams County,9,1052,620,432
Wisconsin,Adams County,10,1225,665,560
Wisconsin,Adams County,11,1685,889,796
Wisconsin,Adams County,12,1826,954,872
Wisconsin,Adams County,13,1851,929,922
Wisconsin,Adams County,14,1805,935,870
Wisconsin,Adams County,15,1541,777,764
Wisconsin,Adams County,16,1050,538,512
Wisconsin,Adams County,17,584,288,296
Wisconsin,Adams County,18,498,218,280
Wisconsin,Ashland County,0,16103,8102,8001
Wisconsin,Ashland County,1,991,506,485
Wisconsin,Ashland County,2,1035,519,516
Wisconsin,Ashland County,3,983,525,458
Wisconsin,Ashland County,4,1114,592,522
Wisconsin,Ashland County,5,1075,576,499
Wisconsin,Ashland County,6,828,431,397
Wisconsin,Ashland County,7,936,473,463
Wisconsin,Ashland County,8,887,457,430
Wisconsin,Ashland County,9,799,388,411
Wisconsin,Ashland County,10,995,528,467
Wisconsin,Ashland County,11,1245,589,656
Wisconsin,Ashland County,12,1242,610,632
Wisconsin,Ashland County,13,1163,585,578
Wisconsin,Ashland County,14,891,441,450
Wisconsin,Ashland County,15,697,356,341
Wisconsin,Ashland County,16,479,240,239
Wisconsin,Ashland County,17,347,162,185
Wisconsin,Ashland County,18,396,124,272
Wisconsin,Barron County,0,45455,22623,22832
Wisconsin,Barron County,1,2723,1379,1344
Wisconsin,Barron County,2,2783,1415,1368
Wisconsin,Barron County,3,2687,1328,1359
Wisconsin,Barron County,4,2578,1347,1231
Wisconsin,Barron County,5,2464,1294,1170
Wisconsin,Barron County,6,2303,1170,1133
Wisconsin,Barron County,7,2628,1366,1262
Wisconsin,Barron County,8,2400,1227,1173
Wisconsin,Barron County,9,2624,1312,1312
Wisconsin,Barron County,10,2762,1415,1347
Wisconsin,Barron County,11,3567,1811,1756
Wisconsin,Barron County,12,3546,1750,1796
Wisconsin,Barron County,13,3214,1610,1604
Wisconsin,Barron County,14,2917,1450,1467
Wisconsin,Barron County,15,2221,1080,1141
Wisconsin,Barron County,16,1580,732,848
Wisconsin,Barron County,17,1225,521,704
Wisconsin,Barron County,18,1233,416,817
Wisconsin,Bayfield County,0,14985,7663,7322
Wisconsin,Bayfield County,1,655,357,298
Wisconsin,Bayfield County,2,699,369,330
Wisconsin,Bayfield County,3,806,416,390
Wisconsin,Bayfield County,4,803,423,380
Wisconsin,Bayfield County,5,641,325,316
Wisconsin,Bayfield County,6,568,298,270
Wisconsin,Bayfield County,7,678,350,328
Wisconsin,Bayfield County,8,647,328,319
Wisconsin,Bayfield County,9,736,378,358
Wisconsin,Bayfield County,10,953,484,469
Wisconsin,Bayfield County,11,1231,606,625
Wisconsin,Bayfield County,12,1465,738,727
Wisconsin,Bayfield County,13,1528,780,748
Wisconsin,Bayfield County,14,1288,666,622
Wisconsin,Bayfield County,15,947,471,476
Wisconsin,Bayfield County,16,614,330,284
Wisconsin,Bayfield County,17,407,213,194
Wisconsin,Bayfield County,18,319,131,188
Wisconsin,Brown County,0,256670,127290,129380
Wisconsin,Brown County,1,17306,8839,8467
Wisconsin,Brown County,2,17425,8890,8535
Wisconsin,Brown County,3,17404,8822,8582
Wisconsin,Brown County,4,17009,8565,8444
Wisconsin,Brown County,5,17380,8733,8647
Wisconsin,Brown County,6,17542,8941,8601
Wisconsin,Brown County,7,17915,9071,8844
Wisconsin,Brown County,8,16044,8168,7876
Wisconsin,Brown County,9,15938,8112,7826
Wisconsin,Brown County,10,17394,8786,8608
Wisconsin,Brown County,11,19452,9685,9767
Wisconsin,Brown County,12,17564,8704,8860
Wisconsin,Brown County,13,14801,7246,7555
Wisconsin,Brown County,14,11007,5302,5705
Wisconsin,Brown County,15,7652,3475,4177
Wisconsin,Brown County,16,5864,2624,3240
Wisconsin,Brown County,17,4267,1763,2504
Wisconsin,Brown County,18,4706,1564,3142
Wisconsin,Buffalo County,0,13188,6682,6506
Wisconsin,Buffalo County,1,689,325,364
Wisconsin,Buffalo County,2,795,387,408
Wisconsin,Buffalo County,3,794,383,411
Wisconsin,Buffalo County,4,777,414,363
Wisconsin,Buffalo County,5,673,341,332
Wisconsin,Buffalo County,6,663,358,305
Wisconsin,Buffalo County,7,713,360,353
Wisconsin,Buffalo County,8,661,331,330
Wisconsin,Buffalo County,9,743,362,381
Wisconsin,Buffalo County,10,907,488,419
Wisconsin,Buffalo County,11,1080,550,530
Wisconsin,Buffalo County,12,1071,540,531
Wisconsin,Buffalo County,13,979,538,441
Wisconsin,Buffalo County,14,835,452,383
Wisconsin,Buffalo County,15,614,310,304
Wisconsin,Buffalo County,16,510,238,272
Wisconsin,Buffalo County,17,345,169,176
Wisconsin,Buffalo County,18,339,136,203
Wisconsin,Burnett County,0,15328,7827,7501
Wisconsin,Burnett County,1,685,381,304
Wisconsin,Burnett County,2,777,408,369
Wisconsin,Burnett County,3,765,394,371
Wisconsin,Burnett County,4,837,422,415
Wisconsin,Burnett County,5,657,340,317
Wisconsin,Burnett County,6,571,291,280
Wisconsin,Burnett County,7,663,327,336
Wisconsin,Burnett County,8,639,321,318
Wisconsin,Burnett County,9,748,399,349
Wisconsin,Burnett County,10,951,478,473
Wisconsin,Burnett County,11,1233,623,610
Wisconsin,Burnett County,12,1366,695,671
Wisconsin,Burnett County,13,1405,722,683
Wisconsin,Burnett County,14,1284,665,619
Wisconsin,Burnett County,15,1084,553,531
Wisconsin,Burnett County,16,756,372,384
Wisconsin,Burnett County,17,493,253,240
Wisconsin,Burnett County,18,414,183,231
Wisconsin,Calumet County,0,49491,24810,24681
Wisconsin,Calumet County,1,3063,1565,1498
Wisconsin,Calumet County,2,3589,1871,1718
Wisconsin,Calumet County,3,3773,1910,1863
Wisconsin,Calumet County,4,3242,1655,1587
Wisconsin,Calumet County,5,2605,1371,1234
Wisconsin,Calumet County,6,2385,1201,1184
Wisconsin,Calumet County,7,3004,1459,1545
Wisconsin,Calumet County,8,3306,1691,1615
Wisconsin,Calumet County,9,3430,1704,1726
Wisconsin,Calumet County,10,3870,1943,1927
Wisconsin,Calumet County,11,4100,2117,1983
Wisconsin,Calumet County,12,3643,1819,1824
Wisconsin,Calumet County,13,2908,1443,1465
Wisconsin,Calumet County,14,2142,1070,1072
Wisconsin,Calumet County,15,1570,774,796
Wisconsin,Calumet County,16,1163,534,629
Wisconsin,Calumet County,17,828,343,485
Wisconsin,Calumet County,18,870,340,530
Wisconsin,Chippewa County,0,63460,32917,30543
Wisconsin,Chippewa County,1,3629,1845,1784
Wisconsin,Chippewa County,2,4224,2173,2051
Wisconsin,Chippewa County,3,4083,2052,2031
Wisconsin,Chippewa County,4,3734,1998,1736
Wisconsin,Chippewa County,5,3382,1838,1544
Wisconsin,Chippewa County,6,3899,2170,1729
Wisconsin,Chippewa County,7,4245,2314,1931
Wisconsin,Chippewa County,8,3873,2135,1738
Wisconsin,Chippewa County,9,3925,2094,1831
Wisconsin,Chippewa County,10,4278,2332,1946
Wisconsin,Chippewa County,11,5019,2653,2366
Wisconsin,Chippewa County,12,4705,2420,2285
Wisconsin,Chippewa County,13,4162,2109,2053
Wisconsin,Chippewa County,14,3345,1693,1652
Wisconsin,Chippewa County,15,2417,1179,1238
Wisconsin,Chippewa County,16,1718,788,930
Wisconsin,Chippewa County,17,1303,600,703
Wisconsin,Chippewa County,18,1519,524,995
Wisconsin,Clark County,0,34423,17379,17044
Wisconsin,Clark County,1,2810,1396,1414
Wisconsin,Clark County,2,2800,1434,1366
Wisconsin,Clark County,3,2808,1424,1384
Wisconsin,Clark County,4,2500,1290,1210
Wisconsin,Clark County,5,1793,942,851
Wisconsin,Clark County,6,1623,853,770
Wisconsin,Clark County,7,1904,983,921
Wisconsin,Clark County,8,1779,955,824
Wisconsin,Clark County,9,1898,947,951
Wisconsin,Clark County,10,2049,1064,985
Wisconsin,Clark County,11,2453,1244,1209
Wisconsin,Clark County,12,2408,1262,1146
Wisconsin,Clark County,13,2075,1068,1007
Wisconsin,Clark County,14,1568,819,749
Wisconsin,Clark County,15,1256,570,686
Wisconsin,Clark County,16,971,464,507
Wisconsin,Clark County,17,793,344,449
Wisconsin,Clark County,18,935,320,615
Wisconsin,Columbia County,0,56615,28751,27864
Wisconsin,Columbia County,1,3073,1461,1612
Wisconsin,Columbia County,2,3515,1794,1721
Wisconsin,Columbia County,3,3739,1879,1860
Wisconsin,Columbia County,4,3525,1843,1682
Wisconsin,Columbia County,5,2914,1567,1347
Wisconsin,Columbia County,6,3056,1644,1412
Wisconsin,Columbia County,7,3498,1842,1656
Wisconsin,Columbia County,8,3540,1847,1693
Wisconsin,Columbia County,9,3682,1944,1738
Wisconsin,Columbia County,10,4121,2169,1952
Wisconsin,Columbia County,11,4562,2316,2246
Wisconsin,Columbia County,12,4406,2251,2155
Wisconsin,Columbia County,13,3834,1974,1860
Wisconsin,Columbia County,14,3061,1533,1528
Wisconsin,Columbia County,15,2173,1066,1107
Wisconsin,Columbia County,16,1560,711,849
Wisconsin,Columbia County,17,1162,501,661
Wisconsin,Columbia County,18,1194,409,785
Wisconsin,Crawford County,0,16392,8428,7964
Wisconsin,Crawford County,1,812,401,411
Wisconsin,Crawford County,2,960,491,469
Wisconsin,Crawford County,3,1029,533,496
Wisconsin,Crawford County,4,1011,535,476
Wisconsin,Crawford County,5,847,484,363
Wisconsin,Crawford County,6,824,449,375
Wisconsin,Crawford County,7,894,491,403
Wisconsin,Crawford County,8,810,418,392
Wisconsin,Crawford County,9,857,467,390
Wisconsin,Crawford County,10,1056,556,500
Wisconsin,Crawford County,11,1325,679,646
Wisconsin,Crawford County,12,1286,647,639
Wisconsin,Crawford County,13,1302,685,617
Wisconsin,Crawford County,14,1060,532,528
Wisconsin,Crawford County,15,895,426,469
Wisconsin,Crawford County,16,598,315,283
Wisconsin,Crawford County,17,389,159,230
Wisconsin,Crawford County,18,437,160,277
Wisconsin,Dane County,0,516284,255980,260304
Wisconsin,Dane County,1,30740,15788,14952
Wisconsin,Dane County,2,30660,15714,14946
Wisconsin,Dane County,3,30087,15533,14554
Wisconsin,Dane County,4,33919,16985,16934
Wisconsin,Dane County,5,53824,27197,26627
Wisconsin,Dane County,6,40018,20674,19344
Wisconsin,Dane County,7,41119,20986,20133
Wisconsin,Dane County,8,34405,17496,16909
Wisconsin,Dane County,9,31970,16049,15921
Wisconsin,Dane County,10,32095,15917,16178
Wisconsin,Dane County,11,34126,16588,17538
Wisconsin,Dane County,12,32420,15777,16643
Wisconsin,Dane County,13,29344,14105,15239
Wisconsin,Dane County,14,22003,10635,11368
Wisconsin,Dane County,15,13961,6466,7495
Wisconsin,Dane County,16,9386,4186,5200
Wisconsin,Dane County,17,7315,2963,4352
Wisconsin,Dane County,18,8892,2921,5971
Wisconsin,Dodge County,0,88574,46671,41903
Wisconsin,Dodge County,1,4310,2263,2047
Wisconsin,Dodge County,2,5115,2644,2471
Wisconsin,Dodge County,3,5512,2726,2786
Wisconsin,Dodge County,4,5328,2772,2556
Wisconsin,Dodge County,5,5177,2969,2208
Wisconsin,Dodge County,6,5350,3287,2063
Wisconsin,Dodge County,7,5785,3306,2479
Wisconsin,Dodge County,8,5495,3155,2340
Wisconsin,Dodge County,9,5693,3141,2552
Wisconsin,Dodge County,10,6466,3494,2972
Wisconsin,Dodge County,11,7500,3975,3525
Wisconsin,Dodge County,12,6905,3655,3250
Wisconsin,Dodge County,13,5509,2805,2704
Wisconsin,Dodge County,14,4232,2130,2102
Wisconsin,Dodge County,15,3280,1560,1720
Wisconsin,Dodge County,16,2617,1210,1407
Wisconsin,Dodge County,17,2023,836,1187
Wisconsin,Dodge County,18,2277,743,1534
Wisconsin,Door County,0,27766,13659,14107
Wisconsin,Door County,1,1087,544,543
Wisconsin,Door County,2,1319,675,644
Wisconsin,Door County,3,1380,679,701
Wisconsin,Door County,4,1368,704,664
Wisconsin,Door County,5,1221,655,566
Wisconsin,Door County,6,1071,558,513
Wisconsin,Door County,7,1355,662,693
Wisconsin,Door County,8,1294,684,610
Wisconsin,Door County,9,1384,704,680
Wisconsin,Door County,10,1605,802,803
Wisconsin,Door County,11,2205,1104,1101
Wisconsin,Door County,12,2459,1216,1243
Wisconsin,Door County,13,2678,1299,1379
Wisconsin,Door County,14,2432,1174,1258
Wisconsin,Door County,15,1814,879,935
Wisconsin,Door County,16,1249,607,642
Wisconsin,Door County,17,888,383,505
Wisconsin,Door County,18,957,330,627
Wisconsin,Douglas County,0,43698,21815,21883
Wisconsin,Douglas County,1,2318,1168,1150
Wisconsin,Douglas County,2,2553,1320,1233
Wisconsin,Douglas County,3,2554,1294,1260
Wisconsin,Douglas County,4,2699,1369,1330
Wisconsin,Douglas County,5,2865,1443,1422
Wisconsin,Douglas County,6,2870,1473,1397
Wisconsin,Douglas County,7,2820,1370,1450
Wisconsin,Douglas County,8,2494,1280,1214
Wisconsin,Douglas County,9,2597,1345,1252
Wisconsin,Douglas County,10,2753,1374,1379
Wisconsin,Douglas County,11,3482,1669,1813
Wisconsin,Douglas County,12,3439,1767,1672
Wisconsin,Douglas County,13,3134,1595,1539
Wisconsin,Douglas County,14,2395,1255,1140
Wisconsin,Douglas County,15,1687,851,836
Wisconsin,Douglas County,16,1222,545,677
Wisconsin,Douglas County,17,880,385,495
Wisconsin,Douglas County,18,936,312,624
Wisconsin,Dunn County,0,44305,22341,21964
Wisconsin,Dunn County,1,2238,1140,1098
Wisconsin,Dunn County,2,2509,1311,1198
Wisconsin,Dunn County,3,2533,1311,1222
Wisconsin,Dunn County,4,4125,2013,2112
Wisconsin,Dunn County,5,5773,2996,2777
Wisconsin,Dunn County,6,2625,1424,1201
Wisconsin,Dunn County,7,2462,1266,1196
Wisconsin,Dunn County,8,2360,1231,1129
Wisconsin,Dunn County,9,2387,1211,1176
Wisconsin,Dunn County,10,2460,1267,1193
Wisconsin,Dunn County,11,2935,1519,1416
Wisconsin,Dunn County,12,2844,1439,1405
Wisconsin,Dunn County,13,2555,1263,1292
Wisconsin,Dunn County,14,2175,1080,1095
Wisconsin,Dunn County,15,1490,753,737
Wisconsin,Dunn County,16,1009,454,555
Wisconsin,Dunn County,17,811,337,474
Wisconsin,Dunn County,18,1014,326,688
Wisconsin,Eau Claire County,0,101564,50097,51467
Wisconsin,Eau Claire County,1,5934,3182,2752
Wisconsin,Eau Claire County,2,5794,3025,2769
Wisconsin,Eau Claire County,3,5671,2976,2695
Wisconsin,Eau Claire County,4,7890,3707,4183
Wisconsin,Eau Claire County,5,12884,6094,6790
Wisconsin,Eau Claire County,6,7205,3728,3477
Wisconsin,Eau Claire County,7,6765,3525,3240
Wisconsin,Eau Claire County,8,5510,2880,2630
Wisconsin,Eau Claire County,9,5436,2772,2664
Wisconsin,Eau Claire County,10,5560,2765,2795
Wisconsin,Eau Claire County,11,6479,3267,3212
Wisconsin,Eau Claire County,12,6299,3091,3208
Wisconsin,Eau Claire County,13,5846,2784,3062
Wisconsin,Eau Claire County,14,4714,2289,2425
Wisconsin,Eau Claire County,15,3225,1545,1680
Wisconsin,Eau Claire County,16,2287,977,1310
Wisconsin,Eau Claire County,17,1828,758,1070
Wisconsin,Eau Claire County,18,2237,732,1505
Wisconsin,Florence County,0,4481,2305,2176
Wisconsin,Florence County,1,156,88,68
Wisconsin,Florence County,2,198,94,104
Wisconsin,Florence County,3,186,99,87
Wisconsin,Florence County,4,204,107,97
Wisconsin,Florence County,5,187,97,90
Wisconsin,Florence County,6,176,100,76
Wisconsin,Florence County,7,181,92,89
Wisconsin,Florence County,8,202,108,94
Wisconsin,Florence County,9,206,114,92
Wisconsin,Florence County,10,331,171,160
Wisconsin,Florence County,11,444,212,232
Wisconsin,Florence County,12,474,249,225
Wisconsin,Florence County,13,378,196,182
Wisconsin,Florence County,14,369,191,178
Wisconsin,Florence County,15,303,159,144
Wisconsin,Florence County,16,231,118,113
Wisconsin,Florence County,17,133,64,69
Wisconsin,Florence County,18,122,46,76
Wisconsin,Fond du Lac County,0,101759,50066,51693
Wisconsin,Fond du Lac County,1,5745,2921,2824
Wisconsin,Fond du Lac County,2,6210,3162,3048
Wisconsin,Fond du Lac County,3,6345,3192,3153
Wisconsin,Fond du Lac County,4,6585,3514,3071
Wisconsin,Fond du Lac County,5,6467,3189,3278
Wisconsin,Fond du Lac County,6,5754,2825,2929
Wisconsin,Fond du Lac County,7,6391,3225,3166
Wisconsin,Fond du Lac County,8,5854,2936,2918
Wisconsin,Fond du Lac County,9,6108,3110,2998
Wisconsin,Fond du Lac County,10,6985,3416,3569
Wisconsin,Fond du Lac County,11,7901,3966,3935
Wisconsin,Fond du Lac County,12,7820,3922,3898
Wisconsin,Fond du Lac County,13,6713,3339,3374
Wisconsin,Fond du Lac County,14,5233,2566,2667
Wisconsin,Fond du Lac County,15,3856,1809,2047
Wisconsin,Fond du Lac County,16,2794,1247,1547
Wisconsin,Fond du Lac County,17,2338,909,1429
Wisconsin,Fond du Lac County,18,2660,818,1842
Wisconsin,Forest County,0,9127,4653,4474
Wisconsin,Forest County,1,528,294,234
Wisconsin,Forest County,2,499,261,238
Wisconsin,Forest County,3,519,267,252
Wisconsin,Forest County,4,589,318,271
Wisconsin,Forest County,5,559,305,254
Wisconsin,Forest County,6,476,237,239
Wisconsin,Forest County,7,400,188,212
Wisconsin,Forest County,8,426,213,213
Wisconsin,Forest County,9,492,235,257
Wisconsin,Forest County,10,546,296,250
Wisconsin,Forest County,11,655,333,322
Wisconsin,Forest County,12,738,359,379
Wisconsin,Forest County,13,713,359,354
Wisconsin,Forest County,14,616,313,303
Wisconsin,Forest County,15,484,257,227
Wisconsin,Forest County,16,368,181,187
Wisconsin,Forest County,17,273,143,130
Wisconsin,Forest County,18,246,94,152
Wisconsin,Grant County,0,51829,27075,24754
Wisconsin,Grant County,1,2724,1436,1288
Wisconsin,Grant County,2,3031,1534,1497
Wisconsin,Grant County,3,3021,1549,1472
Wisconsin,Grant County,4,4898,2874,2024
Wisconsin,Grant County,5,6304,3713,2591
Wisconsin,Grant County,6,2852,1646,1206
Wisconsin,Grant County,7,2748,1472,1276
Wisconsin,Grant County,8,2507,1339,1168
Wisconsin,Grant County,9,2494,1278,1216
Wisconsin,Grant County,10,2764,1429,1335
Wisconsin,Grant County,11,3421,1709,1712
Wisconsin,Grant County,12,3527,1812,1715
Wisconsin,Grant County,13,3078,1549,1529
Wisconsin,Grant County,14,2386,1175,1211
Wisconsin,Grant County,15,1901,906,995
Wisconsin,Grant County,16,1618,734,884
Wisconsin,Grant County,17,1232,507,725
Wisconsin,Grant County,18,1323,413,910
Wisconsin,Green County,0,37063,18372,18691
Wisconsin,Green County,1,2069,1050,1019
Wisconsin,Green County,2,2518,1314,1204
Wisconsin,Green County,3,2514,1271,1243
Wisconsin,Green County,4,2228,1100,1128
Wisconsin,Green County,5,1919,960,959
Wisconsin,Green County,6,1757,894,863
Wisconsin,Green County,7,2090,1054,1036
Wisconsin,Green County,8,2187,1068,1119
Wisconsin,Green County,9,2468,1275,1193
Wisconsin,Green County,10,2543,1272,1271
Wisconsin,Green County,11,3057,1566,1491
Wisconsin,Green County,12,2948,1485,1463
Wisconsin,Green County,13,2516,1287,1229
Wisconsin,Green County,14,1983,980,1003
Wisconsin,Green County,15,1455,685,770
Wisconsin,Green County,16,1045,487,558
Wisconsin,Green County,17,843,333,510
Wisconsin,Green County,18,923,291,632
Wisconsin,Green Lake County,0,18836,9473,9363
Wisconsin,Green Lake County,1,1045,576,469
Wisconsin,Green Lake County,2,1152,608,544
Wisconsin,Green Lake County,3,1329,696,633
Wisconsin,Green Lake County,4,1168,610,558
Wisconsin,Green Lake County,5,848,430,418
Wisconsin,Green Lake County,6,809,387,422
Wisconsin,Green Lake County,7,1012,522,490
Wisconsin,Green Lake County,8,927,476,451
Wisconsin,Green Lake County,9,1035,514,521
Wisconsin,Green Lake County,10,1154,600,554
Wisconsin,Green Lake County,11,1501,782,719
Wisconsin,Green Lake County,12,1522,777,745
Wisconsin,Green Lake County,13,1416,728,688
Wisconsin,Green Lake County,14,1213,582,631
Wisconsin,Green Lake County,15,933,446,487
Wisconsin,Green Lake County,16,701,321,380
Wisconsin,Green Lake County,17,523,201,322
Wisconsin,Green Lake County,18,548,217,331
Wisconsin,Iowa County,0,23825,11899,11926
Wisconsin,Iowa County,1,1413,705,708
Wisconsin,Iowa County,2,1583,812,771
Wisconsin,Iowa County,3,1610,811,799
Wisconsin,Iowa County,4,1453,755,698
Wisconsin,Iowa County,5,1141,588,553
Wisconsin,Iowa County,6,1181,595,586
Wisconsin,Iowa County,7,1391,697,694
Wisconsin,Iowa County,8,1347,687,660
Wisconsin,Iowa County,9,1444,731,713
Wisconsin,Iowa County,10,1662,823,839
Wisconsin,Iowa County,11,1961,978,983
Wisconsin,Iowa County,12,1962,994,968
Wisconsin,Iowa County,13,1700,872,828
Wisconsin,Iowa County,14,1359,681,678
Wisconsin,Iowa County,15,905,472,433
Wisconsin,Iowa County,16,652,279,373
Wisconsin,Iowa County,17,546,251,295
Wisconsin,Iowa County,18,515,168,347
Wisconsin,Iron County,0,5917,2962,2955
Wisconsin,Iron County,1,224,107,117
Wisconsin,Iron County,2,269,133,136
Wisconsin,Iron County,3,274,141,133
Wisconsin,Iron County,4,272,134,138
Wisconsin,Iron County,5,224,116,108
Wisconsin,Iron County,6,200,100,100
Wisconsin,Iron County,7,261,120,141
Wisconsin,Iron County,8,255,129,126
Wisconsin,Iron County,9,302,166,136
Wisconsin,Iron County,10,375,175,200
Wisconsin,Iron County,11,502,258,244
Wisconsin,Iron County,12,546,287,259
Wisconsin,Iron County,13,542,282,260
Wisconsin,Iron County,14,506,269,237
Wisconsin,Iron County,15,377,208,169
Wisconsin,Iron County,16,280,144,136
Wisconsin,Iron County,17,250,108,142
Wisconsin,Iron County,18,258,85,173
Wisconsin,Jackson County,0,20652,11063,9589
Wisconsin,Jackson County,1,1289,709,580
Wisconsin,Jackson County,2,1248,638,610
Wisconsin,Jackson County,3,1308,645,663
Wisconsin,Jackson County,4,1200,634,566
Wisconsin,Jackson County,5,1171,677,494
Wisconsin,Jackson County,6,1257,771,486
Wisconsin,Jackson County,7,1208,701,507
Wisconsin,Jackson County,8,1166,646,520
Wisconsin,Jackson County,9,1268,724,544
Wisconsin,Jackson County,10,1409,774,635
Wisconsin,Jackson County,11,1610,848,762
Wisconsin,Jackson County,12,1534,823,711
Wisconsin,Jackson County,13,1355,694,661
Wisconsin,Jackson County,14,1181,605,576
Wisconsin,Jackson County,15,901,489,412
Wisconsin,Jackson County,16,654,309,345
Wisconsin,Jackson County,17,451,203,248
Wisconsin,Jackson County,18,442,173,269
Wisconsin,Jefferson County,0,84395,42120,42275
Wisconsin,Jefferson County,1,4620,2414,2206
Wisconsin,Jefferson County,2,5240,2689,2551
Wisconsin,Jefferson County,3,5505,2796,2709
Wisconsin,Jefferson County,4,6489,3302,3187
Wisconsin,Jefferson County,5,5206,2682,2524
Wisconsin,Jefferson County,6,4690,2328,2362
Wisconsin,Jefferson County,7,5306,2624,2682
Wisconsin,Jefferson County,8,5103,2617,2486
Wisconsin,Jefferson County,9,5548,2846,2702
Wisconsin,Jefferson County,10,5907,3011,2896
Wisconsin,Jefferson County,11,6582,3271,3311
Wisconsin,Jefferson County,12,6199,3124,3075
Wisconsin,Jefferson County,13,5348,2636,2712
Wisconsin,Jefferson County,14,4253,2095,2158
Wisconsin,Jefferson County,15,3095,1442,1653
Wisconsin,Jefferson County,16,2236,1029,1207
Wisconsin,Jefferson County,17,1472,634,838
Wisconsin,Jefferson County,18,1596,580,1016
Wisconsin,Juneau County,0,26395,13982,12413
Wisconsin,Juneau County,1,1458,762,696
Wisconsin,Juneau County,2,1428,733,695
Wisconsin,Juneau County,3,1553,796,757
Wisconsin,Juneau County,4,1437,722,715
Wisconsin,Juneau County,5,1350,750,600
Wisconsin,Juneau County,6,1439,851,588
Wisconsin,Juneau County,7,1515,857,658
Wisconsin,Juneau County,8,1453,824,629
Wisconsin,Juneau County,9,1681,976,705
Wisconsin,Juneau County,10,1868,1017,851
Wisconsin,Juneau County,11,2283,1248,1035
Wisconsin,Juneau County,12,2071,1100,971
Wisconsin,Juneau County,13,1847,972,875
Wisconsin,Juneau County,14,1630,815,815
Wisconsin,Juneau County,15,1247,639,608
Wisconsin,Juneau County,16,910,430,480
Wisconsin,Juneau County,17,617,288,329
Wisconsin,Juneau County,18,608,202,406
Wisconsin,Kenosha County,0,168068,83036,85032
Wisconsin,Kenosha County,1,9953,5077,4876
Wisconsin,Kenosha County,2,11208,5651,5557
Wisconsin,Kenosha County,3,12022,6200,5822
Wisconsin,Kenosha County,4,12484,6484,6000
Wisconsin,Kenosha County,5,11532,5779,5753
Wisconsin,Kenosha County,6,10451,5320,5131
Wisconsin,Kenosha County,7,10877,5410,5467
Wisconsin,Kenosha County,8,10437,5139,5298
Wisconsin,Kenosha County,9,11168,5572,5596
Wisconsin,Kenosha County,10,12191,6008,6183
Wisconsin,Kenosha County,11,13604,6787,6817
Wisconsin,Kenosha County,12,11735,5769,5966
Wisconsin,Kenosha County,13,9402,4666,4736
Wisconsin,Kenosha County,14,6834,3284,3550
Wisconsin,Kenosha County,15,4944,2280,2664
Wisconsin,Kenosha County,16,3567,1573,1994
Wisconsin,Kenosha County,17,2653,1043,1610
Wisconsin,Kenosha County,18,3006,994,2012
Wisconsin,Kewaunee County,0,20444,10360,10084
Wisconsin,Kewaunee County,1,1086,552,534
Wisconsin,Kewaunee County,2,1154,592,562
Wisconsin,Kewaunee County,3,1436,748,688
Wisconsin,Kewaunee County,4,1256,664,592
Wisconsin,Kewaunee County,5,1030,540,490
Wisconsin,Kewaunee County,6,948,487,461
Wisconsin,Kewaunee County,7,1121,583,538
Wisconsin,Kewaunee County,8,1160,606,554
Wisconsin,Kewaunee County,9,1259,645,614
Wisconsin,Kewaunee County,10,1401,698,703
Wisconsin,Kewaunee County,11,1704,851,853
Wisconsin,Kewaunee County,12,1581,849,732
Wisconsin,Kewaunee County,13,1449,747,702
Wisconsin,Kewaunee County,14,1161,601,560
Wisconsin,Kewaunee County,15,896,430,466
Wisconsin,Kewaunee County,16,674,343,331
Wisconsin,Kewaunee County,17,505,217,288
Wisconsin,Kewaunee County,18,623,207,416
Wisconsin,La Crosse County,0,118011,57780,60231
Wisconsin,La Crosse County,1,6416,3374,3042
Wisconsin,La Crosse County,2,6856,3558,3298
Wisconsin,La Crosse County,3,6657,3450,3207
Wisconsin,La Crosse County,4,9498,4357,5141
Wisconsin,La Crosse County,5,13643,6494,7149
Wisconsin,La Crosse County,6,7783,4035,3748
Wisconsin,La Crosse County,7,7525,3889,3636
Wisconsin,La Crosse County,8,6463,3298,3165
Wisconsin,La Crosse County,9,6440,3238,3202
Wisconsin,La Crosse County,10,6806,3459,3347
Wisconsin,La Crosse County,11,7749,3779,3970
Wisconsin,La Crosse County,12,7842,3785,4057
Wisconsin,La Crosse County,13,6926,3417,3509
Wisconsin,La Crosse County,14,5595,2714,2881
Wisconsin,La Crosse County,15,3766,1767,1999
Wisconsin,La Crosse County,16,2976,1316,1660
Wisconsin,La Crosse County,17,2359,954,1405
Wisconsin,La Crosse County,18,2711,896,1815
Wisconsin,Lafayette County,0,16853,8546,8307
Wisconsin,Lafayette County,1,1077,547,530
Wisconsin,Lafayette County,2,1211,610,601
Wisconsin,Lafayette County,3,1200,602,598
Wisconsin,Lafayette County,4,1084,583,501
Wisconsin,Lafayette County,5,1018,531,487
Wisconsin,Lafayette County,6,852,457,395
Wisconsin,Lafayette County,7,982,508,474
Wisconsin,Lafayette County,8,858,429,429
Wisconsin,Lafayette County,9,891,450,441
Wisconsin,Lafayette County,10,1074,559,515
Wisconsin,Lafayette County,11,1343,659,684
Wisconsin,Lafayette County,12,1345,685,660
Wisconsin,Lafayette County,13,1143,599,544
Wisconsin,Lafayette County,14,789,441,348
Wisconsin,Lafayette County,15,637,301,336
Wisconsin,Lafayette County,16,551,258,293
Wisconsin,Lafayette County,17,426,186,240
Wisconsin,Lafayette County,18,372,141,231
Wisconsin,Langlade County,0,19410,9776,9634
Wisconsin,Langlade County,1,962,482,480
Wisconsin,Langlade County,2,1017,526,491
Wisconsin,Langlade County,3,1188,609,579
Wisconsin,Langlade County,4,1125,613,512
Wisconsin,Langlade County,5,939,498,441
Wisconsin,Langlade County,6,809,414,395
Wisconsin,Langlade County,7,962,512,450
Wisconsin,Langlade County,8,943,465,478
Wisconsin,Langlade County,9,1042,504,538
Wisconsin,Langlade County,10,1255,661,594
Wisconsin,Langlade County,11,1701,851,850
Wisconsin,Langlade County,12,1654,837,817
Wisconsin,Langlade County,13,1500,793,707
Wisconsin,Langlade County,14,1270,631,639
Wisconsin,Langlade County,15,1031,502,529
Wisconsin,Langlade County,16,851,414,437
Wisconsin,Langlade County,17,544,229,315
Wisconsin,Langlade County,18,617,235,382
Wisconsin,Lincoln County,0,28493,14483,14010
Wisconsin,Lincoln County,1,1296,624,672
Wisconsin,Lincoln County,2,1440,727,713
Wisconsin,Lincoln County,3,1599,838,761
Wisconsin,Lincoln County,4,2137,1334,803
Wisconsin,Lincoln County,5,1416,745,671
Wisconsin,Lincoln County,6,1186,618,568
Wisconsin,Lincoln County,7,1452,730,722
Wisconsin,Lincoln County,8,1481,735,746
Wisconsin,Lincoln County,9,1672,826,846
Wisconsin,Lincoln County,10,2098,1113,985
Wisconsin,Lincoln County,11,2481,1241,1240
Wisconsin,Lincoln County,12,2539,1298,1241
Wisconsin,Lincoln County,13,2043,1065,978
Wisconsin,Lincoln County,14,1706,846,860
Wisconsin,Lincoln County,15,1320,631,689
Wisconsin,Lincoln County,16,1068,492,576
Wisconsin,Lincoln County,17,740,343,397
Wisconsin,Lincoln County,18,819,277,542
Wisconsin,Manitowoc County,0,80160,39985,40175
Wisconsin,Manitowoc County,1,4139,2156,1983
Wisconsin,Manitowoc County,2,4647,2354,2293
Wisconsin,Manitowoc County,3,4969,2545,2424
Wisconsin,Manitowoc County,4,4898,2520,2378
Wisconsin,Manitowoc County,5,4434,2289,2145
Wisconsin,Manitowoc County,6,3937,2045,1892
Wisconsin,Manitowoc County,7,4442,2286,2156
Wisconsin,Manitowoc County,8,4399,2291,2108
Wisconsin,Manitowoc County,9,4579,2343,2236
Wisconsin,Manitowoc County,10,5588,2831,2757
Wisconsin,Manitowoc County,11,6734,3403,3331
Wisconsin,Manitowoc County,12,6713,3389,3324
Wisconsin,Manitowoc County,13,5773,2972,2801
Wisconsin,Manitowoc County,14,4445,2223,2222
Wisconsin,Manitowoc County,15,3504,1638,1866
Wisconsin,Manitowoc County,16,2597,1136,1461
Wisconsin,Manitowoc County,17,2061,828,1233
Wisconsin,Manitowoc County,18,2301,736,1565
Wisconsin,Marathon County,0,135780,68280,67500
Wisconsin,Marathon County,1,8243,4281,3962
Wisconsin,Marathon County,2,8919,4573,4346
Wisconsin,Marathon County,3,9019,4672,4347
Wisconsin,Marathon County,4,8666,4516,4150
Wisconsin,Marathon County,5,7961,4165,3796
Wisconsin,Marathon County,6,7613,3900,3713
Wisconsin,Marathon County,7,8630,4356,4274
Wisconsin,Marathon County,8,7994,4150,3844
Wisconsin,Marathon County,9,8441,4299,4142
Wisconsin,Marathon County,10,9433,4776,4657
Wisconsin,Marathon County,11,10625,5357,5268
Wisconsin,Marathon County,12,9986,5086,4900
Wisconsin,Marathon County,13,8641,4333,4308
Wisconsin,Marathon County,14,6629,3277,3352
Wisconsin,Marathon County,15,5071,2436,2635
Wisconsin,Marathon County,16,3808,1737,2071
Wisconsin,Marathon County,17,2887,1237,1650
Wisconsin,Marathon County,18,3214,1129,2085
Wisconsin,Marinette County,0,41298,20733,20565
Wisconsin,Marinette County,1,1956,1046,910
Wisconsin,Marinette County,2,2241,1134,1107
Wisconsin,Marinette County,3,2378,1201,1177
Wisconsin,Marinette County,4,2344,1198,1146
Wisconsin,Marinette County,5,2181,1150,1031
Wisconsin,Marinette County,6,1932,1017,915
Wisconsin,Marinette County,7,2176,1110,1066
Wisconsin,Marinette County,8,2083,1048,1035
Wisconsin,Marinette County,9,2133,1104,1029
Wisconsin,Marinette County,10,2595,1319,1276
Wisconsin,Marinette County,11,3506,1740,1766
Wisconsin,Marinette County,12,3612,1855,1757
Wisconsin,Marinette County,13,3213,1617,1596
Wisconsin,Marinette County,14,2749,1401,1348
Wisconsin,Marinette County,15,2244,1131,1113
Wisconsin,Marinette County,16,1575,733,842
Wisconsin,Marinette County,17,1142,500,642
Wisconsin,Marinette County,18,1238,429,809
Wisconsin,Marquette County,0,15050,7639,7411
Wisconsin,Marquette County,1,745,411,334
Wisconsin,Marquette County,2,818,422,396
Wisconsin,Marquette County,3,836,448,388
Wisconsin,Marquette County,4,818,431,387
Wisconsin,Marquette County,5,624,308,316
Wisconsin,Marquette County,6,676,341,335
Wisconsin,Marquette County,7,719,386,333
Wisconsin,Marquette County,8,705,352,353
Wisconsin,Marquette County,9,793,394,399
Wisconsin,Marquette County,10,978,522,456
Wisconsin,Marquette County,11,1350,681,669
Wisconsin,Marquette County,12,1323,701,622
Wisconsin,Marquette County,13,1259,658,601
Wisconsin,Marquette County,14,1083,509,574
Wisconsin,Marquette County,15,863,432,431
Wisconsin,Marquette County,16,654,295,359
Wisconsin,Marquette County,17,394,188,206
Wisconsin,Marquette County,18,412,160,252
Wisconsin,Menominee County,0,4522,2231,2291
Wisconsin,Menominee County,1,492,267,225
Wisconsin,Menominee County,2,421,223,198
Wisconsin,Menominee County,3,368,171,197
Wisconsin,Menominee County,4,333,190,143
Wisconsin,Menominee County,5,314,144,170
Wisconsin,Menominee County,6,263,122,141
Wisconsin,Menominee County,7,231,109,122
Wisconsin,Menominee County,8,203,92,111
Wisconsin,Menominee County,9,235,115,120
Wisconsin,Menominee County,10,279,134,145
Wisconsin,Menominee County,11,308,150,158
Wisconsin,Menominee County,12,292,155,137
Wisconsin,Menominee County,13,211,100,111
Wisconsin,Menominee County,14,219,102,117
Wisconsin,Menominee County,15,152,64,88
Wisconsin,Menominee County,16,112,53,59
Wisconsin,Menominee County,17,64,29,35
Wisconsin,Menominee County,18,25,11,14
Wisconsin,Milwaukee County,0,956406,461907,494499
Wisconsin,Milwaukee County,1,69081,35224,33857
Wisconsin,Milwaukee County,2,65856,33574,32282
Wisconsin,Milwaukee County,3,62225,31590,30635
Wisconsin,Milwaukee County,4,63490,32272,31218
Wisconsin,Milwaukee County,5,71140,34789,36351
Wisconsin,Milwaukee County,6,81766,39660,42106
Wisconsin,Milwaukee County,7,74014,35998,38016
Wisconsin,Milwaukee County,8,62163,30419,31744
Wisconsin,Milwaukee County,9,58013,28341,29672
Wisconsin,Milwaukee County,10,57552,28223,29329
Wisconsin,Milwaukee County,11,62114,29971,32143
Wisconsin,Milwaukee County,12,61379,29530,31849
Wisconsin,Milwaukee County,13,51546,24399,27147
Wisconsin,Milwaukee County,14,37147,17292,19855
Wisconsin,Milwaukee County,15,24545,10636,13909
Wisconsin,Milwaukee County,16,19053,7825,11228
Wisconsin,Milwaukee County,17,15802,5960,9842
Wisconsin,Milwaukee County,18,19520,6204,13316
Wisconsin,Monroe County,0,45379,22873,22506
Wisconsin,Monroe County,1,3079,1492,1587
Wisconsin,Monroe County,2,3278,1658,1620
Wisconsin,Monroe County,3,3247,1704,1543
Wisconsin,Monroe County,4,2861,1489,1372
Wisconsin,Monroe County,5,2379,1165,1214
Wisconsin,Monroe County,6,2506,1246,1260
Wisconsin,Monroe County,7,2940,1478,1462
Wisconsin,Monroe County,8,2572,1350,1222
Wisconsin,Monroe County,9,2659,1337,1322
Wisconsin,Monroe County,10,2884,1514,1370
Wisconsin,Monroe County,11,3523,1850,1673
Wisconsin,Monroe County,12,3419,1744,1675
Wisconsin,Monroe County,13,2898,1503,1395
Wisconsin,Monroe County,14,2411,1265,1146
Wisconsin,Monroe County,15,1685,815,870
Wisconsin,Monroe County,16,1208,555,653
Wisconsin,Monroe County,17,908,378,530
Wisconsin,Monroe County,18,922,330,592
Wisconsin,Oconto County,0,37417,19105,18312
Wisconsin,Oconto County,1,1805,945,860
Wisconsin,Oconto County,2,2206,1128,1078
Wisconsin,Oconto County,3,2305,1193,1112
Wisconsin,Oconto County,4,2189,1140,1049
Wisconsin,Oconto County,5,1808,944,864
Wisconsin,Oconto County,6,1676,843,833
Wisconsin,Oconto County,7,1920,975,945
Wisconsin,Oconto County,8,2048,1073,975
Wisconsin,Oconto County,9,2245,1111,1134
Wisconsin,Oconto County,10,2886,1462,1424
Wisconsin,Oconto County,11,3323,1732,1591
Wisconsin,Oconto County,12,3249,1692,1557
Wisconsin,Oconto County,13,2838,1497,1341
Wisconsin,Oconto County,14,2299,1197,1102
Wisconsin,Oconto County,15,1785,881,904
Wisconsin,Oconto County,16,1262,638,624
Wisconsin,Oconto County,17,838,387,451
Wisconsin,Oconto County,18,735,267,468
Wisconsin,Oneida County,0,35563,17810,17753
Wisconsin,Oneida County,1,1629,830,799
Wisconsin,Oneida County,2,1681,871,810
Wisconsin,Oneida County,3,1725,852,873
Wisconsin,Oneida County,4,1767,898,869
Wisconsin,Oneida County,5,1686,883,803
Wisconsin,Oneida County,6,1603,862,741
Wisconsin,Oneida County,7,1746,912,834
Wisconsin,Oneida County,8,1596,821,775
Wisconsin,Oneida County,9,1858,949,909
Wisconsin,Oneida County,10,2275,1127,1148
Wisconsin,Oneida County,11,3092,1528,1564
Wisconsin,Oneida County,12,3248,1619,1629
Wisconsin,Oneida County,13,3146,1618,1528
Wisconsin,Oneida County,14,2597,1279,1318
Wisconsin,Oneida County,15,2166,1079,1087
Wisconsin,Oneida County,16,1603,771,832
Wisconsin,Oneida County,17,1091,510,581
Wisconsin,Oneida County,18,1054,401,653
Wisconsin,Outagamie County,0,182006,90601,91405
Wisconsin,Outagamie County,1,11498,5835,5663
Wisconsin,Outagamie County,2,12172,6257,5915
Wisconsin,Outagamie County,3,12661,6479,6182
Wisconsin,Outagamie County,4,12042,6253,5789
Wisconsin,Outagamie County,5,11879,6000,5879
Wisconsin,Outagamie County,6,11573,5933,5640
Wisconsin,Outagamie County,7,12578,6359,6219
Wisconsin,Outagamie County,8,11749,6015,5734
Wisconsin,Outagamie County,9,11453,5799,5654
Wisconsin,Outagamie County,10,12951,6417,6534
Wisconsin,Outagamie County,11,14483,7193,7290
Wisconsin,Outagamie County,12,12812,6450,6362
Wisconsin,Outagamie County,13,10213,5064,5149
Wisconsin,Outagamie County,14,7828,3762,4066
Wisconsin,Outagamie County,15,5655,2610,3045
Wisconsin,Outagamie County,16,4076,1810,2266
Wisconsin,Outagamie County,17,3016,1238,1778
Wisconsin,Outagamie County,18,3367,1127,2240
Wisconsin,Ozaukee County,0,87470,42949,44521
Wisconsin,Ozaukee County,1,4376,2228,2148
Wisconsin,Ozaukee County,2,5089,2646,2443
Wisconsin,Ozaukee County,3,6004,3097,2907
Wisconsin,Ozaukee County,4,6314,3260,3054
Wisconsin,Ozaukee County,5,5036,2549,2487
Wisconsin,Ozaukee County,6,3874,2027,1847
Wisconsin,Ozaukee County,7,4482,2258,2224
Wisconsin,Ozaukee County,8,4498,2254,2244
Wisconsin,Ozaukee County,9,5277,2508,2769
Wisconsin,Ozaukee County,10,6358,3122,3236
Wisconsin,Ozaukee County,11,7309,3545,3764
Wisconsin,Ozaukee County,12,7307,3617,3690
Wisconsin,Ozaukee County,13,6232,3031,3201
Wisconsin,Ozaukee County,14,4856,2342,2514
Wisconsin,Ozaukee County,15,3628,1694,1934
Wisconsin,Ozaukee County,16,2497,1111,1386
Wisconsin,Ozaukee County,17,2087,892,1195
Wisconsin,Ozaukee County,18,2246,768,1478
Wisconsin,Pepin County,0,7335,3670,3665
Wisconsin,Pepin County,1,385,173,212
Wisconsin,Pepin County,2,471,246,225
Wisconsin,Pepin County,3,444,227,217
Wisconsin,Pepin County,4,461,253,208
Wisconsin,Pepin County,5,361,189,172
Wisconsin,Pepin County,6,295,144,151
Wisconsin,Pepin County,7,392,204,188
Wisconsin,Pepin County,8,334,171,163
Wisconsin,Pepin County,9,419,211,208
Wisconsin,Pepin County,10,496,252,244
Wisconsin,Pepin County,11,552,282,270
Wisconsin,Pepin County,12,640,303,337
Wisconsin,Pepin County,13,560,289,271
Wisconsin,Pepin County,14,459,242,217
Wisconsin,Pepin County,15,344,167,177
Wisconsin,Pepin County,16,288,144,144
Wisconsin,Pepin County,17,216,95,121
Wisconsin,Pepin County,18,218,78,140
Wisconsin,Pierce County,0,40958,20303,20655
Wisconsin,Pierce County,1,2175,1159,1016
Wisconsin,Pierce County,2,2505,1303,1202
Wisconsin,Pierce County,3,2510,1266,1244
Wisconsin,Pierce County,4,3633,1692,1941
Wisconsin,Pierce County,5,4745,2131,2614
Wisconsin,Pierce County,6,2121,1093,1028
Wisconsin,Pierce County,7,2384,1223,1161
Wisconsin,Pierce County,8,2178,1103,1075
Wisconsin,Pierce County,9,2464,1255,1209
Wisconsin,Pierce County,10,2647,1322,1325
Wisconsin,Pierce County,11,3047,1578,1469
Wisconsin,Pierce County,12,2949,1473,1476
Wisconsin,Pierce County,13,2460,1233,1227
Wisconsin,Pierce County,14,1817,959,858
Wisconsin,Pierce County,15,1177,578,599
Wisconsin,Pierce County,16,910,445,465
Wisconsin,Pierce County,17,594,259,335
Wisconsin,Pierce County,18,642,231,411
Wisconsin,Polk County,0,43437,21941,21496
Wisconsin,Polk County,1,2215,1178,1037
Wisconsin,Polk County,2,2721,1368,1353
Wisconsin,Polk County,3,2807,1465,1342
Wisconsin,Polk County,4,2673,1395,1278
Wisconsin,Polk County,5,2169,1111,1058
Wisconsin,Polk County,6,1855,925,930
Wisconsin,Polk County,7,2418,1221,1197
Wisconsin,Polk County,8,2425,1234,1191
Wisconsin,Polk County,9,2636,1329,1307
Wisconsin,Polk County,10,3042,1581,1461
Wisconsin,Polk County,11,3659,1825,1834
Wisconsin,Polk County,12,3593,1815,1778
Wisconsin,Polk County,13,3194,1668,1526
Wisconsin,Polk County,14,2606,1344,1262
Wisconsin,Polk County,15,1973,955,1018
Wisconsin,Polk County,16,1448,726,722
Wisconsin,Polk County,17,981,441,540
Wisconsin,Polk County,18,1022,360,662
Wisconsin,Portage County,0,70482,35408,35074
Wisconsin,Portage County,1,3544,1883,1661
Wisconsin,Portage County,2,3858,1998,1860
Wisconsin,Portage County,3,4012,2047,1965
Wisconsin,Portage County,4,5876,2938,2938
Wisconsin,Portage County,5,8638,4469,4169
Wisconsin,Portage County,6,4214,2233,1981
Wisconsin,Portage County,7,4157,2160,1997
Wisconsin,Portage County,8,3742,1895,1847
Wisconsin,Portage County,9,3740,1910,1830
Wisconsin,Portage County,10,4270,2105,2165
Wisconsin,Portage County,11,4940,2491,2449
Wisconsin,Portage County,12,4866,2417,2449
Wisconsin,Portage County,13,4346,2200,2146
Wisconsin,Portage County,14,3299,1639,1660
Wisconsin,Portage County,15,2462,1152,1310
Wisconsin,Portage County,16,1838,878,960
Wisconsin,Portage County,17,1229,525,704
Wisconsin,Portage County,18,1451,468,983
Wisconsin,Price County,0,13675,6927,6748
Wisconsin,Price County,1,530,283,247
Wisconsin,Price County,2,640,314,326
Wisconsin,Price County,3,769,390,379
Wisconsin,Price County,4,750,382,368
Wisconsin,Price County,5,586,297,289
Wisconsin,Price County,6,470,263,207
Wisconsin,Price County,7,576,280,296
Wisconsin,Price County,8,636,325,311
Wisconsin,Price County,9,754,388,366
Wisconsin,Price County,10,907,474,433
Wisconsin,Price County,11,1224,635,589
Wisconsin,Price County,12,1324,704,620
Wisconsin,Price County,13,1226,614,612
Wisconsin,Price County,14,998,543,455
Wisconsin,Price County,15,793,397,396
Wisconsin,Price County,16,608,310,298
Wisconsin,Price County,17,434,179,255
Wisconsin,Price County,18,450,149,301
Wisconsin,Racine County,0,195163,96655,98508
Wisconsin,Racine County,1,12111,6273,5838
Wisconsin,Racine County,2,12831,6523,6308
Wisconsin,Racine County,3,13288,6792,6496
Wisconsin,Racine County,4,12830,6638,6192
Wisconsin,Racine County,5,11896,6305,5591
Wisconsin,Racine County,6,11174,5711,5463
Wisconsin,Racine County,7,12223,5994,6229
Wisconsin,Racine County,8,11537,5791,5746
Wisconsin,Racine County,9,12016,6004,6012
Wisconsin,Racine County,10,13829,6850,6979
Wisconsin,Racine County,11,15613,7730,7883
Wisconsin,Racine County,12,14949,7338,7611
Wisconsin,Racine County,13,12081,6024,6057
Wisconsin,Racine County,14,9474,4513,4961
Wisconsin,Racine County,15,6693,3074,3619
Wisconsin,Racine County,16,4926,2207,2719
Wisconsin,Racine County,17,3596,1510,2086
Wisconsin,Racine County,18,4096,1378,2718
Wisconsin,Richland County,0,17662,8877,8785
Wisconsin,Richland County,1,949,475,474
Wisconsin,Richland County,2,1163,602,561
Wisconsin,Richland County,3,1177,629,548
Wisconsin,Richland County,4,1063,535,528
Wisconsin,Richland County,5,972,504,468
Wisconsin,Richland County,6,818,427,391
Wisconsin,Richland County,7,928,467,461
Wisconsin,Richland County,8,913,493,420
Wisconsin,Richland County,9,1011,531,480
Wisconsin,Richland County,10,1046,518,528
Wisconsin,Richland County,11,1304,647,657
Wisconsin,Richland County,12,1429,722,707
Wisconsin,Richland County,13,1439,761,678
Wisconsin,Richland County,14,993,497,496
Wisconsin,Richland County,15,786,374,412
Wisconsin,Richland County,16,644,322,322
Wisconsin,Richland County,17,442,191,251
Wisconsin,Richland County,18,585,182,403
Wisconsin,Rock County,0,161188,79194,81994
Wisconsin,Rock County,1,9723,4990,4733
Wisconsin,Rock County,2,10774,5533,5241
Wisconsin,Rock County,3,11269,5750,5519
Wisconsin,Rock County,4,10717,5496,5221
Wisconsin,Rock County,5,10095,5039,5056
Wisconsin,Rock County,6,9330,4640,4690
Wisconsin,Rock County,7,10541,5175,5366
Wisconsin,Rock County,8,9746,4930,4816
Wisconsin,Rock County,9,10424,5168,5256
Wisconsin,Rock County,10,10784,5306,5478
Wisconsin,Rock County,11,12050,5984,6066
Wisconsin,Rock County,12,11604,5687,5917
Wisconsin,Rock County,13,9808,4803,5005
Wisconsin,Rock County,14,7713,3647,4066
Wisconsin,Rock County,15,5719,2613,3106
Wisconsin,Rock County,16,4366,2014,2352
Wisconsin,Rock County,17,3218,1326,1892
Wisconsin,Rock County,18,3307,1093,2214
Wisconsin,Rusk County,0,14333,7192,7141
Wisconsin,Rusk County,1,754,376,378
Wisconsin,Rusk County,2,781,397,384
Wisconsin,Rusk County,3,906,450,456
Wisconsin,Rusk County,4,874,461,413
Wisconsin,Rusk County,5,685,362,323
Wisconsin,Rusk County,6,562,289,273
Wisconsin,Rusk County,7,657,338,319
Wisconsin,Rusk County,8,680,342,338
Wisconsin,Rusk County,9,755,394,361
Wisconsin,Rusk County,10,919,471,448
Wisconsin,Rusk County,11,1208,629,579
Wisconsin,Rusk County,12,1223,615,608
Wisconsin,Rusk County,13,1167,601,566
Wisconsin,Rusk County,14,961,506,455
Wisconsin,Rusk County,15,726,353,373
Wisconsin,Rusk County,16,572,276,296
Wisconsin,Rusk County,17,437,186,251
Wisconsin,Rusk County,18,466,146,320
Wisconsin,Sauk County,0,63379,31499,31880
Wisconsin,Sauk County,1,3820,1972,1848
Wisconsin,Sauk County,2,4081,2117,1964
Wisconsin,Sauk County,3,4115,2120,1995
Wisconsin,Sauk County,4,3894,1999,1895
Wisconsin,Sauk County,5,3450,1738,1712
Wisconsin,Sauk County,6,3657,1859,1798
Wisconsin,Sauk County,7,4084,2127,1957
Wisconsin,Sauk County,8,3683,1886,1797
Wisconsin,Sauk County,9,4004,2025,1979
Wisconsin,Sauk County,10,4170,2109,2061
Wisconsin,Sauk County,11,4822,2369,2453
Wisconsin,Sauk County,12,4649,2337,2312
Wisconsin,Sauk County,13,4169,2076,2093
Wisconsin,Sauk County,14,3478,1682,1796
Wisconsin,Sauk County,15,2477,1167,1310
Wisconsin,Sauk County,16,1818,832,986
Wisconsin,Sauk County,17,1344,559,785
Wisconsin,Sauk County,18,1664,525,1139
Wisconsin,Sawyer County,0,16437,8330,8107
Wisconsin,Sawyer County,1,901,461,440
Wisconsin,Sawyer County,2,939,480,459
Wisconsin,Sawyer County,3,885,449,436
Wisconsin,Sawyer County,4,874,444,430
Wisconsin,Sawyer County,5,765,417,348
Wisconsin,Sawyer County,6,714,380,334
Wisconsin,Sawyer County,7,721,367,354
Wisconsin,Sawyer County,8,751,382,369
Wisconsin,Sawyer County,9,870,436,434
Wisconsin,Sawyer County,10,971,486,485
Wisconsin,Sawyer County,11,1291,672,619
Wisconsin,Sawyer County,12,1488,727,761
Wisconsin,Sawyer County,13,1432,734,698
Wisconsin,Sawyer County,14,1268,647,621
Wisconsin,Sawyer County,15,1042,522,520
Wisconsin,Sawyer County,16,706,359,347
Wisconsin,Sawyer County,17,431,200,231
Wisconsin,Sawyer County,18,388,167,221
Wisconsin,Shawano County,0,41579,20781,20798
Wisconsin,Shawano County,1,2240,1110,1130
Wisconsin,Shawano County,2,2535,1319,1216
Wisconsin,Shawano County,3,2709,1380,1329
Wisconsin,Shawano County,4,2463,1251,1212
Wisconsin,Shawano County,5,2174,1132,1042
Wisconsin,Shawano County,6,1979,991,988
Wisconsin,Shawano County,7,2293,1192,1101
Wisconsin,Shawano County,8,2134,1047,1087
Wisconsin,Shawano County,9,2492,1267,1225
Wisconsin,Shawano County,10,2936,1503,1433
Wisconsin,Shawano County,11,3381,1716,1665
Wisconsin,Shawano County,12,3172,1598,1574
Wisconsin,Shawano County,13,2834,1482,1352
Wisconsin,Shawano County,14,2413,1164,1249
Wisconsin,Shawano County,15,2115,1030,1085
Wisconsin,Shawano County,16,1477,697,780
Wisconsin,Shawano County,17,1070,477,593
Wisconsin,Shawano County,18,1162,425,737
Wisconsin,Sheboygan County,0,115290,57922,57368
Wisconsin,Sheboygan County,1,6453,3304,3149
Wisconsin,Sheboygan County,2,7365,3736,3629
Wisconsin,Sheboygan County,3,7722,3983,3739
Wisconsin,Sheboygan County,4,7414,3869,3545
Wisconsin,Sheboygan County,5,6897,3575,3322
Wisconsin,Sheboygan County,6,6154,3224,2930
Wisconsin,Sheboygan County,7,7090,3693,3397
Wisconsin,Sheboygan County,8,6667,3461,3206
Wisconsin,Sheboygan County,9,7030,3647,3383
Wisconsin,Sheboygan County,10,8160,4210,3950
Wisconsin,Sheboygan County,11,9083,4631,4452
Wisconsin,Sheboygan County,12,8938,4525,4413
Wisconsin,Sheboygan County,13,7619,3755,3864
Wisconsin,Sheboygan County,14,5861,2859,3002
Wisconsin,Sheboygan County,15,4265,1973,2292
Wisconsin,Sheboygan County,16,3240,1475,1765
Wisconsin,Sheboygan County,17,2458,1056,1402
Wisconsin,Sheboygan County,18,2874,946,1928
Wisconsin,Taylor County,0,20540,10447,10093
Wisconsin,Taylor County,1,1194,580,614
Wisconsin,Taylor County,2,1434,749,685
Wisconsin,Taylor County,3,1439,753,686
Wisconsin,Taylor County,4,1215,651,564
Wisconsin,Taylor County,5,974,524,450
Wisconsin,Taylor County,6,922,482,440
Wisconsin,Taylor County,7,1105,554,551
Wisconsin,Taylor County,8,1179,611,568
Wisconsin,Taylor County,9,1188,601,587
Wisconsin,Taylor County,10,1375,734,641
Wisconsin,Taylor County,11,1708,862,846
Wisconsin,Taylor County,12,1718,897,821
Wisconsin,Taylor County,13,1338,713,625
Wisconsin,Taylor County,14,1044,524,520
Wisconsin,Taylor County,15,842,417,425
Wisconsin,Taylor County,16,723,341,382
Wisconsin,Taylor County,17,526,251,275
Wisconsin,Taylor County,18,616,203,413
Wisconsin,Trempealeau County,0,29509,14885,14624
Wisconsin,Trempealeau County,1,2017,984,1033
Wisconsin,Trempealeau County,2,1976,1005,971
Wisconsin,Trempealeau County,3,2010,1020,990
Wisconsin,Trempealeau County,4,1824,941,883
Wisconsin,Trempealeau County,5,1575,805,770
Wisconsin,Trempealeau County,6,1490,764,726
Wisconsin,Trempealeau County,7,1724,883,841
Wisconsin,Trempealeau County,8,1676,874,802
Wisconsin,Trempealeau County,9,1823,930,893
Wisconsin,Trempealeau County,10,2025,1035,990
Wisconsin,Trempealeau County,11,2234,1174,1060
Wisconsin,Trempealeau County,12,2154,1104,1050
Wisconsin,Trempealeau County,13,1981,1033,948
Wisconsin,Trempealeau County,14,1506,775,731
Wisconsin,Trempealeau County,15,1146,577,569
Wisconsin,Trempealeau County,16,910,431,479
Wisconsin,Trempealeau County,17,640,266,374
Wisconsin,Trempealeau County,18,798,284,514
Wisconsin,Vernon County,0,30362,15122,15240
Wisconsin,Vernon County,1,2176,1070,1106
Wisconsin,Vernon County,2,2143,1064,1079
Wisconsin,Vernon County,3,2246,1176,1070
Wisconsin,Vernon County,4,1962,1012,950
Wisconsin,Vernon County,5,1451,730,721
Wisconsin,Vernon County,6,1349,675,674
Wisconsin,Vernon County,7,1560,760,800
Wisconsin,Vernon County,8,1549,817,732
Wisconsin,Vernon County,9,1641,804,837
Wisconsin,Vernon County,10,1811,874,937
Wisconsin,Vernon County,11,2308,1163,1145
Wisconsin,Vernon County,12,2455,1258,1197
Wisconsin,Vernon County,13,2103,1092,1011
Wisconsin,Vernon County,14,1721,890,831
Wisconsin,Vernon County,15,1297,639,658
Wisconsin,Vernon County,16,992,493,499
Wisconsin,Vernon County,17,774,299,475
Wisconsin,Vernon County,18,824,306,518
Wisconsin,Vilas County,0,21398,10802,10596
Wisconsin,Vilas County,1,887,433,454
Wisconsin,Vilas County,2,980,517,463
Wisconsin,Vilas County,3,1093,564,529
Wisconsin,Vilas County,4,1033,565,468
Wisconsin,Vilas County,5,890,475,415
Wisconsin,Vilas County,6,789,392,397
Wisconsin,Vilas County,7,793,419,374
Wisconsin,Vilas County,8,812,445,367
Wisconsin,Vilas County,9,1054,528,526
Wisconsin,Vilas County,10,1276,659,617
Wisconsin,Vilas County,11,1783,888,895
Wisconsin,Vilas County,12,1848,920,928
Wisconsin,Vilas County,13,1947,959,988
Wisconsin,Vilas County,14,1949,987,962
Wisconsin,Vilas County,15,1636,781,855
Wisconsin,Vilas County,16,1151,607,544
Wisconsin,Vilas County,17,767,369,398
Wisconsin,Vilas County,18,710,294,416
Wisconsin,Walworth County,0,103527,51749,51778
Wisconsin,Walworth County,1,5288,2702,2586
Wisconsin,Walworth County,2,6375,3223,3152
Wisconsin,Walworth County,3,6881,3593,3288
Wisconsin,Walworth County,4,7882,4104,3778
Wisconsin,Walworth County,5,9602,4879,4723
Wisconsin,Walworth County,6,5276,2834,2442
Wisconsin,Walworth County,7,5740,2878,2862
Wisconsin,Walworth County,8,5714,2848,2866
Wisconsin,Walworth County,9,6157,3068,3089
Wisconsin,Walworth County,10,6804,3445,3359
Wisconsin,Walworth County,11,7819,3848,3971
Wisconsin,Walworth County,12,7536,3779,3757
Wisconsin,Walworth County,13,6591,3307,3284
Wisconsin,Walworth County,14,5312,2640,2672
Wisconsin,Walworth County,15,3790,1827,1963
Wisconsin,Walworth County,16,2658,1189,1469
Wisconsin,Walworth County,17,1901,806,1095
Wisconsin,Walworth County,18,2201,779,1422
Wisconsin,Washburn County,0,15694,7788,7906
Wisconsin,Washburn County,1,779,408,371
Wisconsin,Washburn County,2,890,452,438
Wisconsin,Washburn County,3,863,421,442
Wisconsin,Washburn County,4,803,385,418
Wisconsin,Washburn County,5,675,362,313
Wisconsin,Washburn County,6,646,309,337
Wisconsin,Washburn County,7,753,384,369
Wisconsin,Washburn County,8,717,362,355
Wisconsin,Washburn County,9,842,431,411
Wisconsin,Washburn County,10,955,490,465
Wisconsin,Washburn County,11,1271,625,646
Wisconsin,Washburn County,12,1344,634,710
Wisconsin,Washburn County,13,1405,726,679
Wisconsin,Washburn County,14,1235,650,585
Wisconsin,Washburn County,15,959,482,477
Wisconsin,Washburn County,16,663,336,327
Wisconsin,Washburn County,17,461,192,269
Wisconsin,Washburn County,18,433,139,294
Wisconsin,Washington County,0,133251,66209,67042
Wisconsin,Washington County,1,7073,3486,3587
Wisconsin,Washington County,2,8603,4352,4251
Wisconsin,Washington County,3,9286,4735,4551
Wisconsin,Washington County,4,8526,4392,4134
Wisconsin,Washington County,5,6774,3542,3232
Wisconsin,Washington County,6,6457,3351,3106
Wisconsin,Washington County,7,7788,3905,3883
Wisconsin,Washington County,8,7931,4048,3883
Wisconsin,Washington County,9,8700,4399,4301
Wisconsin,Washington County,10,10449,5219,5230
Wisconsin,Washington County,11,11679,5884,5795
Wisconsin,Washington County,12,10352,5230,5122
Wisconsin,Washington County,13,8711,4292,4419
Wisconsin,Washington County,14,6791,3329,3462
Wisconsin,Washington County,15,4897,2255,2642
Wisconsin,Washington County,16,3545,1610,1935
Wisconsin,Washington County,17,2683,1152,1531
Wisconsin,Washington County,18,3006,1028,1978
Wisconsin,Waukesha County,0,395118,194072,201046
Wisconsin,Waukesha County,1,20260,10284,9976
Wisconsin,Waukesha County,2,23782,12060,11722
Wisconsin,Waukesha County,3,27216,14003,13213
Wisconsin,Waukesha County,4,26662,13527,13135
Wisconsin,Waukesha County,5,20937,10648,10289
Wisconsin,Waukesha County,6,19140,9692,9448
Wisconsin,Waukesha County,7,22340,11321,11019
Wisconsin,Waukesha County,8,22662,11386,11276
Wisconsin,Waukesha County,9,25095,12447,12648
Wisconsin,Waukesha County,10,28830,14113,14717
Wisconsin,Waukesha County,11,33765,16467,17298
Wisconsin,Waukesha County,12,32444,16221,16223
Wisconsin,Waukesha County,13,26884,13192,13692
Wisconsin,Waukesha County,14,21117,10268,10849
Wisconsin,Waukesha County,15,14558,6797,7761
Wisconsin,Waukesha County,16,10900,4750,6150
Wisconsin,Waukesha County,17,8840,3692,5148
Wisconsin,Waukesha County,18,9686,3204,6482
Wisconsin,Waupaca County,0,52066,26212,25854
Wisconsin,Waupaca County,1,2723,1369,1354
Wisconsin,Waupaca County,2,2998,1579,1419
Wisconsin,Waupaca County,3,3217,1689,1528
Wisconsin,Waupaca County,4,3179,1647,1532
Wisconsin,Waupaca County,5,2751,1408,1343
Wisconsin,Waupaca County,6,2493,1312,1181
Wisconsin,Waupaca County,7,2781,1437,1344
Wisconsin,Waupaca County,8,2881,1465,1416
Wisconsin,Waupaca County,9,3037,1515,1522
Wisconsin,Waupaca County,10,3614,1812,1802
Wisconsin,Waupaca County,11,4405,2267,2138
Wisconsin,Waupaca County,12,4171,2137,2034
Wisconsin,Waupaca County,13,3689,1881,1808
Wisconsin,Waupaca County,14,2989,1504,1485
Wisconsin,Waupaca County,15,2316,1146,1170
Wisconsin,Waupaca County,16,1701,805,896
Wisconsin,Waupaca County,17,1400,609,791
Wisconsin,Waupaca County,18,1721,630,1091
Wisconsin,Waushara County,0,24178,12733,11445
Wisconsin,Waushara County,1,1157,585,572
Wisconsin,Waushara County,2,1178,560,618
Wisconsin,Waushara County,3,1370,701,669
Wisconsin,Waushara County,4,1284,679,605
Wisconsin,Waushara County,5,1121,660,461
Wisconsin,Waushara County,6,1135,658,477
Wisconsin,Waushara County,7,1202,689,513
Wisconsin,Waushara County,8,1230,708,522
Wisconsin,Waushara County,9,1339,768,571
Wisconsin,Waushara County,10,1639,860,779
Wisconsin,Waushara County,11,2089,1115,974
Wisconsin,Waushara County,12,2073,1076,997
Wisconsin,Waushara County,13,1910,1007,903
Wisconsin,Waushara County,14,1773,894,879
Wisconsin,Waushara County,15,1348,684,664
Wisconsin,Waushara County,16,1028,544,484
Wisconsin,Waushara County,17,661,308,353
Wisconsin,Waushara County,18,641,237,404
Wisconsin,Winnebago County,0,169511,85190,84321
Wisconsin,Winnebago County,1,9510,4903,4607
Wisconsin,Winnebago County,2,9838,5036,4802
Wisconsin,Winnebago County,3,10047,5075,4972
Wisconsin,Winnebago County,4,11550,5644,5906
Wisconsin,Winnebago County,5,15532,7849,7683
Wisconsin,Winnebago County,6,11117,6005,5112
Wisconsin,Winnebago County,7,11130,5886,5244
Wisconsin,Winnebago County,8,9954,5306,4648
Wisconsin,Winnebago County,9,10234,5355,4879
Wisconsin,Winnebago County,10,11240,5895,5345
Wisconsin,Winnebago County,11,12566,6365,6201
Wisconsin,Winnebago County,12,11828,5921,5907
Wisconsin,Winnebago County,13,9994,4995,4999
Wisconsin,Winnebago County,14,7674,3695,3979
Wisconsin,Winnebago County,15,5606,2634,2972
Wisconsin,Winnebago County,16,4352,1880,2472
Wisconsin,Winnebago County,17,3360,1410,1950
Wisconsin,Winnebago County,18,3979,1336,2643
Wisconsin,Wood County,0,73608,36341,37267
Wisconsin,Wood County,1,4221,2211,2010
Wisconsin,Wood County,2,4446,2227,2219
Wisconsin,Wood County,3,4502,2282,2220
Wisconsin,Wood County,4,4465,2341,2124
Wisconsin,Wood County,5,4054,2065,1989
Wisconsin,Wood County,6,3978,2021,1957
Wisconsin,Wood County,7,4160,2093,2067
Wisconsin,Wood County,8,3890,1961,1929
Wisconsin,Wood County,9,4220,2129,2091
Wisconsin,Wood County,10,4885,2419,2466
Wisconsin,Wood County,11,6157,3092,3065
Wisconsin,Wood County,12,5917,2918,2999
Wisconsin,Wood County,13,5017,2471,2546
Wisconsin,Wood County,14,4018,1975,2043
Wisconsin,Wood County,15,3110,1470,1640
Wisconsin,Wood County,16,2476,1119,1357
Wisconsin,Wood County,17,1842,748,1094
Wisconsin,Wood County,18,2250,799,1451
Wyoming,Albany County,0,37811,19770,18041
Wyoming,Albany County,1,1968,1019,949
Wyoming,Albany County,2,1805,948,857
Wyoming,Albany County,3,1485,776,709
Wyoming,Albany County,4,3269,1672,1597
Wyoming,Albany County,5,8305,4436,3869
Wyoming,Albany County,6,3620,2062,1558
Wyoming,Albany County,7,2626,1433,1193
Wyoming,Albany County,8,1971,1049,922
Wyoming,Albany County,9,1648,864,784
Wyoming,Albany County,10,1629,844,785
Wyoming,Albany County,11,1816,883,933
Wyoming,Albany County,12,2005,1018,987
Wyoming,Albany County,13,1956,982,974
Wyoming,Albany County,14,1412,739,673
Wyoming,Albany County,15,864,437,427
Wyoming,Albany County,16,565,265,300
Wyoming,Albany County,17,417,164,253
Wyoming,Albany County,18,450,179,271
Wyoming,Big Horn County,0,11930,6004,5926
Wyoming,Big Horn County,1,778,377,401
Wyoming,Big Horn County,2,850,420,430
Wyoming,Big Horn County,3,842,417,425
Wyoming,Big Horn County,4,855,415,440
Wyoming,Big Horn County,5,604,350,254
Wyoming,Big Horn County,6,615,314,301
Wyoming,Big Horn County,7,631,320,311
Wyoming,Big Horn County,8,629,334,295
Wyoming,Big Horn County,9,642,333,309
Wyoming,Big Horn County,10,686,338,348
Wyoming,Big Horn County,11,794,407,387
Wyoming,Big Horn County,12,872,440,432
Wyoming,Big Horn County,13,845,418,427
Wyoming,Big Horn County,14,741,375,366
Wyoming,Big Horn County,15,592,297,295
Wyoming,Big Horn County,16,408,197,211
Wyoming,Big Horn County,17,285,136,149
Wyoming,Big Horn County,18,261,116,145
Wyoming,Campbell County,0,48320,25139,23181
Wyoming,Campbell County,1,3870,1934,1936
Wyoming,Campbell County,2,4027,2003,2024
Wyoming,Campbell County,3,3554,1895,1659
Wyoming,Campbell County,4,3128,1651,1477
Wyoming,Campbell County,5,3253,1686,1567
Wyoming,Campbell County,6,4066,2185,1881
Wyoming,Campbell County,7,4041,2170,1871
Wyoming,Campbell County,8,3426,1790,1636
Wyoming,Campbell County,9,2986,1607,1379
Wyoming,Campbell County,10,2755,1416,1339
Wyoming,Campbell County,11,3575,1817,1758
Wyoming,Campbell County,12,3654,2002,1652
Wyoming,Campbell County,13,2551,1342,1209
Wyoming,Campbell County,14,1475,753,722
Wyoming,Campbell County,15,821,414,407
Wyoming,Campbell County,16,485,209,276
Wyoming,Campbell County,17,349,147,202
Wyoming,Campbell County,18,304,118,186
Wyoming,Carbon County,0,15854,8622,7232
Wyoming,Carbon County,1,986,537,449
Wyoming,Carbon County,2,1137,601,536
Wyoming,Carbon County,3,1026,532,494
Wyoming,Carbon County,4,943,502,441
Wyoming,Carbon County,5,953,583,370
Wyoming,Carbon County,6,1222,706,516
Wyoming,Carbon County,7,1142,662,480
Wyoming,Carbon County,8,997,566,431
Wyoming,Carbon County,9,915,513,402
Wyoming,Carbon County,10,955,542,413
Wyoming,Carbon County,11,1094,576,518
Wyoming,Carbon County,12,1181,615,566
Wyoming,Carbon County,13,1119,566,553
Wyoming,Carbon County,14,794,440,354
Wyoming,Carbon County,15,568,280,288
Wyoming,Carbon County,16,368,202,166
Wyoming,Carbon County,17,249,111,138
Wyoming,Carbon County,18,205,88,117
Wyoming,Converse County,0,14097,7196,6901
Wyoming,Converse County,1,976,502,474
Wyoming,Converse County,2,1004,533,471
Wyoming,Converse County,3,929,450,479
Wyoming,Converse County,4,860,457,403
Wyoming,Converse County,5,837,421,416
Wyoming,Converse County,6,896,467,429
Wyoming,Converse County,7,921,463,458
Wyoming,Converse County,8,850,434,416
Wyoming,Converse County,9,862,459,403
Wyoming,Converse County,10,907,455,452
Wyoming,Converse County,11,1068,560,508
Wyoming,Converse County,12,1127,598,529
Wyoming,Converse County,13,873,466,407
Wyoming,Converse County,14,728,362,366
Wyoming,Converse County,15,448,206,242
Wyoming,Converse County,16,359,158,201
Wyoming,Converse County,17,233,110,123
Wyoming,Converse County,18,219,95,124
Wyoming,Crook County,0,7248,3661,3587
Wyoming,Crook County,1,479,220,259
Wyoming,Crook County,2,497,254,243
Wyoming,Crook County,3,463,231,232
Wyoming,Crook County,4,443,235,208
Wyoming,Crook County,5,347,194,153
Wyoming,Crook County,6,366,191,175
Wyoming,Crook County,7,411,209,202
Wyoming,Crook County,8,357,202,155
Wyoming,Crook County,9,367,174,193
Wyoming,Crook County,10,430,221,209
Wyoming,Crook County,11,570,277,293
Wyoming,Crook County,12,639,307,332
Wyoming,Crook County,13,576,298,278
Wyoming,Crook County,14,432,222,210
Wyoming,Crook County,15,366,175,191
Wyoming,Crook County,16,215,118,97
Wyoming,Crook County,17,148,85,63
Wyoming,Crook County,18,142,48,94
Wyoming,Fremont County,0,40703,20363,20340
Wyoming,Fremont County,1,3040,1544,1496
Wyoming,Fremont County,2,3025,1541,1484
Wyoming,Fremont County,3,2696,1371,1325
Wyoming,Fremont County,4,2562,1369,1193
Wyoming,Fremont County,5,2429,1251,1178
Wyoming,Fremont County,6,2522,1273,1249
Wyoming,Fremont County,7,2673,1340,1333
Wyoming,Fremont County,8,2200,1128,1072
Wyoming,Fremont County,9,2156,1121,1035
Wyoming,Fremont County,10,2211,1102,1109
Wyoming,Fremont County,11,2758,1362,1396
Wyoming,Fremont County,12,3004,1476,1528
Wyoming,Fremont County,13,2820,1392,1428
Wyoming,Fremont County,14,2249,1119,1130
Wyoming,Fremont County,15,1592,778,814
Wyoming,Fremont County,16,1174,541,633
Wyoming,Fremont County,17,807,337,470
Wyoming,Fremont County,18,785,318,467
Wyoming,Goshen County,0,13514,7043,6471
Wyoming,Goshen County,1,752,370,382
Wyoming,Goshen County,2,697,355,342
Wyoming,Goshen County,3,759,392,367
Wyoming,Goshen County,4,884,434,450
Wyoming,Goshen County,5,983,547,436
Wyoming,Goshen County,6,806,456,350
Wyoming,Goshen County,7,758,414,344
Wyoming,Goshen County,8,676,385,291
Wyoming,Goshen County,9,758,438,320
Wyoming,Goshen County,10,727,403,324
Wyoming,Goshen County,11,972,530,442
Wyoming,Goshen County,12,1069,551,518
Wyoming,Goshen County,13,907,483,424
Wyoming,Goshen County,14,863,435,428
Wyoming,Goshen County,15,687,332,355
Wyoming,Goshen County,16,492,246,246
Wyoming,Goshen County,17,335,145,190
Wyoming,Goshen County,18,389,127,262
Wyoming,Hot Springs County,0,4816,2394,2422
Wyoming,Hot Springs County,1,213,134,79
Wyoming,Hot Springs County,2,301,153,148
Wyoming,Hot Springs County,3,301,169,132
Wyoming,Hot Springs County,4,282,134,148
Wyoming,Hot Springs County,5,184,103,81
Wyoming,Hot Springs County,6,239,119,120
Wyoming,Hot Springs County,7,241,125,116
Wyoming,Hot Springs County,8,241,129,112
Wyoming,Hot Springs County,9,223,103,120
Wyoming,Hot Springs County,10,219,119,100
Wyoming,Hot Springs County,11,371,187,184
Wyoming,Hot Springs County,12,426,186,240
Wyoming,Hot Springs County,13,440,196,244
Wyoming,Hot Springs County,14,324,151,173
Wyoming,Hot Springs County,15,286,148,138
Wyoming,Hot Springs County,16,242,126,116
Wyoming,Hot Springs County,17,138,54,84
Wyoming,Hot Springs County,18,145,58,87
Wyoming,Johnson County,0,8573,4339,4234
Wyoming,Johnson County,1,494,264,230
Wyoming,Johnson County,2,590,320,270
Wyoming,Johnson County,3,479,245,234
Wyoming,Johnson County,4,514,264,250
Wyoming,Johnson County,5,386,195,191
Wyoming,Johnson County,6,420,207,213
Wyoming,Johnson County,7,529,259,270
Wyoming,Johnson County,8,448,229,219
Wyoming,Johnson County,9,491,254,237
Wyoming,Johnson County,10,445,202,243
Wyoming,Johnson County,11,620,310,310
Wyoming,Johnson County,12,688,346,342
Wyoming,Johnson County,13,700,362,338
Wyoming,Johnson County,14,583,307,276
Wyoming,Johnson County,15,448,232,216
Wyoming,Johnson County,16,306,158,148
Wyoming,Johnson County,17,211,93,118
Wyoming,Johnson County,18,221,92,129
Wyoming,Laramie County,0,96389,48581,47808
Wyoming,Laramie County,1,6296,3160,3136
Wyoming,Laramie County,2,6572,3342,3230
Wyoming,Laramie County,3,6084,3127,2957
Wyoming,Laramie County,4,5953,3117,2836
Wyoming,Laramie County,5,7384,4109,3275
Wyoming,Laramie County,6,7138,3705,3433
Wyoming,Laramie County,7,6660,3439,3221
Wyoming,Laramie County,8,5742,2967,2775
Wyoming,Laramie County,9,5736,2886,2850
Wyoming,Laramie County,10,5648,2957,2691
Wyoming,Laramie County,11,6807,3401,3406
Wyoming,Laramie County,12,6689,3246,3443
Wyoming,Laramie County,13,5904,2891,3013
Wyoming,Laramie County,14,4761,2327,2434
Wyoming,Laramie County,15,3184,1503,1681
Wyoming,Laramie County,16,2264,1028,1236
Wyoming,Laramie County,17,1720,734,986
Wyoming,Laramie County,18,1847,642,1205
Wyoming,Lincoln County,0,18567,9409,9158
Wyoming,Lincoln County,1,1225,606,619
Wyoming,Lincoln County,2,1512,767,745
Wyoming,Lincoln County,3,1406,732,674
Wyoming,Lincoln County,4,1292,666,626
Wyoming,Lincoln County,5,865,449,416
Wyoming,Lincoln County,6,868,420,448
Wyoming,Lincoln County,7,1160,575,585
Wyoming,Lincoln County,8,1246,658,588
Wyoming,Lincoln County,9,1097,564,533
Wyoming,Lincoln County,10,1031,513,518
Wyoming,Lincoln County,11,1318,667,651
Wyoming,Lincoln County,12,1493,759,734
Wyoming,Lincoln County,13,1311,654,657
Wyoming,Lincoln County,14,1055,552,503
Wyoming,Lincoln County,15,699,358,341
Wyoming,Lincoln County,16,452,236,216
Wyoming,Lincoln County,17,277,138,139
Wyoming,Lincoln County,18,260,95,165
Wyoming,Natrona County,0,81624,41256,40368
Wyoming,Natrona County,1,5556,2797,2759
Wyoming,Natrona County,2,5657,2885,2772
Wyoming,Natrona County,3,5201,2697,2504
Wyoming,Natrona County,4,5036,2578,2458
Wyoming,Natrona County,5,5684,2913,2771
Wyoming,Natrona County,6,6444,3421,3023
Wyoming,Natrona County,7,6244,3251,2993
Wyoming,Natrona County,8,5337,2744,2593
Wyoming,Natrona County,9,4803,2531,2272
Wyoming,Natrona County,10,4601,2329,2272
Wyoming,Natrona County,11,5630,2837,2793
Wyoming,Natrona County,12,5976,3025,2951
Wyoming,Natrona County,13,4986,2546,2440
Wyoming,Natrona County,14,3531,1752,1779
Wyoming,Natrona County,15,2321,1076,1245
Wyoming,Natrona County,16,1706,751,955
Wyoming,Natrona County,17,1360,557,803
Wyoming,Natrona County,18,1551,566,985
Wyoming,Niobrara County,0,2463,1126,1337
Wyoming,Niobrara County,1,116,68,48
Wyoming,Niobrara County,2,88,44,44
Wyoming,Niobrara County,3,113,66,47
Wyoming,Niobrara County,4,129,72,57
Wyoming,Niobrara County,5,129,49,80
Wyoming,Niobrara County,6,169,67,102
Wyoming,Niobrara County,7,183,71,112
Wyoming,Niobrara County,8,135,55,80
Wyoming,Niobrara County,9,168,65,103
Wyoming,Niobrara County,10,142,58,84
Wyoming,Niobrara County,11,160,72,88
Wyoming,Niobrara County,12,213,98,115
Wyoming,Niobrara County,13,195,98,97
Wyoming,Niobrara County,14,141,77,64
Wyoming,Niobrara County,15,133,57,76
Wyoming,Niobrara County,16,110,51,59
Wyoming,Niobrara County,17,78,40,38
Wyoming,Niobrara County,18,61,18,43
Wyoming,Park County,0,28989,14469,14520
Wyoming,Park County,1,1590,817,773
Wyoming,Park County,2,1688,861,827
Wyoming,Park County,3,1610,861,749
Wyoming,Park County,4,1856,948,908
Wyoming,Park County,5,1724,881,843
Wyoming,Park County,6,1587,791,796
Wyoming,Park County,7,1720,900,820
Wyoming,Park County,8,1533,779,754
Wyoming,Park County,9,1481,751,730
Wyoming,Park County,10,1573,760,813
Wyoming,Park County,11,2139,1002,1137
Wyoming,Park County,12,2305,1115,1190
Wyoming,Park County,13,2360,1207,1153
Wyoming,Park County,14,1982,1018,964
Wyoming,Park County,15,1423,725,698
Wyoming,Park County,16,936,464,472
Wyoming,Park County,17,706,306,400
Wyoming,Park County,18,776,283,493
Wyoming,Platte County,0,8799,4477,4322
Wyoming,Platte County,1,432,211,221
Wyoming,Platte County,2,496,253,243
Wyoming,Platte County,3,513,257,256
Wyoming,Platte County,4,531,262,269
Wyoming,Platte County,5,435,255,180
Wyoming,Platte County,6,433,218,215
Wyoming,Platte County,7,443,249,194
Wyoming,Platte County,8,405,191,214
Wyoming,Platte County,9,465,234,231
Wyoming,Platte County,10,543,273,270
Wyoming,Platte County,11,671,331,340
Wyoming,Platte County,12,741,380,361
Wyoming,Platte County,13,691,364,327
Wyoming,Platte County,14,647,340,307
Wyoming,Platte County,15,510,260,250
Wyoming,Platte County,16,375,179,196
Wyoming,Platte County,17,247,130,117
Wyoming,Platte County,18,221,90,131
Wyoming,Sheridan County,0,30032,15004,15028
Wyoming,Sheridan County,1,1696,860,836
Wyoming,Sheridan County,2,1830,931,899
Wyoming,Sheridan County,3,1799,914,885
Wyoming,Sheridan County,4,1871,963,908
Wyoming,Sheridan County,5,1707,883,824
Wyoming,Sheridan County,6,1682,847,835
Wyoming,Sheridan County,7,1799,905,894
Wyoming,Sheridan County,8,1810,884,926
Wyoming,Sheridan County,9,1719,890,829
Wyoming,Sheridan County,10,1681,848,833
Wyoming,Sheridan County,11,2134,1028,1106
Wyoming,Sheridan County,12,2399,1185,1214
Wyoming,Sheridan County,13,2413,1221,1192
Wyoming,Sheridan County,14,1892,988,904
Wyoming,Sheridan County,15,1334,657,677
Wyoming,Sheridan County,16,893,457,436
Wyoming,Sheridan County,17,663,295,368
Wyoming,Sheridan County,18,710,248,462
Wyoming,Sublette County,0,10057,5396,4661
Wyoming,Sublette County,1,580,323,257
Wyoming,Sublette County,2,694,365,329
Wyoming,Sublette County,3,713,362,351
Wyoming,Sublette County,4,604,326,278
Wyoming,Sublette County,5,501,260,241
Wyoming,Sublette County,6,644,358,286
Wyoming,Sublette County,7,671,346,325
Wyoming,Sublette County,8,742,414,328
Wyoming,Sublette County,9,668,346,322
Wyoming,Sublette County,10,672,382,290
Wyoming,Sublette County,11,833,441,392
Wyoming,Sublette County,12,771,423,348
Wyoming,Sublette County,13,692,371,321
Wyoming,Sublette County,14,500,281,219
Wyoming,Sublette County,15,338,177,161
Wyoming,Sublette County,16,204,102,102
Wyoming,Sublette County,17,127,65,62
Wyoming,Sublette County,18,103,54,49
Wyoming,Sweetwater County,0,45010,23356,21654
Wyoming,Sweetwater County,1,3285,1705,1580
Wyoming,Sweetwater County,2,3722,1886,1836
Wyoming,Sweetwater County,3,3266,1668,1598
Wyoming,Sweetwater County,4,3038,1598,1440
Wyoming,Sweetwater County,5,2933,1557,1376
Wyoming,Sweetwater County,6,3408,1765,1643
Wyoming,Sweetwater County,7,3714,1966,1748
Wyoming,Sweetwater County,8,3182,1650,1532
Wyoming,Sweetwater County,9,2762,1449,1313
Wyoming,Sweetwater County,10,2494,1301,1193
Wyoming,Sweetwater County,11,3058,1611,1447
Wyoming,Sweetwater County,12,3285,1731,1554
Wyoming,Sweetwater County,13,2588,1361,1227
Wyoming,Sweetwater County,14,1700,893,807
Wyoming,Sweetwater County,15,1026,519,507
Wyoming,Sweetwater County,16,645,329,316
Wyoming,Sweetwater County,17,434,203,231
Wyoming,Sweetwater County,18,470,164,306
Wyoming,Teton County,0,22930,11882,11048
Wyoming,Teton County,1,1318,664,654
Wyoming,Teton County,2,1311,680,631
Wyoming,Teton County,3,1067,534,533
Wyoming,Teton County,4,1012,517,495
Wyoming,Teton County,5,1103,549,554
Wyoming,Teton County,6,2214,1138,1076
Wyoming,Teton County,7,2207,1192,1015
Wyoming,Teton County,8,1857,1017,840
Wyoming,Teton County,9,1798,1020,778
Wyoming,Teton County,10,1486,774,712
Wyoming,Teton County,11,1605,792,813
Wyoming,Teton County,12,1693,825,868
Wyoming,Teton County,13,1454,772,682
Wyoming,Teton County,14,1109,594,515
Wyoming,Teton County,15,718,364,354
Wyoming,Teton County,16,401,196,205
Wyoming,Teton County,17,299,142,157
Wyoming,Teton County,18,278,112,166
Wyoming,Uinta County,0,20904,10546,10358
Wyoming,Uinta County,1,1595,816,779
Wyoming,Uinta County,2,1798,924,874
Wyoming,Uinta County,3,1789,955,834
Wyoming,Uinta County,4,1542,763,779
Wyoming,Uinta County,5,1145,595,550
Wyoming,Uinta County,6,1219,587,632
Wyoming,Uinta County,7,1509,766,743
Wyoming,Uinta County,8,1392,677,715
Wyoming,Uinta County,9,1244,639,605
Wyoming,Uinta County,10,1103,545,558
Wyoming,Uinta County,11,1392,692,700
Wyoming,Uinta County,12,1559,786,773
Wyoming,Uinta County,13,1308,678,630
Wyoming,Uinta County,14,879,453,426
Wyoming,Uinta County,15,599,303,296
Wyoming,Uinta County,16,377,177,200
Wyoming,Uinta County,17,237,102,135
Wyoming,Uinta County,18,217,88,129
Wyoming,Washakie County,0,8322,4219,4103
Wyoming,Washakie County,1,458,234,224
Wyoming,Washakie County,2,551,264,287
Wyoming,Washakie County,3,577,293,284
Wyoming,Washakie County,4,582,324,258
Wyoming,Washakie County,5,371,200,171
Wyoming,Washakie County,6,393,219,174
Wyoming,Washakie County,7,496,245,251
Wyoming,Washakie County,8,481,241,240
Wyoming,Washakie County,9,458,242,216
Wyoming,Washakie County,10,469,255,214
Wyoming,Washakie County,11,600,287,313
Wyoming,Washakie County,12,625,306,319
Wyoming,Washakie County,13,587,310,277
Wyoming,Washakie County,14,500,238,262
Wyoming,Washakie County,15,421,226,195
Wyoming,Washakie County,16,275,126,149
Wyoming,Washakie County,17,244,102,142
Wyoming,Washakie County,18,234,107,127
Wyoming,Weston County,0,7201,3790,3411
Wyoming,Weston County,1,468,212,256
Wyoming,Weston County,2,394,197,197
Wyoming,Weston County,3,428,220,208
Wyoming,Weston County,4,412,227,185
Wyoming,Weston County,5,389,233,156
Wyoming,Weston County,6,411,239,172
Wyoming,Weston County,7,464,249,215
Wyoming,Weston County,8,427,244,183
Wyoming,Weston County,9,399,236,163
Wyoming,Weston County,10,411,216,195
Wyoming,Weston County,11,569,313,256
Wyoming,Weston County,12,587,303,284
Wyoming,Weston County,13,542,299,243
Wyoming,Weston County,14,414,215,199
Wyoming,Weston County,15,292,140,152
Wyoming,Weston County,16,246,109,137
Wyoming,Weston County,17,150,61,89
Wyoming,Weston County,18,198,77,121
